PublishTime,StartTime,EndTime,LoadForecastROI,LoadForecastNI,AggregatedForecast
"2018-11-08 10:10:51","2018-11-08 23:00:00","2018-11-08 23:30:00",3321,889,4210
"2018-11-08 10:10:51","2018-11-09 00:00:00","2018-11-09 00:30:00",3134,785,3919
"2018-11-08 10:10:51","2018-11-09 01:00:00","2018-11-09 01:30:00",2925,727,3652
"2018-11-08 10:10:51","2018-11-09 02:00:00","2018-11-09 02:30:00",2766,694,3460
"2018-11-08 10:10:51","2018-11-09 03:00:00","2018-11-09 03:30:00",2667,663,3330
"2018-11-08 10:10:51","2018-11-09 04:00:00","2018-11-09 04:30:00",2632,655,3287
"2018-11-08 10:10:51","2018-11-09 05:00:00","2018-11-09 05:30:00",2625,685,3310
"2018-11-08 10:10:51","2018-11-09 06:00:00","2018-11-09 06:30:00",2764,823,3587
"2018-11-08 10:10:51","2018-11-09 07:00:00","2018-11-09 07:30:00",3176,1031,4207
"2018-11-08 10:10:51","2018-11-09 08:00:00","2018-11-09 08:30:00",3544,1148,4692
"2018-11-08 10:10:51","2018-11-09 09:00:00","2018-11-09 09:30:00",3842,1206,5048
"2018-11-08 10:10:51","2018-11-09 10:00:00","2018-11-09 10:30:00",3971,1199,5170
"2018-11-08 10:10:51","2018-11-09 11:00:00","2018-11-09 11:30:00",4009,1200,5209
"2018-11-08 10:10:51","2018-11-09 12:00:00","2018-11-09 12:30:00",4058,1208,5266
"2018-11-08 10:10:51","2018-11-09 13:00:00","2018-11-09 13:30:00",4106,1190,5296
"2018-11-08 10:10:51","2018-11-09 14:00:00","2018-11-09 14:30:00",4062,1160,5222
"2018-11-08 10:10:51","2018-11-09 15:00:00","2018-11-09 15:30:00",4098,1170,5268
"2018-11-08 10:10:51","2018-11-09 16:00:00","2018-11-09 16:30:00",4185,1255,5440
"2018-11-08 10:10:51","2018-11-09 17:00:00","2018-11-09 17:30:00",4473,1450,5923
"2018-11-08 10:10:51","2018-11-09 18:00:00","2018-11-09 18:30:00",4619,1413,6032
"2018-11-08 10:10:51","2018-11-09 19:00:00","2018-11-09 19:30:00",4475,1314,5789
"2018-11-08 10:10:51","2018-11-09 20:00:00","2018-11-09 20:30:00",4205,1236,5441
"2018-11-08 10:10:51","2018-11-09 21:00:00","2018-11-09 21:30:00",4006,1157,5163
"2018-11-08 10:10:51","2018-11-09 22:00:00","2018-11-09 22:30:00",3641,1025,4666
"2018-11-09 10:10:31","2018-11-09 23:00:00","2018-11-09 23:30:00",3411,867,4278
"2018-11-09 10:10:31","2018-11-10 00:00:00","2018-11-10 00:30:00",3279,745,4024
"2018-11-09 10:10:31","2018-11-10 01:00:00","2018-11-10 01:30:00",3052,680,3732
"2018-11-09 10:10:31","2018-11-10 02:00:00","2018-11-10 02:30:00",2892,656,3548
"2018-11-09 10:10:31","2018-11-10 03:00:00","2018-11-10 03:30:00",2777,640,3417
"2018-11-09 10:10:31","2018-11-10 04:00:00","2018-11-10 04:30:00",2753,612,3365
"2018-11-09 10:10:31","2018-11-10 05:00:00","2018-11-10 05:30:00",2713,603,3316
"2018-11-09 10:10:31","2018-11-10 06:00:00","2018-11-10 06:30:00",2794,644,3438
"2018-11-09 10:10:31","2018-11-10 07:00:00","2018-11-10 07:30:00",3011,755,3766
"2018-11-09 10:10:31","2018-11-10 08:00:00","2018-11-10 08:30:00",3269,877,4146
"2018-11-09 10:10:31","2018-11-10 09:00:00","2018-11-10 09:30:00",3610,1008,4618
"2018-11-09 10:10:31","2018-11-10 10:00:00","2018-11-10 10:30:00",3809,1082,4891
"2018-11-09 10:10:31","2018-11-10 11:00:00","2018-11-10 11:30:00",3854,1093,4947
"2018-11-09 10:10:31","2018-11-10 12:00:00","2018-11-10 12:30:00",3869,1094,4963
"2018-11-09 10:10:31","2018-11-10 13:00:00","2018-11-10 13:30:00",3830,1068,4898
"2018-11-09 10:10:31","2018-11-10 14:00:00","2018-11-10 14:30:00",3740,1021,4761
"2018-11-09 10:10:31","2018-11-10 15:00:00","2018-11-10 15:30:00",3671,1029,4700
"2018-11-09 10:10:31","2018-11-10 16:00:00","2018-11-10 16:30:00",3719,1071,4790
"2018-11-09 10:10:31","2018-11-10 17:00:00","2018-11-10 17:30:00",4024,1210,5234
"2018-11-09 10:10:31","2018-11-10 18:00:00","2018-11-10 18:30:00",4294,1249,5543
"2018-11-09 10:10:31","2018-11-10 19:00:00","2018-11-10 19:30:00",4170,1180,5350
"2018-11-09 10:10:31","2018-11-10 20:00:00","2018-11-10 20:30:00",3900,1092,4992
"2018-11-09 10:10:31","2018-11-10 21:00:00","2018-11-10 21:30:00",3708,1016,4724
"2018-11-09 10:10:31","2018-11-10 22:00:00","2018-11-10 22:30:00",3404,936,4340
"2018-11-10 10:10:30","2018-11-10 23:00:00","2018-11-10 23:30:00",3222,828,4050
"2018-11-10 10:10:30","2018-11-11 00:00:00","2018-11-11 00:30:00",3115,693,3808
"2018-11-10 10:10:30","2018-11-11 01:00:00","2018-11-11 01:30:00",2906,663,3569
"2018-11-10 10:10:30","2018-11-11 02:00:00","2018-11-11 02:30:00",2720,629,3349
"2018-11-10 10:10:30","2018-11-11 03:00:00","2018-11-11 03:30:00",2594,615,3209
"2018-11-10 10:10:30","2018-11-11 04:00:00","2018-11-11 04:30:00",2572,597,3169
"2018-11-10 10:10:30","2018-11-11 05:00:00","2018-11-11 05:30:00",2547,605,3152
"2018-11-10 10:10:30","2018-11-11 06:00:00","2018-11-11 06:30:00",2560,643,3203
"2018-11-10 10:10:30","2018-11-11 07:00:00","2018-11-11 07:30:00",2691,715,3406
"2018-11-10 10:10:30","2018-11-11 08:00:00","2018-11-11 08:30:00",2829,787,3616
"2018-11-10 10:10:30","2018-11-11 09:00:00","2018-11-11 09:30:00",3110,874,3984
"2018-11-10 10:10:30","2018-11-11 10:00:00","2018-11-11 10:30:00",3334,942,4276
"2018-11-10 10:10:30","2018-11-11 11:00:00","2018-11-11 11:30:00",3447,974,4421
"2018-11-10 10:10:30","2018-11-11 12:00:00","2018-11-11 12:30:00",3522,1033,4555
"2018-11-10 10:10:30","2018-11-11 13:00:00","2018-11-11 13:30:00",3558,1053,4611
"2018-11-10 10:10:30","2018-11-11 14:00:00","2018-11-11 14:30:00",3524,1030,4554
"2018-11-10 10:10:30","2018-11-11 15:00:00","2018-11-11 15:30:00",3434,1008,4442
"2018-11-10 10:10:30","2018-11-11 16:00:00","2018-11-11 16:30:00",3477,1028,4505
"2018-11-10 10:10:30","2018-11-11 17:00:00","2018-11-11 17:30:00",3831,1190,5021
"2018-11-10 10:10:30","2018-11-11 18:00:00","2018-11-11 18:30:00",4097,1278,5375
"2018-11-10 10:10:30","2018-11-11 19:00:00","2018-11-11 19:30:00",3942,1187,5129
"2018-11-10 10:10:30","2018-11-11 20:00:00","2018-11-11 20:30:00",3791,1107,4898
"2018-11-10 10:10:30","2018-11-11 21:00:00","2018-11-11 21:30:00",3569,1021,4590
"2018-11-10 10:10:30","2018-11-11 22:00:00","2018-11-11 22:30:00",3258,922,4180
"2018-11-11 10:10:31","2018-11-11 23:00:00","2018-11-11 23:30:00",3036,809,3845
"2018-11-11 10:10:31","2018-11-12 00:00:00","2018-11-12 00:30:00",2814,687,3501
"2018-11-11 10:10:31","2018-11-12 01:00:00","2018-11-12 01:30:00",2696,645,3341
"2018-11-11 10:10:31","2018-11-12 02:00:00","2018-11-12 02:30:00",2582,644,3226
"2018-11-11 10:10:31","2018-11-12 03:00:00","2018-11-12 03:30:00",2527,630,3157
"2018-11-11 10:10:31","2018-11-12 04:00:00","2018-11-12 04:30:00",2550,619,3169
"2018-11-11 10:10:31","2018-11-12 05:00:00","2018-11-12 05:30:00",2578,636,3214
"2018-11-11 10:10:31","2018-11-12 06:00:00","2018-11-12 06:30:00",2783,716,3499
"2018-11-11 10:10:31","2018-11-12 07:00:00","2018-11-12 07:30:00",3334,919,4253
"2018-11-11 10:10:31","2018-11-12 08:00:00","2018-11-12 08:30:00",3853,1130,4983
"2018-11-11 10:10:31","2018-11-12 09:00:00","2018-11-12 09:30:00",3920,1153,5073
"2018-11-11 10:10:31","2018-11-12 10:00:00","2018-11-12 10:30:00",3985,1191,5176
"2018-11-11 10:10:31","2018-11-12 11:00:00","2018-11-12 11:30:00",3970,1182,5152
"2018-11-11 10:10:31","2018-11-12 12:00:00","2018-11-12 12:30:00",4028,1228,5256
"2018-11-11 10:10:31","2018-11-12 13:00:00","2018-11-12 13:30:00",4057,1229,5286
"2018-11-11 10:10:31","2018-11-12 14:00:00","2018-11-12 14:30:00",3966,1186,5152
"2018-11-11 10:10:31","2018-11-12 15:00:00","2018-11-12 15:30:00",4023,1214,5237
"2018-11-11 10:10:31","2018-11-12 16:00:00","2018-11-12 16:30:00",4090,1246,5336
"2018-11-11 10:10:31","2018-11-12 17:00:00","2018-11-12 17:30:00",4459,1465,5924
"2018-11-11 10:10:31","2018-11-12 18:00:00","2018-11-12 18:30:00",4700,1446,6146
"2018-11-11 10:10:31","2018-11-12 19:00:00","2018-11-12 19:30:00",4438,1333,5771
"2018-11-11 10:10:31","2018-11-12 20:00:00","2018-11-12 20:30:00",4146,1242,5388
"2018-11-11 10:10:31","2018-11-12 21:00:00","2018-11-12 21:30:00",3866,1158,5024
"2018-11-11 10:10:31","2018-11-12 22:00:00","2018-11-12 22:30:00",3491,1013,4504
"2018-11-12 10:10:36","2018-11-12 23:00:00","2018-11-12 23:30:00",3226,837,4063
"2018-11-12 10:10:36","2018-11-13 00:00:00","2018-11-13 00:30:00",3081,758,3839
"2018-11-12 10:10:36","2018-11-13 01:00:00","2018-11-13 01:30:00",2825,698,3523
"2018-11-12 10:10:36","2018-11-13 02:00:00","2018-11-13 02:30:00",2691,673,3364
"2018-11-12 10:10:36","2018-11-13 03:00:00","2018-11-13 03:30:00",2597,639,3236
"2018-11-12 10:10:36","2018-11-13 04:00:00","2018-11-13 04:30:00",2570,640,3210
"2018-11-12 10:10:36","2018-11-13 05:00:00","2018-11-13 05:30:00",2628,653,3281
"2018-11-12 10:10:36","2018-11-13 06:00:00","2018-11-13 06:30:00",2804,743,3547
"2018-11-12 10:10:36","2018-11-13 07:00:00","2018-11-13 07:30:00",3315,933,4248
"2018-11-12 10:10:36","2018-11-13 08:00:00","2018-11-13 08:30:00",3813,1113,4926
"2018-11-12 10:10:36","2018-11-13 09:00:00","2018-11-13 09:30:00",3852,1162,5014
"2018-11-12 10:10:36","2018-11-13 10:00:00","2018-11-13 10:30:00",3915,1198,5113
"2018-11-12 10:10:36","2018-11-13 11:00:00","2018-11-13 11:30:00",3912,1183,5095
"2018-11-12 10:10:36","2018-11-13 12:00:00","2018-11-13 12:30:00",3919,1159,5078
"2018-11-12 10:10:36","2018-11-13 13:00:00","2018-11-13 13:30:00",3941,1165,5106
"2018-11-12 10:10:36","2018-11-13 14:00:00","2018-11-13 14:30:00",3850,1134,4984
"2018-11-12 10:10:36","2018-11-13 15:00:00","2018-11-13 15:30:00",3893,1154,5047
"2018-11-12 10:10:36","2018-11-13 16:00:00","2018-11-13 16:30:00",4009,1196,5205
"2018-11-12 10:10:36","2018-11-13 17:00:00","2018-11-13 17:30:00",4474,1399,5873
"2018-11-12 10:10:36","2018-11-13 18:00:00","2018-11-13 18:30:00",4650,1395,6045
"2018-11-12 10:10:36","2018-11-13 19:00:00","2018-11-13 19:30:00",4454,1323,5777
"2018-11-12 10:10:36","2018-11-13 20:00:00","2018-11-13 20:30:00",4130,1245,5375
"2018-11-12 10:10:36","2018-11-13 21:00:00","2018-11-13 21:30:00",3880,1145,5025
"2018-11-12 10:10:36","2018-11-13 22:00:00","2018-11-13 22:30:00",3601,1009,4610
"2018-11-13 10:10:36","2018-11-13 23:00:00","2018-11-13 23:30:00",3334,913,4247
"2018-11-13 10:10:36","2018-11-14 00:00:00","2018-11-14 00:30:00",3065,720,3785
"2018-11-13 10:10:36","2018-11-14 01:00:00","2018-11-14 01:30:00",2859,715,3574
"2018-11-13 10:10:36","2018-11-14 02:00:00","2018-11-14 02:30:00",2673,682,3355
"2018-11-13 10:10:36","2018-11-14 03:00:00","2018-11-14 03:30:00",2598,651,3249
"2018-11-13 10:10:36","2018-11-14 04:00:00","2018-11-14 04:30:00",2583,642,3225
"2018-11-13 10:10:36","2018-11-14 05:00:00","2018-11-14 05:30:00",2563,676,3239
"2018-11-13 10:10:36","2018-11-14 06:00:00","2018-11-14 06:30:00",2761,810,3571
"2018-11-13 10:10:36","2018-11-14 07:00:00","2018-11-14 07:30:00",3369,1080,4449
"2018-11-13 10:10:36","2018-11-14 08:00:00","2018-11-14 08:30:00",3855,1180,5035
"2018-11-13 10:10:36","2018-11-14 09:00:00","2018-11-14 09:30:00",3931,1195,5126
"2018-11-13 10:10:36","2018-11-14 10:00:00","2018-11-14 10:30:00",4026,1180,5206
"2018-11-13 10:10:36","2018-11-14 11:00:00","2018-11-14 11:30:00",4022,1165,5187
"2018-11-13 10:10:36","2018-11-14 12:00:00","2018-11-14 12:30:00",3991,1185,5176
"2018-11-13 10:10:36","2018-11-14 13:00:00","2018-11-14 13:30:00",4050,1150,5200
"2018-11-13 10:10:36","2018-11-14 14:00:00","2018-11-14 14:30:00",3994,1107,5101
"2018-11-13 10:10:36","2018-11-14 15:00:00","2018-11-14 15:30:00",4069,1140,5209
"2018-11-13 10:10:36","2018-11-14 16:00:00","2018-11-14 16:30:00",4185,1280,5465
"2018-11-13 10:10:36","2018-11-14 17:00:00","2018-11-14 17:30:00",4491,1490,5981
"2018-11-13 10:10:36","2018-11-14 18:00:00","2018-11-14 18:30:00",4675,1440,6115
"2018-11-13 10:10:36","2018-11-14 19:00:00","2018-11-14 19:30:00",4461,1310,5771
"2018-11-13 10:10:36","2018-11-14 20:00:00","2018-11-14 20:30:00",4209,1240,5449
"2018-11-13 10:10:36","2018-11-14 21:00:00","2018-11-14 21:30:00",3995,1150,5145
"2018-11-13 10:10:36","2018-11-14 22:00:00","2018-11-14 22:30:00",3626,1020,4646
"2018-11-14 10:10:20","2018-11-14 23:00:00","2018-11-14 23:30:00",3393,873,4266
"2018-11-14 10:10:20","2018-11-15 00:00:00","2018-11-15 00:30:00",3094,699,3793
"2018-11-14 10:10:20","2018-11-15 01:00:00","2018-11-15 01:30:00",2874,649,3523
"2018-11-14 10:10:20","2018-11-15 02:00:00","2018-11-15 02:30:00",2763,635,3398
"2018-11-14 10:10:20","2018-11-15 03:00:00","2018-11-15 03:30:00",2659,609,3268
"2018-11-14 10:10:20","2018-11-15 04:00:00","2018-11-15 04:30:00",2646,598,3244
"2018-11-14 10:10:20","2018-11-15 05:00:00","2018-11-15 05:30:00",2664,611,3275
"2018-11-14 10:10:20","2018-11-15 06:00:00","2018-11-15 06:30:00",2796,698,3494
"2018-11-14 10:10:20","2018-11-15 07:00:00","2018-11-15 07:30:00",3381,879,4260
"2018-11-14 10:10:20","2018-11-15 08:00:00","2018-11-15 08:30:00",3813,1042,4855
"2018-11-14 10:10:20","2018-11-15 09:00:00","2018-11-15 09:30:00",3879,1079,4958
"2018-11-14 10:10:20","2018-11-15 10:00:00","2018-11-15 10:30:00",3925,1109,5034
"2018-11-14 10:10:20","2018-11-15 11:00:00","2018-11-15 11:30:00",3910,1105,5015
"2018-11-14 10:10:20","2018-11-15 12:00:00","2018-11-15 12:30:00",3893,1089,4982
"2018-11-14 10:10:20","2018-11-15 13:00:00","2018-11-15 13:30:00",3987,1097,5084
"2018-11-14 10:10:20","2018-11-15 14:00:00","2018-11-15 14:30:00",3941,1089,5030
"2018-11-14 10:10:20","2018-11-15 15:00:00","2018-11-15 15:30:00",4011,1110,5121
"2018-11-14 10:10:20","2018-11-15 16:00:00","2018-11-15 16:30:00",4144,1206,5350
"2018-11-14 10:10:20","2018-11-15 17:00:00","2018-11-15 17:30:00",4602,1439,6041
"2018-11-14 10:10:20","2018-11-15 18:00:00","2018-11-15 18:30:00",4750,1423,6173
"2018-11-14 10:10:20","2018-11-15 19:00:00","2018-11-15 19:30:00",4539,1326,5865
"2018-11-14 10:10:20","2018-11-15 20:00:00","2018-11-15 20:30:00",4370,1195,5565
"2018-11-14 10:10:20","2018-11-15 21:00:00","2018-11-15 21:30:00",4099,1116,5215
"2018-11-14 10:10:20","2018-11-15 22:00:00","2018-11-15 22:30:00",3718,1002,4720
"2018-11-15 10:10:20","2018-11-15 23:00:00","2018-11-15 23:30:00",3393,863,4256
"2018-11-15 10:10:20","2018-11-16 00:00:00","2018-11-16 00:30:00",3173,738,3911
"2018-11-15 10:10:20","2018-11-16 01:00:00","2018-11-16 01:30:00",2914,682,3596
"2018-11-15 10:10:20","2018-11-16 02:00:00","2018-11-16 02:30:00",2747,669,3416
"2018-11-15 10:10:20","2018-11-16 03:00:00","2018-11-16 03:30:00",2675,641,3316
"2018-11-15 10:10:20","2018-11-16 04:00:00","2018-11-16 04:30:00",2652,648,3300
"2018-11-15 10:10:20","2018-11-16 05:00:00","2018-11-16 05:30:00",2663,660,3323
"2018-11-15 10:10:20","2018-11-16 06:00:00","2018-11-16 06:30:00",2844,721,3565
"2018-11-15 10:10:20","2018-11-16 07:00:00","2018-11-16 07:30:00",3393,903,4296
"2018-11-15 10:10:20","2018-11-16 08:00:00","2018-11-16 08:30:00",3925,1081,5006
"2018-11-15 10:10:20","2018-11-16 09:00:00","2018-11-16 09:30:00",3984,1136,5120
"2018-11-15 10:10:20","2018-11-16 10:00:00","2018-11-16 10:30:00",4093,1164,5257
"2018-11-15 10:10:20","2018-11-16 11:00:00","2018-11-16 11:30:00",4028,1132,5160
"2018-11-15 10:10:20","2018-11-16 12:00:00","2018-11-16 12:30:00",4050,1153,5203
"2018-11-15 10:10:20","2018-11-16 13:00:00","2018-11-16 13:30:00",4045,1140,5185
"2018-11-15 10:10:20","2018-11-16 14:00:00","2018-11-16 14:30:00",3938,1116,5054
"2018-11-15 10:10:20","2018-11-16 15:00:00","2018-11-16 15:30:00",3970,1115,5085
"2018-11-15 10:10:20","2018-11-16 16:00:00","2018-11-16 16:30:00",4082,1149,5231
"2018-11-15 10:10:20","2018-11-16 17:00:00","2018-11-16 17:30:00",4493,1282,5775
"2018-11-15 10:10:20","2018-11-16 18:00:00","2018-11-16 18:30:00",4624,1250,5874
"2018-11-15 10:10:20","2018-11-16 19:00:00","2018-11-16 19:30:00",4417,1215,5632
"2018-11-15 10:10:20","2018-11-16 20:00:00","2018-11-16 20:30:00",4181,1157,5338
"2018-11-15 10:10:20","2018-11-16 21:00:00","2018-11-16 21:30:00",3943,1071,5014
"2018-11-15 10:10:20","2018-11-16 22:00:00","2018-11-16 22:30:00",3578,962,4540
"2018-11-16 10:10:35","2018-11-16 23:00:00","2018-11-16 23:30:00",3332,844,4176
"2018-11-16 10:10:35","2018-11-17 00:00:00","2018-11-17 00:30:00",3241,719,3960
"2018-11-16 10:10:35","2018-11-17 01:00:00","2018-11-17 01:30:00",2955,646,3601
"2018-11-16 10:10:35","2018-11-17 02:00:00","2018-11-17 02:30:00",2749,613,3362
"2018-11-16 10:10:35","2018-11-17 03:00:00","2018-11-17 03:30:00",2649,598,3247
"2018-11-16 10:10:35","2018-11-17 04:00:00","2018-11-17 04:30:00",2615,589,3204
"2018-11-16 10:10:35","2018-11-17 05:00:00","2018-11-17 05:30:00",2576,580,3156
"2018-11-16 10:10:35","2018-11-17 06:00:00","2018-11-17 06:30:00",2630,660,3290
"2018-11-16 10:10:35","2018-11-17 07:00:00","2018-11-17 07:30:00",2818,770,3588
"2018-11-16 10:10:35","2018-11-17 08:00:00","2018-11-17 08:30:00",3078,897,3975
"2018-11-16 10:10:35","2018-11-17 09:00:00","2018-11-17 09:30:00",3372,1000,4372
"2018-11-16 10:10:35","2018-11-17 10:00:00","2018-11-17 10:30:00",3613,1040,4653
"2018-11-16 10:10:35","2018-11-17 11:00:00","2018-11-17 11:30:00",3704,1039,4743
"2018-11-16 10:10:35","2018-11-17 12:00:00","2018-11-17 12:30:00",3726,1036,4762
"2018-11-16 10:10:35","2018-11-17 13:00:00","2018-11-17 13:30:00",3730,1026,4756
"2018-11-16 10:10:35","2018-11-17 14:00:00","2018-11-17 14:30:00",3631,1001,4632
"2018-11-16 10:10:35","2018-11-17 15:00:00","2018-11-17 15:30:00",3630,1004,4634
"2018-11-16 10:10:35","2018-11-17 16:00:00","2018-11-17 16:30:00",3708,1020,4728
"2018-11-16 10:10:35","2018-11-17 17:00:00","2018-11-17 17:30:00",4131,1213,5344
"2018-11-16 10:10:35","2018-11-17 18:00:00","2018-11-17 18:30:00",4225,1235,5460
"2018-11-16 10:10:35","2018-11-17 19:00:00","2018-11-17 19:30:00",4020,1160,5180
"2018-11-16 10:10:35","2018-11-17 20:00:00","2018-11-17 20:30:00",3819,1057,4876
"2018-11-16 10:10:35","2018-11-17 21:00:00","2018-11-17 21:30:00",3575,993,4568
"2018-11-16 10:10:35","2018-11-17 22:00:00","2018-11-17 22:30:00",3356,908,4264
"2018-11-17 10:10:06","2018-11-17 23:00:00","2018-11-17 23:30:00",3105,860,3965
"2018-11-17 10:10:06","2018-11-18 00:00:00","2018-11-18 00:30:00",2798,716,3514
"2018-11-17 10:10:06","2018-11-18 01:00:00","2018-11-18 01:30:00",2617,655,3272
"2018-11-17 10:10:06","2018-11-18 02:00:00","2018-11-18 02:30:00",2512,626,3138
"2018-11-17 10:10:06","2018-11-18 03:00:00","2018-11-18 03:30:00",2466,618,3084
"2018-11-17 10:10:06","2018-11-18 04:00:00","2018-11-18 04:30:00",2440,595,3035
"2018-11-17 10:10:06","2018-11-18 05:00:00","2018-11-18 05:30:00",2450,588,3038
"2018-11-17 10:10:06","2018-11-18 06:00:00","2018-11-18 06:30:00",2604,640,3244
"2018-11-17 10:10:06","2018-11-18 07:00:00","2018-11-18 07:30:00",3028,720,3748
"2018-11-17 10:10:06","2018-11-18 08:00:00","2018-11-18 08:30:00",3405,790,4195
"2018-11-17 10:10:06","2018-11-18 09:00:00","2018-11-18 09:30:00",3484,910,4394
"2018-11-17 10:10:06","2018-11-18 10:00:00","2018-11-18 10:30:00",3532,980,4512
"2018-11-17 10:10:06","2018-11-18 11:00:00","2018-11-18 11:30:00",3512,1020,4532
"2018-11-17 10:10:06","2018-11-18 12:00:00","2018-11-18 12:30:00",3458,997,4455
"2018-11-17 10:10:06","2018-11-18 13:00:00","2018-11-18 13:30:00",3518,1033,4551
"2018-11-17 10:10:06","2018-11-18 14:00:00","2018-11-18 14:30:00",3512,1013,4525
"2018-11-17 10:10:06","2018-11-18 15:00:00","2018-11-18 15:30:00",3572,986,4558
"2018-11-17 10:10:06","2018-11-18 16:00:00","2018-11-18 16:30:00",3663,1031,4694
"2018-11-17 10:10:06","2018-11-18 17:00:00","2018-11-18 17:30:00",3984,1206,5190
"2018-11-17 10:10:06","2018-11-18 18:00:00","2018-11-18 18:30:00",4099,1281,5380
"2018-11-17 10:10:06","2018-11-18 19:00:00","2018-11-18 19:30:00",3943,1189,5132
"2018-11-17 10:10:06","2018-11-18 20:00:00","2018-11-18 20:30:00",3739,1102,4841
"2018-11-17 10:10:06","2018-11-18 21:00:00","2018-11-18 21:30:00",3537,1018,4555
"2018-11-17 10:10:06","2018-11-18 22:00:00","2018-11-18 22:30:00",3234,931,4165
"2018-11-18 10:10:06","2018-11-18 23:00:00","2018-11-18 23:30:00",2980,791,3771
"2018-11-18 10:10:06","2018-11-19 00:00:00","2018-11-19 00:30:00",2955,683,3638
"2018-11-18 10:10:06","2018-11-19 01:00:00","2018-11-19 01:30:00",2788,633,3421
"2018-11-18 10:10:06","2018-11-19 02:00:00","2018-11-19 02:30:00",2656,631,3287
"2018-11-18 10:10:06","2018-11-19 03:00:00","2018-11-19 03:30:00",2572,617,3189
"2018-11-18 10:10:06","2018-11-19 04:00:00","2018-11-19 04:30:00",2565,619,3184
"2018-11-18 10:10:06","2018-11-19 05:00:00","2018-11-19 05:30:00",2601,624,3225
"2018-11-18 10:10:06","2018-11-19 06:00:00","2018-11-19 06:30:00",2803,695,3498
"2018-11-18 10:10:06","2018-11-19 07:00:00","2018-11-19 07:30:00",3366,911,4277
"2018-11-18 10:10:06","2018-11-19 08:00:00","2018-11-19 08:30:00",3857,1134,4991
"2018-11-18 10:10:06","2018-11-19 09:00:00","2018-11-19 09:30:00",3955,1172,5127
"2018-11-18 10:10:06","2018-11-19 10:00:00","2018-11-19 10:30:00",4037,1188,5225
"2018-11-18 10:10:06","2018-11-19 11:00:00","2018-11-19 11:30:00",4048,1171,5219
"2018-11-18 10:10:06","2018-11-19 12:00:00","2018-11-19 12:30:00",4064,1207,5271
"2018-11-18 10:10:06","2018-11-19 13:00:00","2018-11-19 13:30:00",4107,1189,5296
"2018-11-18 10:10:06","2018-11-19 14:00:00","2018-11-19 14:30:00",4016,1172,5188
"2018-11-18 10:10:06","2018-11-19 15:00:00","2018-11-19 15:30:00",4036,1179,5215
"2018-11-18 10:10:06","2018-11-19 16:00:00","2018-11-19 16:30:00",4173,1212,5385
"2018-11-18 10:10:06","2018-11-19 17:00:00","2018-11-19 17:30:00",4618,1479,6097
"2018-11-18 10:10:06","2018-11-19 18:00:00","2018-11-19 18:30:00",4733,1482,6215
"2018-11-18 10:10:06","2018-11-19 19:00:00","2018-11-19 19:30:00",4505,1330,5835
"2018-11-18 10:10:06","2018-11-19 20:00:00","2018-11-19 20:30:00",4220,1210,5430
"2018-11-18 10:10:06","2018-11-19 21:00:00","2018-11-19 21:30:00",3961,1157,5118
"2018-11-18 10:10:06","2018-11-19 22:00:00","2018-11-19 22:30:00",3547,991,4538
"2018-11-19 10:10:51","2018-11-19 23:00:00","2018-11-19 23:30:00",3294,882,4176
"2018-11-19 10:10:51","2018-11-20 00:00:00","2018-11-20 00:30:00",3168,712,3880
"2018-11-19 10:10:51","2018-11-20 01:00:00","2018-11-20 01:30:00",2941,666,3607
"2018-11-19 10:10:51","2018-11-20 02:00:00","2018-11-20 02:30:00",2817,671,3488
"2018-11-19 10:10:51","2018-11-20 03:00:00","2018-11-20 03:30:00",2747,653,3400
"2018-11-19 10:10:51","2018-11-20 04:00:00","2018-11-20 04:30:00",2707,652,3359
"2018-11-19 10:10:51","2018-11-20 05:00:00","2018-11-20 05:30:00",2728,659,3387
"2018-11-19 10:10:51","2018-11-20 06:00:00","2018-11-20 06:30:00",2904,749,3653
"2018-11-19 10:10:51","2018-11-20 07:00:00","2018-11-20 07:30:00",3463,966,4429
"2018-11-19 10:10:51","2018-11-20 08:00:00","2018-11-20 08:30:00",4000,1169,5169
"2018-11-19 10:10:51","2018-11-20 09:00:00","2018-11-20 09:30:00",4026,1194,5220
"2018-11-19 10:10:51","2018-11-20 10:00:00","2018-11-20 10:30:00",4105,1217,5322
"2018-11-19 10:10:51","2018-11-20 11:00:00","2018-11-20 11:30:00",4082,1232,5314
"2018-11-19 10:10:51","2018-11-20 12:00:00","2018-11-20 12:30:00",4125,1237,5362
"2018-11-19 10:10:51","2018-11-20 13:00:00","2018-11-20 13:30:00",4110,1224,5334
"2018-11-19 10:10:51","2018-11-20 14:00:00","2018-11-20 14:30:00",4035,1188,5223
"2018-11-19 10:10:51","2018-11-20 15:00:00","2018-11-20 15:30:00",4085,1195,5280
"2018-11-19 10:10:51","2018-11-20 16:00:00","2018-11-20 16:30:00",4231,1281,5512
"2018-11-19 10:10:51","2018-11-20 17:00:00","2018-11-20 17:30:00",4728,1492,6220
"2018-11-19 10:10:51","2018-11-20 18:00:00","2018-11-20 18:30:00",4850,1445,6295
"2018-11-19 10:10:51","2018-11-20 19:00:00","2018-11-20 19:30:00",4715,1329,6044
"2018-11-19 10:10:51","2018-11-20 20:00:00","2018-11-20 20:30:00",4502,1245,5747
"2018-11-19 10:10:51","2018-11-20 21:00:00","2018-11-20 21:30:00",4270,1146,5416
"2018-11-19 10:10:51","2018-11-20 22:00:00","2018-11-20 22:30:00",3891,993,4884
"2018-11-20 10:10:11","2018-11-20 23:00:00","2018-11-20 23:30:00",3597,847,4444
"2018-11-20 10:10:11","2018-11-21 00:00:00","2018-11-21 00:30:00",3168,698,3866
"2018-11-20 10:10:11","2018-11-21 01:00:00","2018-11-21 01:30:00",2941,641,3582
"2018-11-20 10:10:11","2018-11-21 02:00:00","2018-11-21 02:30:00",2817,631,3448
"2018-11-20 10:10:11","2018-11-21 03:00:00","2018-11-21 03:30:00",2747,620,3367
"2018-11-20 10:10:11","2018-11-21 04:00:00","2018-11-21 04:30:00",2707,612,3319
"2018-11-20 10:10:11","2018-11-21 05:00:00","2018-11-21 05:30:00",2728,634,3362
"2018-11-20 10:10:11","2018-11-21 06:00:00","2018-11-21 06:30:00",2904,723,3627
"2018-11-20 10:10:11","2018-11-21 07:00:00","2018-11-21 07:30:00",3463,925,4388
"2018-11-20 10:10:11","2018-11-21 08:00:00","2018-11-21 08:30:00",4000,1128,5128
"2018-11-20 10:10:11","2018-11-21 09:00:00","2018-11-21 09:30:00",4026,1174,5200
"2018-11-20 10:10:11","2018-11-21 10:00:00","2018-11-21 10:30:00",4105,1205,5310
"2018-11-20 10:10:11","2018-11-21 11:00:00","2018-11-21 11:30:00",4082,1212,5294
"2018-11-20 10:10:11","2018-11-21 12:00:00","2018-11-21 12:30:00",4125,1221,5346
"2018-11-20 10:10:11","2018-11-21 13:00:00","2018-11-21 13:30:00",4110,1214,5324
"2018-11-20 10:10:11","2018-11-21 14:00:00","2018-11-21 14:30:00",4035,1179,5214
"2018-11-20 10:10:11","2018-11-21 15:00:00","2018-11-21 15:30:00",4085,1191,5276
"2018-11-20 10:10:11","2018-11-21 16:00:00","2018-11-21 16:30:00",4231,1253,5484
"2018-11-20 10:10:11","2018-11-21 17:00:00","2018-11-21 17:30:00",4728,1475,6203
"2018-11-20 10:10:11","2018-11-21 18:00:00","2018-11-21 18:30:00",4850,1440,6290
"2018-11-20 10:10:11","2018-11-21 19:00:00","2018-11-21 19:30:00",4715,1316,6031
"2018-11-20 10:10:11","2018-11-21 20:00:00","2018-11-21 20:30:00",4502,1219,5721
"2018-11-20 10:10:11","2018-11-21 21:00:00","2018-11-21 21:30:00",4270,1143,5413
"2018-11-20 10:10:11","2018-11-21 22:00:00","2018-11-21 22:30:00",3891,997,4888
"2018-11-21 10:10:16","2018-11-21 23:00:00","2018-11-21 23:30:00",3597,843,4440
"2018-11-21 10:10:16","2018-11-22 00:00:00","2018-11-22 00:30:00",3168,718,3886
"2018-11-21 10:10:16","2018-11-22 01:00:00","2018-11-22 01:30:00",2941,668,3609
"2018-11-21 10:10:16","2018-11-22 02:00:00","2018-11-22 02:30:00",2817,663,3480
"2018-11-21 10:10:16","2018-11-22 03:00:00","2018-11-22 03:30:00",2747,635,3382
"2018-11-21 10:10:16","2018-11-22 04:00:00","2018-11-22 04:30:00",2707,631,3338
"2018-11-21 10:10:16","2018-11-22 05:00:00","2018-11-22 05:30:00",2728,654,3382
"2018-11-21 10:10:16","2018-11-22 06:00:00","2018-11-22 06:30:00",2904,800,3704
"2018-11-21 10:10:16","2018-11-22 07:00:00","2018-11-22 07:30:00",3463,1088,4551
"2018-11-21 10:10:16","2018-11-22 08:00:00","2018-11-22 08:30:00",4000,1196,5196
"2018-11-21 10:10:16","2018-11-22 09:00:00","2018-11-22 09:30:00",4026,1226,5252
"2018-11-21 10:10:16","2018-11-22 10:00:00","2018-11-22 10:30:00",4105,1216,5321
"2018-11-21 10:10:16","2018-11-22 11:00:00","2018-11-22 11:30:00",4082,1201,5283
"2018-11-21 10:10:16","2018-11-22 12:00:00","2018-11-22 12:30:00",4125,1206,5331
"2018-11-21 10:10:16","2018-11-22 13:00:00","2018-11-22 13:30:00",4110,1202,5312
"2018-11-21 10:10:16","2018-11-22 14:00:00","2018-11-22 14:30:00",4035,1183,5218
"2018-11-21 10:10:16","2018-11-22 15:00:00","2018-11-22 15:30:00",4085,1215,5300
"2018-11-21 10:10:16","2018-11-22 16:00:00","2018-11-22 16:30:00",4231,1349,5580
"2018-11-21 10:10:16","2018-11-22 17:00:00","2018-11-22 17:30:00",4728,1503,6231
"2018-11-21 10:10:16","2018-11-22 18:00:00","2018-11-22 18:30:00",4850,1452,6302
"2018-11-21 10:10:16","2018-11-22 19:00:00","2018-11-22 19:30:00",4715,1337,6052
"2018-11-21 10:10:16","2018-11-22 20:00:00","2018-11-22 20:30:00",4502,1279,5781
"2018-11-21 10:10:16","2018-11-22 21:00:00","2018-11-22 21:30:00",4270,1187,5457
"2018-11-21 10:10:16","2018-11-22 22:00:00","2018-11-22 22:30:00",3891,1026,4917
"2018-11-22 10:10:11","2018-11-22 23:00:00","2018-11-22 23:30:00",3597,903,4500
"2018-11-22 10:10:11","2018-11-23 00:00:00","2018-11-23 00:30:00",3123,769,3892
"2018-11-22 10:10:11","2018-11-23 01:00:00","2018-11-23 01:30:00",2882,703,3585
"2018-11-22 10:10:11","2018-11-23 02:00:00","2018-11-23 02:30:00",2696,705,3401
"2018-11-22 10:10:11","2018-11-23 03:00:00","2018-11-23 03:30:00",2617,677,3294
"2018-11-22 10:10:11","2018-11-23 04:00:00","2018-11-23 04:30:00",2571,670,3241
"2018-11-22 10:10:11","2018-11-23 05:00:00","2018-11-23 05:30:00",2604,685,3289
"2018-11-22 10:10:11","2018-11-23 06:00:00","2018-11-23 06:30:00",2876,764,3640
"2018-11-22 10:10:11","2018-11-23 07:00:00","2018-11-23 07:30:00",3451,983,4434
"2018-11-22 10:10:11","2018-11-23 08:00:00","2018-11-23 08:30:00",3925,1149,5074
"2018-11-22 10:10:11","2018-11-23 09:00:00","2018-11-23 09:30:00",3988,1199,5187
"2018-11-22 10:10:11","2018-11-23 10:00:00","2018-11-23 10:30:00",4030,1220,5250
"2018-11-22 10:10:11","2018-11-23 11:00:00","2018-11-23 11:30:00",4033,1206,5239
"2018-11-22 10:10:11","2018-11-23 12:00:00","2018-11-23 12:30:00",4021,1219,5240
"2018-11-22 10:10:11","2018-11-23 13:00:00","2018-11-23 13:30:00",4012,1161,5173
"2018-11-22 10:10:11","2018-11-23 14:00:00","2018-11-23 14:30:00",3972,1136,5108
"2018-11-22 10:10:11","2018-11-23 15:00:00","2018-11-23 15:30:00",4017,1122,5139
"2018-11-22 10:10:11","2018-11-23 16:00:00","2018-11-23 16:30:00",4126,1199,5325
"2018-11-22 10:10:11","2018-11-23 17:00:00","2018-11-23 17:30:00",4529,1388,5917
"2018-11-22 10:10:11","2018-11-23 18:00:00","2018-11-23 18:30:00",4578,1361,5939
"2018-11-22 10:10:11","2018-11-23 19:00:00","2018-11-23 19:30:00",4392,1289,5681
"2018-11-22 10:10:11","2018-11-23 20:00:00","2018-11-23 20:30:00",4169,1217,5386
"2018-11-22 10:10:11","2018-11-23 21:00:00","2018-11-23 21:30:00",3885,1126,5011
"2018-11-22 10:10:11","2018-11-23 22:00:00","2018-11-23 22:30:00",3570,1009,4579
"2018-11-23 10:10:16","2018-11-23 23:00:00","2018-11-23 23:30:00",3458,897,4355
"2018-11-23 10:10:16","2018-11-24 00:00:00","2018-11-24 00:30:00",3269,768,4037
"2018-11-23 10:10:16","2018-11-24 01:00:00","2018-11-24 01:30:00",3016,691,3707
"2018-11-23 10:10:16","2018-11-24 02:00:00","2018-11-24 02:30:00",2831,657,3488
"2018-11-23 10:10:16","2018-11-24 03:00:00","2018-11-24 03:30:00",2736,630,3366
"2018-11-23 10:10:16","2018-11-24 04:00:00","2018-11-24 04:30:00",2657,617,3274
"2018-11-23 10:10:16","2018-11-24 05:00:00","2018-11-24 05:30:00",2676,609,3285
"2018-11-23 10:10:16","2018-11-24 06:00:00","2018-11-24 06:30:00",2719,642,3361
"2018-11-23 10:10:16","2018-11-24 07:00:00","2018-11-24 07:30:00",2915,752,3667
"2018-11-23 10:10:16","2018-11-24 08:00:00","2018-11-24 08:30:00",3251,869,4120
"2018-11-23 10:10:16","2018-11-24 09:00:00","2018-11-24 09:30:00",3576,986,4562
"2018-11-23 10:10:16","2018-11-24 10:00:00","2018-11-24 10:30:00",3759,1056,4815
"2018-11-23 10:10:16","2018-11-24 11:00:00","2018-11-24 11:30:00",3805,1059,4864
"2018-11-23 10:10:16","2018-11-24 12:00:00","2018-11-24 12:30:00",3820,1060,4880
"2018-11-23 10:10:16","2018-11-24 13:00:00","2018-11-24 13:30:00",3814,1055,4869
"2018-11-23 10:10:16","2018-11-24 14:00:00","2018-11-24 14:30:00",3732,1011,4743
"2018-11-23 10:10:16","2018-11-24 15:00:00","2018-11-24 15:30:00",3703,996,4699
"2018-11-23 10:10:16","2018-11-24 16:00:00","2018-11-24 16:30:00",3783,1055,4838
"2018-11-23 10:10:16","2018-11-24 17:00:00","2018-11-24 17:30:00",4253,1261,5514
"2018-11-23 10:10:16","2018-11-24 18:00:00","2018-11-24 18:30:00",4410,1285,5695
"2018-11-23 10:10:16","2018-11-24 19:00:00","2018-11-24 19:30:00",4054,1185,5239
"2018-11-23 10:10:16","2018-11-24 20:00:00","2018-11-24 20:30:00",3792,1095,4887
"2018-11-23 10:10:16","2018-11-24 21:00:00","2018-11-24 21:30:00",3540,1013,4553
"2018-11-23 10:10:16","2018-11-24 22:00:00","2018-11-24 22:30:00",3400,939,4339
"2018-11-24 10:10:15","2018-11-24 23:00:00","2018-11-24 23:30:00",3274,841,4115
"2018-11-24 10:10:15","2018-11-25 00:00:00","2018-11-25 00:30:00",3209,735,3944
"2018-11-24 10:10:15","2018-11-25 01:00:00","2018-11-25 01:30:00",2980,664,3644
"2018-11-24 10:10:15","2018-11-25 02:00:00","2018-11-25 02:30:00",2765,646,3411
"2018-11-24 10:10:15","2018-11-25 03:00:00","2018-11-25 03:30:00",2612,636,3248
"2018-11-24 10:10:15","2018-11-25 04:00:00","2018-11-25 04:30:00",2534,606,3140
"2018-11-24 10:10:15","2018-11-25 05:00:00","2018-11-25 05:30:00",2500,601,3101
"2018-11-24 10:10:15","2018-11-25 06:00:00","2018-11-25 06:30:00",2547,625,3172
"2018-11-24 10:10:15","2018-11-25 07:00:00","2018-11-25 07:30:00",2645,690,3335
"2018-11-24 10:10:15","2018-11-25 08:00:00","2018-11-25 08:30:00",2787,800,3587
"2018-11-24 10:10:15","2018-11-25 09:00:00","2018-11-25 09:30:00",3009,929,3938
"2018-11-24 10:10:15","2018-11-25 10:00:00","2018-11-25 10:30:00",3328,1009,4337
"2018-11-24 10:10:15","2018-11-25 11:00:00","2018-11-25 11:30:00",3528,1057,4585
"2018-11-24 10:10:15","2018-11-25 12:00:00","2018-11-25 12:30:00",3625,1100,4725
"2018-11-24 10:10:15","2018-11-25 13:00:00","2018-11-25 13:30:00",3698,1114,4812
"2018-11-24 10:10:15","2018-11-25 14:00:00","2018-11-25 14:30:00",3595,1074,4669
"2018-11-24 10:10:15","2018-11-25 15:00:00","2018-11-25 15:30:00",3524,1050,4574
"2018-11-24 10:10:15","2018-11-25 16:00:00","2018-11-25 16:30:00",3592,1225,4817
"2018-11-24 10:10:15","2018-11-25 17:00:00","2018-11-25 17:30:00",4018,1300,5318
"2018-11-24 10:10:15","2018-11-25 18:00:00","2018-11-25 18:30:00",4160,1262,5422
"2018-11-24 10:10:15","2018-11-25 19:00:00","2018-11-25 19:30:00",4018,1176,5194
"2018-11-24 10:10:15","2018-11-25 20:00:00","2018-11-25 20:30:00",3882,1098,4980
"2018-11-24 10:10:15","2018-11-25 21:00:00","2018-11-25 21:30:00",3718,1052,4770
"2018-11-24 10:10:15","2018-11-25 22:00:00","2018-11-25 22:30:00",3430,939,4369
"2018-11-25 10:10:21","2018-11-25 23:00:00","2018-11-25 23:30:00",3096,784,3880
"2018-11-25 10:10:21","2018-11-26 00:00:00","2018-11-26 00:30:00",2928,739,3667
"2018-11-25 10:10:21","2018-11-26 01:00:00","2018-11-26 01:30:00",2758,678,3436
"2018-11-25 10:10:21","2018-11-26 02:00:00","2018-11-26 02:30:00",2602,662,3264
"2018-11-25 10:10:21","2018-11-26 03:00:00","2018-11-26 03:30:00",2549,658,3207
"2018-11-25 10:10:21","2018-11-26 04:00:00","2018-11-26 04:30:00",2540,645,3185
"2018-11-25 10:10:21","2018-11-26 05:00:00","2018-11-26 05:30:00",2629,690,3319
"2018-11-25 10:10:21","2018-11-26 06:00:00","2018-11-26 06:30:00",2827,810,3637
"2018-11-25 10:10:21","2018-11-26 07:00:00","2018-11-26 07:30:00",3332,1055,4387
"2018-11-25 10:10:21","2018-11-26 08:00:00","2018-11-26 08:30:00",3876,1200,5076
"2018-11-25 10:10:21","2018-11-26 09:00:00","2018-11-26 09:30:00",3987,1214,5201
"2018-11-25 10:10:21","2018-11-26 10:00:00","2018-11-26 10:30:00",4046,1226,5272
"2018-11-25 10:10:21","2018-11-26 11:00:00","2018-11-26 11:30:00",4065,1235,5300
"2018-11-25 10:10:21","2018-11-26 12:00:00","2018-11-26 12:30:00",4136,1219,5355
"2018-11-25 10:10:21","2018-11-26 13:00:00","2018-11-26 13:30:00",4119,1238,5357
"2018-11-25 10:10:21","2018-11-26 14:00:00","2018-11-26 14:30:00",4073,1200,5273
"2018-11-25 10:10:21","2018-11-26 15:00:00","2018-11-26 15:30:00",4116,1231,5347
"2018-11-25 10:10:21","2018-11-26 16:00:00","2018-11-26 16:30:00",4261,1350,5611
"2018-11-25 10:10:21","2018-11-26 17:00:00","2018-11-26 17:30:00",4716,1540,6256
"2018-11-25 10:10:21","2018-11-26 18:00:00","2018-11-26 18:30:00",4792,1520,6312
"2018-11-25 10:10:21","2018-11-26 19:00:00","2018-11-26 19:30:00",4588,1364,5952
"2018-11-25 10:10:21","2018-11-26 20:00:00","2018-11-26 20:30:00",4337,1254,5591
"2018-11-25 10:10:21","2018-11-26 21:00:00","2018-11-26 21:30:00",4067,1168,5235
"2018-11-25 10:10:21","2018-11-26 22:00:00","2018-11-26 22:30:00",3678,1019,4697
"2018-11-26 10:10:20","2018-11-26 23:00:00","2018-11-26 23:30:00",3381,860,4241
"2018-11-26 10:10:20","2018-11-27 00:00:00","2018-11-27 00:30:00",3152,754,3906
"2018-11-26 10:10:20","2018-11-27 01:00:00","2018-11-27 01:30:00",2915,695,3610
"2018-11-26 10:10:20","2018-11-27 02:00:00","2018-11-27 02:30:00",2785,681,3466
"2018-11-26 10:10:20","2018-11-27 03:00:00","2018-11-27 03:30:00",2713,651,3364
"2018-11-26 10:10:20","2018-11-27 04:00:00","2018-11-27 04:30:00",2668,640,3308
"2018-11-26 10:10:20","2018-11-27 05:00:00","2018-11-27 05:30:00",2655,690,3345
"2018-11-26 10:10:20","2018-11-27 06:00:00","2018-11-27 06:30:00",2910,840,3750
"2018-11-26 10:10:20","2018-11-27 07:00:00","2018-11-27 07:30:00",3449,1110,4559
"2018-11-26 10:10:20","2018-11-27 08:00:00","2018-11-27 08:30:00",3954,1210,5164
"2018-11-26 10:10:20","2018-11-27 09:00:00","2018-11-27 09:30:00",4014,1230,5244
"2018-11-26 10:10:20","2018-11-27 10:00:00","2018-11-27 10:30:00",4071,1236,5307
"2018-11-26 10:10:20","2018-11-27 11:00:00","2018-11-27 11:30:00",4141,1256,5397
"2018-11-26 10:10:20","2018-11-27 12:00:00","2018-11-27 12:30:00",4103,1242,5345
"2018-11-26 10:10:20","2018-11-27 13:00:00","2018-11-27 13:30:00",4139,1234,5373
"2018-11-26 10:10:20","2018-11-27 14:00:00","2018-11-27 14:30:00",4065,1219,5284
"2018-11-26 10:10:20","2018-11-27 15:00:00","2018-11-27 15:30:00",4139,1245,5384
"2018-11-26 10:10:20","2018-11-27 16:00:00","2018-11-27 16:30:00",4281,1350,5631
"2018-11-26 10:10:20","2018-11-27 17:00:00","2018-11-27 17:30:00",4729,1550,6279
"2018-11-26 10:10:20","2018-11-27 18:00:00","2018-11-27 18:30:00",4786,1530,6316
"2018-11-26 10:10:20","2018-11-27 19:00:00","2018-11-27 19:30:00",4637,1319,5956
"2018-11-26 10:10:20","2018-11-27 20:00:00","2018-11-27 20:30:00",4405,1263,5668
"2018-11-26 10:10:20","2018-11-27 21:00:00","2018-11-27 21:30:00",4147,1187,5334
"2018-11-26 10:10:20","2018-11-27 22:00:00","2018-11-27 22:30:00",3750,1030,4780
"2018-11-27 10:10:21","2018-11-27 23:00:00","2018-11-27 23:30:00",3447,915,4362
"2018-11-27 10:10:21","2018-11-28 00:00:00","2018-11-28 00:30:00",3164,751,3915
"2018-11-27 10:10:21","2018-11-28 01:00:00","2018-11-28 01:30:00",2949,686,3635
"2018-11-27 10:10:21","2018-11-28 02:00:00","2018-11-28 02:30:00",2783,678,3461
"2018-11-27 10:10:21","2018-11-28 03:00:00","2018-11-28 03:30:00",2688,654,3342
"2018-11-27 10:10:21","2018-11-28 04:00:00","2018-11-28 04:30:00",2700,648,3348
"2018-11-27 10:10:21","2018-11-28 05:00:00","2018-11-28 05:30:00",2736,661,3397
"2018-11-27 10:10:21","2018-11-28 06:00:00","2018-11-28 06:30:00",2915,832,3747
"2018-11-27 10:10:21","2018-11-28 07:00:00","2018-11-28 07:30:00",3438,1116,4554
"2018-11-27 10:10:21","2018-11-28 08:00:00","2018-11-28 08:30:00",3933,1230,5163
"2018-11-27 10:10:21","2018-11-28 09:00:00","2018-11-28 09:30:00",4006,1260,5266
"2018-11-27 10:10:21","2018-11-28 10:00:00","2018-11-28 10:30:00",4038,1269,5307
"2018-11-27 10:10:21","2018-11-28 11:00:00","2018-11-28 11:30:00",4061,1250,5311
"2018-11-27 10:10:21","2018-11-28 12:00:00","2018-11-28 12:30:00",4054,1250,5304
"2018-11-27 10:10:21","2018-11-28 13:00:00","2018-11-28 13:30:00",4081,1235,5316
"2018-11-27 10:10:21","2018-11-28 14:00:00","2018-11-28 14:30:00",4045,1220,5265
"2018-11-27 10:10:21","2018-11-28 15:00:00","2018-11-28 15:30:00",4099,1250,5349
"2018-11-27 10:10:21","2018-11-28 16:00:00","2018-11-28 16:30:00",4245,1433,5678
"2018-11-27 10:10:21","2018-11-28 17:00:00","2018-11-28 17:30:00",4721,1560,6281
"2018-11-27 10:10:21","2018-11-28 18:00:00","2018-11-28 18:30:00",4850,1520,6370
"2018-11-27 10:10:21","2018-11-28 19:00:00","2018-11-28 19:30:00",4673,1400,6073
"2018-11-27 10:10:21","2018-11-28 20:00:00","2018-11-28 20:30:00",4442,1310,5752
"2018-11-27 10:10:21","2018-11-28 21:00:00","2018-11-28 21:30:00",4237,1220,5457
"2018-11-27 10:10:21","2018-11-28 22:00:00","2018-11-28 22:30:00",3815,1060,4875
"2018-11-28 10:10:20","2018-11-28 23:00:00","2018-11-28 23:30:00",3445,878,4323
"2018-11-28 10:10:20","2018-11-29 00:00:00","2018-11-29 00:30:00",3177,730,3907
"2018-11-28 10:10:20","2018-11-29 01:00:00","2018-11-29 01:30:00",2992,664,3656
"2018-11-28 10:10:20","2018-11-29 02:00:00","2018-11-29 02:30:00",2826,651,3477
"2018-11-28 10:10:20","2018-11-29 03:00:00","2018-11-29 03:30:00",2740,626,3366
"2018-11-28 10:10:20","2018-11-29 04:00:00","2018-11-29 04:30:00",2713,615,3328
"2018-11-28 10:10:20","2018-11-29 05:00:00","2018-11-29 05:30:00",2752,632,3384
"2018-11-28 10:10:20","2018-11-29 06:00:00","2018-11-29 06:30:00",2955,710,3665
"2018-11-28 10:10:20","2018-11-29 07:00:00","2018-11-29 07:30:00",3490,934,4424
"2018-11-28 10:10:20","2018-11-29 08:00:00","2018-11-29 08:30:00",4054,1179,5233
"2018-11-28 10:10:20","2018-11-29 09:00:00","2018-11-29 09:30:00",4125,1210,5335
"2018-11-28 10:10:20","2018-11-29 10:00:00","2018-11-29 10:30:00",4208,1254,5462
"2018-11-28 10:10:20","2018-11-29 11:00:00","2018-11-29 11:30:00",4183,1225,5408
"2018-11-28 10:10:20","2018-11-29 12:00:00","2018-11-29 12:30:00",4144,1208,5352
"2018-11-28 10:10:20","2018-11-29 13:00:00","2018-11-29 13:30:00",4122,1210,5332
"2018-11-28 10:10:20","2018-11-29 14:00:00","2018-11-29 14:30:00",3993,1184,5177
"2018-11-28 10:10:20","2018-11-29 15:00:00","2018-11-29 15:30:00",4002,1223,5225
"2018-11-28 10:10:20","2018-11-29 16:00:00","2018-11-29 16:30:00",4159,1297,5456
"2018-11-28 10:10:20","2018-11-29 17:00:00","2018-11-29 17:30:00",4661,1494,6155
"2018-11-28 10:10:20","2018-11-29 18:00:00","2018-11-29 18:30:00",4732,1435,6167
"2018-11-28 10:10:20","2018-11-29 19:00:00","2018-11-29 19:30:00",4551,1328,5879
"2018-11-28 10:10:20","2018-11-29 20:00:00","2018-11-29 20:30:00",4357,1255,5612
"2018-11-28 10:10:20","2018-11-29 21:00:00","2018-11-29 21:30:00",4168,1164,5332
"2018-11-28 10:10:20","2018-11-29 22:00:00","2018-11-29 22:30:00",3771,1032,4803
"2018-11-29 10:10:26","2018-11-29 23:00:00","2018-11-29 23:30:00",3467,884,4351
"2018-11-29 10:10:26","2018-11-30 00:00:00","2018-11-30 00:30:00",3335,764,4099
"2018-11-29 10:10:26","2018-11-30 01:00:00","2018-11-30 01:30:00",3077,686,3763
"2018-11-29 10:10:26","2018-11-30 02:00:00","2018-11-30 02:30:00",2876,687,3563
"2018-11-29 10:10:26","2018-11-30 03:00:00","2018-11-30 03:30:00",2779,659,3438
"2018-11-29 10:10:26","2018-11-30 04:00:00","2018-11-30 04:30:00",2768,659,3427
"2018-11-29 10:10:26","2018-11-30 05:00:00","2018-11-30 05:30:00",2770,671,3441
"2018-11-29 10:10:26","2018-11-30 06:00:00","2018-11-30 06:30:00",3004,755,3759
"2018-11-29 10:10:26","2018-11-30 07:00:00","2018-11-30 07:30:00",3556,951,4507
"2018-11-29 10:10:26","2018-11-30 08:00:00","2018-11-30 08:30:00",4107,1194,5301
"2018-11-29 10:10:26","2018-11-30 09:00:00","2018-11-30 09:30:00",4150,1224,5374
"2018-11-29 10:10:26","2018-11-30 10:00:00","2018-11-30 10:30:00",4216,1225,5441
"2018-11-29 10:10:26","2018-11-30 11:00:00","2018-11-30 11:30:00",4230,1219,5449
"2018-11-29 10:10:26","2018-11-30 12:00:00","2018-11-30 12:30:00",4162,1186,5348
"2018-11-29 10:10:26","2018-11-30 13:00:00","2018-11-30 13:30:00",4172,1208,5380
"2018-11-29 10:10:26","2018-11-30 14:00:00","2018-11-30 14:30:00",4106,1162,5268
"2018-11-29 10:10:26","2018-11-30 15:00:00","2018-11-30 15:30:00",4145,1176,5321
"2018-11-29 10:10:26","2018-11-30 16:00:00","2018-11-30 16:30:00",4269,1226,5495
"2018-11-29 10:10:26","2018-11-30 17:00:00","2018-11-30 17:30:00",4601,1423,6024
"2018-11-29 10:10:26","2018-11-30 18:00:00","2018-11-30 18:30:00",4666,1399,6065
"2018-11-29 10:10:26","2018-11-30 19:00:00","2018-11-30 19:30:00",4476,1317,5793
"2018-11-29 10:10:26","2018-11-30 20:00:00","2018-11-30 20:30:00",4248,1229,5477
"2018-11-29 10:10:26","2018-11-30 21:00:00","2018-11-30 21:30:00",3993,1158,5151
"2018-11-29 10:10:26","2018-11-30 22:00:00","2018-11-30 22:30:00",3660,1025,4685
"2018-11-30 10:10:25","2018-11-30 23:00:00","2018-11-30 23:30:00",3446,883,4329
"2018-11-30 10:10:25","2018-12-01 00:00:00","2018-12-01 00:30:00",3311,783,4094
"2018-11-30 10:10:25","2018-12-01 01:00:00","2018-12-01 01:30:00",3025,713,3738
"2018-11-30 10:10:25","2018-12-01 02:00:00","2018-12-01 02:30:00",2810,681,3491
"2018-11-30 10:10:25","2018-12-01 03:00:00","2018-12-01 03:30:00",2693,647,3340
"2018-11-30 10:10:25","2018-12-01 04:00:00","2018-12-01 04:30:00",2634,648,3282
"2018-11-30 10:10:25","2018-12-01 05:00:00","2018-12-01 05:30:00",2610,643,3253
"2018-11-30 10:10:25","2018-12-01 06:00:00","2018-12-01 06:30:00",2677,683,3360
"2018-11-30 10:10:25","2018-12-01 07:00:00","2018-12-01 07:30:00",2874,793,3667
"2018-11-30 10:10:25","2018-12-01 08:00:00","2018-12-01 08:30:00",3180,917,4097
"2018-11-30 10:10:25","2018-12-01 09:00:00","2018-12-01 09:30:00",3478,1049,4527
"2018-11-30 10:10:25","2018-12-01 10:00:00","2018-12-01 10:30:00",3731,1098,4829
"2018-11-30 10:10:25","2018-12-01 11:00:00","2018-12-01 11:30:00",3806,1134,4940
"2018-11-30 10:10:25","2018-12-01 12:00:00","2018-12-01 12:30:00",3860,1145,5005
"2018-11-30 10:10:25","2018-12-01 13:00:00","2018-12-01 13:30:00",3875,1126,5001
"2018-11-30 10:10:25","2018-12-01 14:00:00","2018-12-01 14:30:00",3743,1058,4801
"2018-11-30 10:10:25","2018-12-01 15:00:00","2018-12-01 15:30:00",3723,1058,4781
"2018-11-30 10:10:25","2018-12-01 16:00:00","2018-12-01 16:30:00",3809,1088,4897
"2018-11-30 10:10:25","2018-12-01 17:00:00","2018-12-01 17:30:00",4222,1287,5509
"2018-11-30 10:10:25","2018-12-01 18:00:00","2018-12-01 18:30:00",4322,1321,5643
"2018-11-30 10:10:25","2018-12-01 19:00:00","2018-12-01 19:30:00",4102,1220,5322
"2018-11-30 10:10:25","2018-12-01 20:00:00","2018-12-01 20:30:00",3834,1124,4958
"2018-11-30 10:10:25","2018-12-01 21:00:00","2018-12-01 21:30:00",3649,1059,4708
"2018-11-30 10:10:25","2018-12-01 22:00:00","2018-12-01 22:30:00",3418,976,4394
"2018-12-01 10:10:26","2018-12-01 23:00:00","2018-12-01 23:30:00",3266,829,4095
"2018-12-01 10:10:26","2018-12-02 00:00:00","2018-12-02 00:30:00",3137,724,3861
"2018-12-01 10:10:26","2018-12-02 01:00:00","2018-12-02 01:30:00",2927,679,3606
"2018-12-01 10:10:26","2018-12-02 02:00:00","2018-12-02 02:30:00",2713,653,3366
"2018-12-01 10:10:26","2018-12-02 03:00:00","2018-12-02 03:30:00",2594,607,3201
"2018-12-01 10:10:26","2018-12-02 04:00:00","2018-12-02 04:30:00",2529,564,3093
"2018-12-01 10:10:26","2018-12-02 05:00:00","2018-12-02 05:30:00",2473,571,3044
"2018-12-01 10:10:26","2018-12-02 06:00:00","2018-12-02 06:30:00",2490,630,3120
"2018-12-01 10:10:26","2018-12-02 07:00:00","2018-12-02 07:30:00",2601,709,3310
"2018-12-01 10:10:26","2018-12-02 08:00:00","2018-12-02 08:30:00",2728,780,3508
"2018-12-01 10:10:26","2018-12-02 09:00:00","2018-12-02 09:30:00",2948,908,3856
"2018-12-01 10:10:26","2018-12-02 10:00:00","2018-12-02 10:30:00",3266,999,4265
"2018-12-01 10:10:26","2018-12-02 11:00:00","2018-12-02 11:30:00",3460,1040,4500
"2018-12-01 10:10:26","2018-12-02 12:00:00","2018-12-02 12:30:00",3502,1090,4592
"2018-12-01 10:10:26","2018-12-02 13:00:00","2018-12-02 13:30:00",3568,1085,4653
"2018-12-01 10:10:26","2018-12-02 14:00:00","2018-12-02 14:30:00",3511,1040,4551
"2018-12-01 10:10:26","2018-12-02 15:00:00","2018-12-02 15:30:00",3472,1030,4502
"2018-12-01 10:10:26","2018-12-02 16:00:00","2018-12-02 16:30:00",3539,1180,4719
"2018-12-01 10:10:26","2018-12-02 17:00:00","2018-12-02 17:30:00",4001,1320,5321
"2018-12-01 10:10:26","2018-12-02 18:00:00","2018-12-02 18:30:00",4152,1300,5452
"2018-12-01 10:10:26","2018-12-02 19:00:00","2018-12-02 19:30:00",4020,1210,5230
"2018-12-01 10:10:26","2018-12-02 20:00:00","2018-12-02 20:30:00",3855,1140,4995
"2018-12-01 10:10:26","2018-12-02 21:00:00","2018-12-02 21:30:00",3679,1038,4717
"2018-12-01 10:10:26","2018-12-02 22:00:00","2018-12-02 22:30:00",3382,933,4315
"2018-12-02 10:10:31","2018-12-02 23:00:00","2018-12-02 23:30:00",3129,828,3957
"2018-12-02 10:10:31","2018-12-03 00:00:00","2018-12-03 00:30:00",2977,707,3684
"2018-12-02 10:10:31","2018-12-03 01:00:00","2018-12-03 01:30:00",2782,656,3438
"2018-12-02 10:10:31","2018-12-03 02:00:00","2018-12-03 02:30:00",2633,655,3288
"2018-12-02 10:10:31","2018-12-03 03:00:00","2018-12-03 03:30:00",2569,630,3199
"2018-12-02 10:10:31","2018-12-03 04:00:00","2018-12-03 04:30:00",2543,621,3164
"2018-12-02 10:10:31","2018-12-03 05:00:00","2018-12-03 05:30:00",2552,650,3202
"2018-12-02 10:10:31","2018-12-03 06:00:00","2018-12-03 06:30:00",2758,836,3594
"2018-12-02 10:10:31","2018-12-03 07:00:00","2018-12-03 07:30:00",3307,1115,4422
"2018-12-02 10:10:31","2018-12-03 08:00:00","2018-12-03 08:30:00",3871,1262,5133
"2018-12-02 10:10:31","2018-12-03 09:00:00","2018-12-03 09:30:00",3953,1294,5247
"2018-12-02 10:10:31","2018-12-03 10:00:00","2018-12-03 10:30:00",4052,1298,5350
"2018-12-02 10:10:31","2018-12-03 11:00:00","2018-12-03 11:30:00",4069,1296,5365
"2018-12-02 10:10:31","2018-12-03 12:00:00","2018-12-03 12:30:00",4100,1300,5400
"2018-12-02 10:10:31","2018-12-03 13:00:00","2018-12-03 13:30:00",4108,1250,5358
"2018-12-02 10:10:31","2018-12-03 14:00:00","2018-12-03 14:30:00",4038,1252,5290
"2018-12-02 10:10:31","2018-12-03 15:00:00","2018-12-03 15:30:00",4065,1290,5355
"2018-12-02 10:10:31","2018-12-03 16:00:00","2018-12-03 16:30:00",4232,1460,5692
"2018-12-02 10:10:31","2018-12-03 17:00:00","2018-12-03 17:30:00",4708,1590,6298
"2018-12-02 10:10:31","2018-12-03 18:00:00","2018-12-03 18:30:00",4754,1530,6284
"2018-12-02 10:10:31","2018-12-03 19:00:00","2018-12-03 19:30:00",4548,1410,5958
"2018-12-02 10:10:31","2018-12-03 20:00:00","2018-12-03 20:30:00",4365,1342,5707
"2018-12-02 10:10:31","2018-12-03 21:00:00","2018-12-03 21:30:00",4175,1232,5407
"2018-12-02 10:10:31","2018-12-03 22:00:00","2018-12-03 22:30:00",3759,1076,4835
"2018-12-03 10:10:30","2018-12-03 23:00:00","2018-12-03 23:30:00",3384,898,4282
"2018-12-03 10:10:30","2018-12-04 00:00:00","2018-12-04 00:30:00",3183,770,3953
"2018-12-03 10:10:30","2018-12-04 01:00:00","2018-12-04 01:30:00",2967,705,3672
"2018-12-03 10:10:30","2018-12-04 02:00:00","2018-12-04 02:30:00",2811,689,3500
"2018-12-03 10:10:30","2018-12-04 03:00:00","2018-12-04 03:30:00",2727,646,3373
"2018-12-03 10:10:30","2018-12-04 04:00:00","2018-12-04 04:30:00",2670,645,3315
"2018-12-03 10:10:30","2018-12-04 05:00:00","2018-12-04 05:30:00",2721,666,3387
"2018-12-03 10:10:30","2018-12-04 06:00:00","2018-12-04 06:30:00",2851,771,3622
"2018-12-03 10:10:30","2018-12-04 07:00:00","2018-12-04 07:30:00",3396,1000,4396
"2018-12-03 10:10:30","2018-12-04 08:00:00","2018-12-04 08:30:00",4061,1254,5315
"2018-12-03 10:10:30","2018-12-04 09:00:00","2018-12-04 09:30:00",4083,1273,5356
"2018-12-03 10:10:30","2018-12-04 10:00:00","2018-12-04 10:30:00",4164,1294,5458
"2018-12-03 10:10:30","2018-12-04 11:00:00","2018-12-04 11:30:00",4180,1281,5461
"2018-12-03 10:10:30","2018-12-04 12:00:00","2018-12-04 12:30:00",4244,1271,5515
"2018-12-03 10:10:30","2018-12-04 13:00:00","2018-12-04 13:30:00",4276,1265,5541
"2018-12-03 10:10:30","2018-12-04 14:00:00","2018-12-04 14:30:00",4162,1236,5398
"2018-12-03 10:10:30","2018-12-04 15:00:00","2018-12-04 15:30:00",4237,1271,5508
"2018-12-03 10:10:30","2018-12-04 16:00:00","2018-12-04 16:30:00",4364,1362,5726
"2018-12-03 10:10:30","2018-12-04 17:00:00","2018-12-04 17:30:00",4779,1572,6351
"2018-12-03 10:10:30","2018-12-04 18:00:00","2018-12-04 18:30:00",4849,1515,6364
"2018-12-03 10:10:30","2018-12-04 19:00:00","2018-12-04 19:30:00",4605,1412,6017
"2018-12-03 10:10:30","2018-12-04 20:00:00","2018-12-04 20:30:00",4359,1345,5704
"2018-12-03 10:10:30","2018-12-04 21:00:00","2018-12-04 21:30:00",4137,1249,5386
"2018-12-03 10:10:30","2018-12-04 22:00:00","2018-12-04 22:30:00",3732,1089,4821
"2018-12-04 10:10:36","2018-12-04 23:00:00","2018-12-04 23:30:00",3387,934,4321
"2018-12-04 10:10:36","2018-12-05 00:00:00","2018-12-05 00:30:00",3183,783,3966
"2018-12-04 10:10:36","2018-12-05 01:00:00","2018-12-05 01:30:00",2967,721,3688
"2018-12-04 10:10:36","2018-12-05 02:00:00","2018-12-05 02:30:00",2811,699,3510
"2018-12-04 10:10:36","2018-12-05 03:00:00","2018-12-05 03:30:00",2727,644,3371
"2018-12-04 10:10:36","2018-12-05 04:00:00","2018-12-05 04:30:00",2670,641,3311
"2018-12-04 10:10:36","2018-12-05 05:00:00","2018-12-05 05:30:00",2721,664,3385
"2018-12-04 10:10:36","2018-12-05 06:00:00","2018-12-05 06:30:00",2851,759,3610
"2018-12-04 10:10:36","2018-12-05 07:00:00","2018-12-05 07:30:00",3396,966,4362
"2018-12-04 10:10:36","2018-12-05 08:00:00","2018-12-05 08:30:00",4061,1207,5268
"2018-12-04 10:10:36","2018-12-05 09:00:00","2018-12-05 09:30:00",4083,1227,5310
"2018-12-04 10:10:36","2018-12-05 10:00:00","2018-12-05 10:30:00",4164,1260,5424
"2018-12-04 10:10:36","2018-12-05 11:00:00","2018-12-05 11:30:00",4180,1244,5424
"2018-12-04 10:10:36","2018-12-05 12:00:00","2018-12-05 12:30:00",4244,1233,5477
"2018-12-04 10:10:36","2018-12-05 13:00:00","2018-12-05 13:30:00",4276,1233,5509
"2018-12-04 10:10:36","2018-12-05 14:00:00","2018-12-05 14:30:00",4162,1213,5375
"2018-12-04 10:10:36","2018-12-05 15:00:00","2018-12-05 15:30:00",4237,1244,5481
"2018-12-04 10:10:36","2018-12-05 16:00:00","2018-12-05 16:30:00",4364,1355,5719
"2018-12-04 10:10:36","2018-12-05 17:00:00","2018-12-05 17:30:00",4779,1563,6342
"2018-12-04 10:10:36","2018-12-05 18:00:00","2018-12-05 18:30:00",4849,1509,6358
"2018-12-04 10:10:36","2018-12-05 19:00:00","2018-12-05 19:30:00",4605,1401,6006
"2018-12-04 10:10:36","2018-12-05 20:00:00","2018-12-05 20:30:00",4359,1343,5702
"2018-12-04 10:10:36","2018-12-05 21:00:00","2018-12-05 21:30:00",4137,1244,5381
"2018-12-04 10:10:36","2018-12-05 22:00:00","2018-12-05 22:30:00",3732,1097,4829
"2018-12-05 10:10:35","2018-12-05 23:00:00","2018-12-05 23:30:00",3390,900,4290
"2018-12-05 10:10:35","2018-12-06 00:00:00","2018-12-06 00:30:00",3183,752,3935
"2018-12-05 10:10:35","2018-12-06 01:00:00","2018-12-06 01:30:00",2967,681,3648
"2018-12-05 10:10:35","2018-12-06 02:00:00","2018-12-06 02:30:00",2811,663,3474
"2018-12-05 10:10:35","2018-12-06 03:00:00","2018-12-06 03:30:00",2727,629,3356
"2018-12-05 10:10:35","2018-12-06 04:00:00","2018-12-06 04:30:00",2670,613,3283
"2018-12-05 10:10:35","2018-12-06 05:00:00","2018-12-06 05:30:00",2721,621,3342
"2018-12-05 10:10:35","2018-12-06 06:00:00","2018-12-06 06:30:00",2851,702,3553
"2018-12-05 10:10:35","2018-12-06 07:00:00","2018-12-06 07:30:00",3396,901,4297
"2018-12-05 10:10:35","2018-12-06 08:00:00","2018-12-06 08:30:00",4061,1132,5193
"2018-12-05 10:10:35","2018-12-06 09:00:00","2018-12-06 09:30:00",4083,1144,5227
"2018-12-05 10:10:35","2018-12-06 10:00:00","2018-12-06 10:30:00",4164,1166,5330
"2018-12-05 10:10:35","2018-12-06 11:00:00","2018-12-06 11:30:00",4180,1161,5341
"2018-12-05 10:10:35","2018-12-06 12:00:00","2018-12-06 12:30:00",4244,1170,5414
"2018-12-05 10:10:35","2018-12-06 13:00:00","2018-12-06 13:30:00",4276,1165,5441
"2018-12-05 10:10:35","2018-12-06 14:00:00","2018-12-06 14:30:00",4162,1135,5297
"2018-12-05 10:10:35","2018-12-06 15:00:00","2018-12-06 15:30:00",4237,1162,5399
"2018-12-05 10:10:35","2018-12-06 16:00:00","2018-12-06 16:30:00",4364,1243,5607
"2018-12-05 10:10:35","2018-12-06 17:00:00","2018-12-06 17:30:00",4779,1438,6217
"2018-12-05 10:10:35","2018-12-06 18:00:00","2018-12-06 18:30:00",4849,1388,6237
"2018-12-05 10:10:35","2018-12-06 19:00:00","2018-12-06 19:30:00",4605,1279,5884
"2018-12-05 10:10:35","2018-12-06 20:00:00","2018-12-06 20:30:00",4359,1221,5580
"2018-12-05 10:10:35","2018-12-06 21:00:00","2018-12-06 21:30:00",4137,1154,5291
"2018-12-05 10:10:35","2018-12-06 22:00:00","2018-12-06 22:30:00",3732,1011,4743
"2018-12-06 10:10:35","2018-12-06 23:00:00","2018-12-06 23:30:00",3387,930,4317
"2018-12-06 10:10:35","2018-12-07 00:00:00","2018-12-07 00:30:00",3223,725,3948
"2018-12-06 10:10:35","2018-12-07 01:00:00","2018-12-07 01:30:00",2988,643,3631
"2018-12-06 10:10:35","2018-12-07 02:00:00","2018-12-07 02:30:00",2839,605,3444
"2018-12-06 10:10:35","2018-12-07 03:00:00","2018-12-07 03:30:00",2782,579,3361
"2018-12-06 10:10:35","2018-12-07 04:00:00","2018-12-07 04:30:00",2763,594,3357
"2018-12-06 10:10:35","2018-12-07 05:00:00","2018-12-07 05:30:00",2773,617,3390
"2018-12-06 10:10:35","2018-12-07 06:00:00","2018-12-07 06:30:00",2998,710,3708
"2018-12-06 10:10:35","2018-12-07 07:00:00","2018-12-07 07:30:00",3514,940,4454
"2018-12-06 10:10:35","2018-12-07 08:00:00","2018-12-07 08:30:00",4074,1181,5255
"2018-12-06 10:10:35","2018-12-07 09:00:00","2018-12-07 09:30:00",4078,1197,5275
"2018-12-06 10:10:35","2018-12-07 10:00:00","2018-12-07 10:30:00",4113,1207,5320
"2018-12-06 10:10:35","2018-12-07 11:00:00","2018-12-07 11:30:00",4157,1213,5370
"2018-12-06 10:10:35","2018-12-07 12:00:00","2018-12-07 12:30:00",4168,1234,5402
"2018-12-06 10:10:35","2018-12-07 13:00:00","2018-12-07 13:30:00",4096,1207,5303
"2018-12-06 10:10:35","2018-12-07 14:00:00","2018-12-07 14:30:00",4048,1141,5189
"2018-12-06 10:10:35","2018-12-07 15:00:00","2018-12-07 15:30:00",4039,1144,5183
"2018-12-06 10:10:35","2018-12-07 16:00:00","2018-12-07 16:30:00",4138,1195,5333
"2018-12-06 10:10:35","2018-12-07 17:00:00","2018-12-07 17:30:00",4556,1438,5994
"2018-12-06 10:10:35","2018-12-07 18:00:00","2018-12-07 18:30:00",4594,1410,6004
"2018-12-06 10:10:35","2018-12-07 19:00:00","2018-12-07 19:30:00",4431,1312,5743
"2018-12-06 10:10:35","2018-12-07 20:00:00","2018-12-07 20:30:00",4188,1222,5410
"2018-12-06 10:10:35","2018-12-07 21:00:00","2018-12-07 21:30:00",3997,1134,5131
"2018-12-06 10:10:35","2018-12-07 22:00:00","2018-12-07 22:30:00",3585,1008,4593
"2018-12-07 10:10:11","2018-12-07 23:00:00","2018-12-07 23:30:00",3382,897,4279
"2018-12-07 10:10:11","2018-12-08 00:00:00","2018-12-08 00:30:00",3395,776,4171
"2018-12-07 10:10:11","2018-12-08 01:00:00","2018-12-08 01:30:00",3092,683,3775
"2018-12-07 10:10:11","2018-12-08 02:00:00","2018-12-08 02:30:00",2862,667,3529
"2018-12-07 10:10:11","2018-12-08 03:00:00","2018-12-08 03:30:00",2691,640,3331
"2018-12-07 10:10:11","2018-12-08 04:00:00","2018-12-08 04:30:00",2604,628,3232
"2018-12-07 10:10:11","2018-12-08 05:00:00","2018-12-08 05:30:00",2597,631,3228
"2018-12-07 10:10:11","2018-12-08 06:00:00","2018-12-08 06:30:00",2680,667,3347
"2018-12-07 10:10:11","2018-12-08 07:00:00","2018-12-08 07:30:00",2873,765,3638
"2018-12-07 10:10:11","2018-12-08 08:00:00","2018-12-08 08:30:00",3135,920,4055
"2018-12-07 10:10:11","2018-12-08 09:00:00","2018-12-08 09:30:00",3410,1050,4460
"2018-12-07 10:10:11","2018-12-08 10:00:00","2018-12-08 10:30:00",3648,1109,4757
"2018-12-07 10:10:11","2018-12-08 11:00:00","2018-12-08 11:30:00",3775,1170,4945
"2018-12-07 10:10:11","2018-12-08 12:00:00","2018-12-08 12:30:00",3804,1147,4951
"2018-12-07 10:10:11","2018-12-08 13:00:00","2018-12-08 13:30:00",3776,1154,4930
"2018-12-07 10:10:11","2018-12-08 14:00:00","2018-12-08 14:30:00",3738,1107,4845
"2018-12-07 10:10:11","2018-12-08 15:00:00","2018-12-08 15:30:00",3741,1082,4823
"2018-12-07 10:10:11","2018-12-08 16:00:00","2018-12-08 16:30:00",3850,1133,4983
"2018-12-07 10:10:11","2018-12-08 17:00:00","2018-12-08 17:30:00",4286,1276,5562
"2018-12-07 10:10:11","2018-12-08 18:00:00","2018-12-08 18:30:00",4345,1256,5601
"2018-12-07 10:10:11","2018-12-08 19:00:00","2018-12-08 19:30:00",4162,1172,5334
"2018-12-07 10:10:11","2018-12-08 20:00:00","2018-12-08 20:30:00",3910,1113,5023
"2018-12-07 10:10:11","2018-12-08 21:00:00","2018-12-08 21:30:00",3726,1040,4766
"2018-12-07 10:10:11","2018-12-08 22:00:00","2018-12-08 22:30:00",3458,952,4410
"2018-12-08 10:10:10","2018-12-08 23:00:00","2018-12-08 23:30:00",3313,805,4118
"2018-12-08 10:10:10","2018-12-09 00:00:00","2018-12-09 00:30:00",3165,743,3908
"2018-12-08 10:10:10","2018-12-09 01:00:00","2018-12-09 01:30:00",2922,693,3615
"2018-12-08 10:10:10","2018-12-09 02:00:00","2018-12-09 02:30:00",2763,677,3440
"2018-12-08 10:10:10","2018-12-09 03:00:00","2018-12-09 03:30:00",2648,633,3281
"2018-12-08 10:10:10","2018-12-09 04:00:00","2018-12-09 04:30:00",2583,609,3192
"2018-12-08 10:10:10","2018-12-09 05:00:00","2018-12-09 05:30:00",2550,600,3150
"2018-12-08 10:10:10","2018-12-09 06:00:00","2018-12-09 06:30:00",2569,639,3208
"2018-12-08 10:10:10","2018-12-09 07:00:00","2018-12-09 07:30:00",2679,702,3381
"2018-12-08 10:10:10","2018-12-09 08:00:00","2018-12-09 08:30:00",2801,784,3585
"2018-12-08 10:10:10","2018-12-09 09:00:00","2018-12-09 09:30:00",2997,895,3892
"2018-12-08 10:10:10","2018-12-09 10:00:00","2018-12-09 10:30:00",3270,961,4231
"2018-12-08 10:10:10","2018-12-09 11:00:00","2018-12-09 11:30:00",3456,1016,4472
"2018-12-08 10:10:10","2018-12-09 12:00:00","2018-12-09 12:30:00",3606,1069,4675
"2018-12-08 10:10:10","2018-12-09 13:00:00","2018-12-09 13:30:00",3680,1121,4801
"2018-12-08 10:10:10","2018-12-09 14:00:00","2018-12-09 14:30:00",3597,1089,4686
"2018-12-08 10:10:10","2018-12-09 15:00:00","2018-12-09 15:30:00",3548,1120,4668
"2018-12-08 10:10:10","2018-12-09 16:00:00","2018-12-09 16:30:00",3638,1130,4768
"2018-12-08 10:10:10","2018-12-09 17:00:00","2018-12-09 17:30:00",4015,1324,5339
"2018-12-08 10:10:10","2018-12-09 18:00:00","2018-12-09 18:30:00",4065,1292,5357
"2018-12-08 10:10:10","2018-12-09 19:00:00","2018-12-09 19:30:00",3951,1225,5176
"2018-12-08 10:10:10","2018-12-09 20:00:00","2018-12-09 20:30:00",3809,1131,4940
"2018-12-08 10:10:10","2018-12-09 21:00:00","2018-12-09 21:30:00",3638,1062,4700
"2018-12-08 10:10:10","2018-12-09 22:00:00","2018-12-09 22:30:00",3339,932,4271
"2018-12-09 10:10:16","2018-12-09 23:00:00","2018-12-09 23:30:00",3146,819,3965
"2018-12-09 10:10:16","2018-12-10 00:00:00","2018-12-10 00:30:00",2963,707,3670
"2018-12-09 10:10:16","2018-12-10 01:00:00","2018-12-10 01:30:00",2775,664,3439
"2018-12-09 10:10:16","2018-12-10 02:00:00","2018-12-10 02:30:00",2630,659,3289
"2018-12-09 10:10:16","2018-12-10 03:00:00","2018-12-10 03:30:00",2568,654,3222
"2018-12-09 10:10:16","2018-12-10 04:00:00","2018-12-10 04:30:00",2543,649,3192
"2018-12-09 10:10:16","2018-12-10 05:00:00","2018-12-10 05:30:00",2551,656,3207
"2018-12-09 10:10:16","2018-12-10 06:00:00","2018-12-10 06:30:00",2751,730,3481
"2018-12-09 10:10:16","2018-12-10 07:00:00","2018-12-10 07:30:00",3283,960,4243
"2018-12-09 10:10:16","2018-12-10 08:00:00","2018-12-10 08:30:00",3829,1178,5007
"2018-12-09 10:10:16","2018-12-10 09:00:00","2018-12-10 09:30:00",3908,1206,5114
"2018-12-09 10:10:16","2018-12-10 10:00:00","2018-12-10 10:30:00",4003,1242,5245
"2018-12-09 10:10:16","2018-12-10 11:00:00","2018-12-10 11:30:00",4021,1246,5267
"2018-12-09 10:10:16","2018-12-10 12:00:00","2018-12-10 12:30:00",4050,1246,5296
"2018-12-09 10:10:16","2018-12-10 13:00:00","2018-12-10 13:30:00",4058,1252,5310
"2018-12-09 10:10:16","2018-12-10 14:00:00","2018-12-10 14:30:00",3991,1251,5242
"2018-12-09 10:10:16","2018-12-10 15:00:00","2018-12-10 15:30:00",4016,1253,5269
"2018-12-09 10:10:16","2018-12-10 16:00:00","2018-12-10 16:30:00",4178,1317,5495
"2018-12-09 10:10:16","2018-12-10 17:00:00","2018-12-10 17:30:00",4639,1512,6151
"2018-12-09 10:10:16","2018-12-10 18:00:00","2018-12-10 18:30:00",4683,1475,6158
"2018-12-09 10:10:16","2018-12-10 19:00:00","2018-12-10 19:30:00",4484,1338,5822
"2018-12-09 10:10:16","2018-12-10 20:00:00","2018-12-10 20:30:00",4307,1268,5575
"2018-12-09 10:10:16","2018-12-10 21:00:00","2018-12-10 21:30:00",4122,1162,5284
"2018-12-09 10:10:16","2018-12-10 22:00:00","2018-12-10 22:30:00",3720,1026,4746
"2018-12-10 10:10:15","2018-12-10 23:00:00","2018-12-10 23:30:00",3342,912,4254
"2018-12-10 10:10:15","2018-12-11 00:00:00","2018-12-11 00:30:00",3245,770,4015
"2018-12-10 10:10:15","2018-12-11 01:00:00","2018-12-11 01:30:00",2967,711,3678
"2018-12-10 10:10:15","2018-12-11 02:00:00","2018-12-11 02:30:00",2787,708,3495
"2018-12-10 10:10:15","2018-12-11 03:00:00","2018-12-11 03:30:00",2697,665,3362
"2018-12-10 10:10:15","2018-12-11 04:00:00","2018-12-11 04:30:00",2678,664,3342
"2018-12-10 10:10:15","2018-12-11 05:00:00","2018-12-11 05:30:00",2724,672,3396
"2018-12-10 10:10:15","2018-12-11 06:00:00","2018-12-11 06:30:00",2898,754,3652
"2018-12-10 10:10:15","2018-12-11 07:00:00","2018-12-11 07:30:00",3442,965,4407
"2018-12-10 10:10:15","2018-12-11 08:00:00","2018-12-11 08:30:00",4029,1231,5260
"2018-12-10 10:10:15","2018-12-11 09:00:00","2018-12-11 09:30:00",4059,1253,5312
"2018-12-10 10:10:15","2018-12-11 10:00:00","2018-12-11 10:30:00",4155,1261,5416
"2018-12-10 10:10:15","2018-12-11 11:00:00","2018-12-11 11:30:00",4185,1277,5462
"2018-12-10 10:10:15","2018-12-11 12:00:00","2018-12-11 12:30:00",4180,1255,5435
"2018-12-10 10:10:15","2018-12-11 13:00:00","2018-12-11 13:30:00",4181,1235,5416
"2018-12-10 10:10:15","2018-12-11 14:00:00","2018-12-11 14:30:00",4091,1196,5287
"2018-12-10 10:10:15","2018-12-11 15:00:00","2018-12-11 15:30:00",4142,1204,5346
"2018-12-10 10:10:15","2018-12-11 16:00:00","2018-12-11 16:30:00",4295,1304,5599
"2018-12-10 10:10:15","2018-12-11 17:00:00","2018-12-11 17:30:00",4781,1450,6231
"2018-12-10 10:10:15","2018-12-11 18:00:00","2018-12-11 18:30:00",4819,1432,6251
"2018-12-10 10:10:15","2018-12-11 19:00:00","2018-12-11 19:30:00",4620,1334,5954
"2018-12-10 10:10:15","2018-12-11 20:00:00","2018-12-11 20:30:00",4385,1267,5652
"2018-12-10 10:10:15","2018-12-11 21:00:00","2018-12-11 21:30:00",4163,1179,5342
"2018-12-10 10:10:15","2018-12-11 22:00:00","2018-12-11 22:30:00",3722,1040,4762
"2018-12-11 10:10:15","2018-12-11 23:00:00","2018-12-11 23:30:00",3418,935,4353
"2018-12-11 10:10:15","2018-12-12 00:00:00","2018-12-12 00:30:00",3245,762,4007
"2018-12-11 10:10:15","2018-12-12 01:00:00","2018-12-12 01:30:00",2967,705,3672
"2018-12-11 10:10:15","2018-12-12 02:00:00","2018-12-12 02:30:00",2787,706,3493
"2018-12-11 10:10:15","2018-12-12 03:00:00","2018-12-12 03:30:00",2697,664,3361
"2018-12-11 10:10:15","2018-12-12 04:00:00","2018-12-12 04:30:00",2678,663,3341
"2018-12-11 10:10:15","2018-12-12 05:00:00","2018-12-12 05:30:00",2724,673,3397
"2018-12-11 10:10:15","2018-12-12 06:00:00","2018-12-12 06:30:00",2898,755,3653
"2018-12-11 10:10:15","2018-12-12 07:00:00","2018-12-12 07:30:00",3442,973,4415
"2018-12-11 10:10:15","2018-12-12 08:00:00","2018-12-12 08:30:00",4029,1229,5258
"2018-12-11 10:10:15","2018-12-12 09:00:00","2018-12-12 09:30:00",4059,1262,5321
"2018-12-11 10:10:15","2018-12-12 10:00:00","2018-12-12 10:30:00",4155,1282,5437
"2018-12-11 10:10:15","2018-12-12 11:00:00","2018-12-12 11:30:00",4185,1283,5468
"2018-12-11 10:10:15","2018-12-12 12:00:00","2018-12-12 12:30:00",4180,1288,5468
"2018-12-11 10:10:15","2018-12-12 13:00:00","2018-12-12 13:30:00",4181,1276,5457
"2018-12-11 10:10:15","2018-12-12 14:00:00","2018-12-12 14:30:00",4091,1238,5329
"2018-12-11 10:10:15","2018-12-12 15:00:00","2018-12-12 15:30:00",4142,1238,5380
"2018-12-11 10:10:15","2018-12-12 16:00:00","2018-12-12 16:30:00",4295,1328,5623
"2018-12-11 10:10:15","2018-12-12 17:00:00","2018-12-12 17:30:00",4781,1510,6291
"2018-12-11 10:10:15","2018-12-12 18:00:00","2018-12-12 18:30:00",4819,1480,6299
"2018-12-11 10:10:15","2018-12-12 19:00:00","2018-12-12 19:30:00",4620,1378,5998
"2018-12-11 10:10:15","2018-12-12 20:00:00","2018-12-12 20:30:00",4385,1313,5698
"2018-12-11 10:10:15","2018-12-12 21:00:00","2018-12-12 21:30:00",4163,1224,5387
"2018-12-11 10:10:15","2018-12-12 22:00:00","2018-12-12 22:30:00",3722,1080,4802
"2018-12-12 10:10:20","2018-12-12 23:00:00","2018-12-12 23:30:00",3515,935,4450
"2018-12-12 10:10:20","2018-12-13 00:00:00","2018-12-13 00:30:00",3251,788,4039
"2018-12-12 10:10:20","2018-12-13 01:00:00","2018-12-13 01:30:00",3009,718,3727
"2018-12-12 10:10:20","2018-12-13 02:00:00","2018-12-13 02:30:00",2847,717,3564
"2018-12-12 10:10:20","2018-12-13 03:00:00","2018-12-13 03:30:00",2781,680,3461
"2018-12-12 10:10:20","2018-12-13 04:00:00","2018-12-13 04:30:00",2750,669,3419
"2018-12-12 10:10:20","2018-12-13 05:00:00","2018-12-13 05:30:00",2796,682,3478
"2018-12-12 10:10:20","2018-12-13 06:00:00","2018-12-13 06:30:00",2985,759,3744
"2018-12-12 10:10:20","2018-12-13 07:00:00","2018-12-13 07:30:00",3517,960,4477
"2018-12-12 10:10:20","2018-12-13 08:00:00","2018-12-13 08:30:00",4125,1246,5371
"2018-12-12 10:10:20","2018-12-13 09:00:00","2018-12-13 09:30:00",4137,1289,5426
"2018-12-12 10:10:20","2018-12-13 10:00:00","2018-12-13 10:30:00",4198,1305,5503
"2018-12-12 10:10:20","2018-12-13 11:00:00","2018-12-13 11:30:00",4197,1330,5527
"2018-12-12 10:10:20","2018-12-13 12:00:00","2018-12-13 12:30:00",4240,1310,5550
"2018-12-12 10:10:20","2018-12-13 13:00:00","2018-12-13 13:30:00",4292,1301,5593
"2018-12-12 10:10:20","2018-12-13 14:00:00","2018-12-13 14:30:00",4242,1269,5511
"2018-12-12 10:10:20","2018-12-13 15:00:00","2018-12-13 15:30:00",4246,1285,5531
"2018-12-12 10:10:20","2018-12-13 16:00:00","2018-12-13 16:30:00",4447,1386,5833
"2018-12-12 10:10:20","2018-12-13 17:00:00","2018-12-13 17:30:00",4767,1562,6329
"2018-12-12 10:10:20","2018-12-13 18:00:00","2018-12-13 18:30:00",4836,1546,6382
"2018-12-12 10:10:20","2018-12-13 19:00:00","2018-12-13 19:30:00",4649,1420,6069
"2018-12-12 10:10:20","2018-12-13 20:00:00","2018-12-13 20:30:00",4456,1335,5791
"2018-12-12 10:10:20","2018-12-13 21:00:00","2018-12-13 21:30:00",4219,1253,5472
"2018-12-12 10:10:20","2018-12-13 22:00:00","2018-12-13 22:30:00",3818,1110,4928
"2018-12-13 10:10:25","2018-12-13 23:00:00","2018-12-13 23:30:00",3465,914,4379
"2018-12-13 10:10:25","2018-12-14 00:00:00","2018-12-14 00:30:00",3359,802,4161
"2018-12-13 10:10:25","2018-12-14 01:00:00","2018-12-14 01:30:00",3173,712,3885
"2018-12-13 10:10:25","2018-12-14 02:00:00","2018-12-14 02:30:00",2959,695,3654
"2018-12-13 10:10:25","2018-12-14 03:00:00","2018-12-14 03:30:00",2854,657,3511
"2018-12-13 10:10:25","2018-12-14 04:00:00","2018-12-14 04:30:00",2828,644,3472
"2018-12-13 10:10:25","2018-12-14 05:00:00","2018-12-14 05:30:00",2801,633,3434
"2018-12-13 10:10:25","2018-12-14 06:00:00","2018-12-14 06:30:00",2975,708,3683
"2018-12-13 10:10:25","2018-12-14 07:00:00","2018-12-14 07:30:00",3498,950,4448
"2018-12-13 10:10:25","2018-12-14 08:00:00","2018-12-14 08:30:00",4103,1193,5296
"2018-12-13 10:10:25","2018-12-14 09:00:00","2018-12-14 09:30:00",4083,1172,5255
"2018-12-13 10:10:25","2018-12-14 10:00:00","2018-12-14 10:30:00",4135,1208,5343
"2018-12-13 10:10:25","2018-12-14 11:00:00","2018-12-14 11:30:00",4155,1193,5348
"2018-12-13 10:10:25","2018-12-14 12:00:00","2018-12-14 12:30:00",4157,1168,5325
"2018-12-13 10:10:25","2018-12-14 13:00:00","2018-12-14 13:30:00",4135,1153,5288
"2018-12-13 10:10:25","2018-12-14 14:00:00","2018-12-14 14:30:00",4069,1130,5199
"2018-12-13 10:10:25","2018-12-14 15:00:00","2018-12-14 15:30:00",4101,1131,5232
"2018-12-13 10:10:25","2018-12-14 16:00:00","2018-12-14 16:30:00",4192,1209,5401
"2018-12-13 10:10:25","2018-12-14 17:00:00","2018-12-14 17:30:00",4616,1380,5996
"2018-12-13 10:10:25","2018-12-14 18:00:00","2018-12-14 18:30:00",4653,1325,5978
"2018-12-13 10:10:25","2018-12-14 19:00:00","2018-12-14 19:30:00",4462,1260,5722
"2018-12-13 10:10:25","2018-12-14 20:00:00","2018-12-14 20:30:00",4255,1173,5428
"2018-12-13 10:10:25","2018-12-14 21:00:00","2018-12-14 21:30:00",4044,1095,5139
"2018-12-13 10:10:25","2018-12-14 22:00:00","2018-12-14 22:30:00",3745,992,4737
"2018-12-14 10:10:16","2018-12-14 23:00:00","2018-12-14 23:30:00",3538,876,4414
"2018-12-14 10:10:16","2018-12-15 00:00:00","2018-12-15 00:30:00",3391,759,4150
"2018-12-14 10:10:16","2018-12-15 01:00:00","2018-12-15 01:30:00",3084,680,3764
"2018-12-14 10:10:16","2018-12-15 02:00:00","2018-12-15 02:30:00",2881,657,3538
"2018-12-14 10:10:16","2018-12-15 03:00:00","2018-12-15 03:30:00",2788,616,3404
"2018-12-14 10:10:16","2018-12-15 04:00:00","2018-12-15 04:30:00",2719,609,3328
"2018-12-14 10:10:16","2018-12-15 05:00:00","2018-12-15 05:30:00",2666,615,3281
"2018-12-14 10:10:16","2018-12-15 06:00:00","2018-12-15 06:30:00",2708,647,3355
"2018-12-14 10:10:16","2018-12-15 07:00:00","2018-12-15 07:30:00",2909,755,3664
"2018-12-14 10:10:16","2018-12-15 08:00:00","2018-12-15 08:30:00",3188,908,4096
"2018-12-14 10:10:16","2018-12-15 09:00:00","2018-12-15 09:30:00",3440,1013,4453
"2018-12-14 10:10:16","2018-12-15 10:00:00","2018-12-15 10:30:00",3616,1072,4688
"2018-12-14 10:10:16","2018-12-15 11:00:00","2018-12-15 11:30:00",3715,1117,4832
"2018-12-14 10:10:16","2018-12-15 12:00:00","2018-12-15 12:30:00",3789,1130,4919
"2018-12-14 10:10:16","2018-12-15 13:00:00","2018-12-15 13:30:00",3833,1126,4959
"2018-12-14 10:10:16","2018-12-15 14:00:00","2018-12-15 14:30:00",3758,1031,4789
"2018-12-14 10:10:16","2018-12-15 15:00:00","2018-12-15 15:30:00",3755,1040,4795
"2018-12-14 10:10:16","2018-12-15 16:00:00","2018-12-15 16:30:00",3801,1114,4915
"2018-12-14 10:10:16","2018-12-15 17:00:00","2018-12-15 17:30:00",4207,1290,5497
"2018-12-14 10:10:16","2018-12-15 18:00:00","2018-12-15 18:30:00",4260,1249,5509
"2018-12-14 10:10:16","2018-12-15 19:00:00","2018-12-15 19:30:00",4082,1167,5249
"2018-12-14 10:10:16","2018-12-15 20:00:00","2018-12-15 20:30:00",3925,1095,5020
"2018-12-14 10:10:16","2018-12-15 21:00:00","2018-12-15 21:30:00",3724,1016,4740
"2018-12-14 10:10:16","2018-12-15 22:00:00","2018-12-15 22:30:00",3521,936,4457
"2018-12-15 10:10:21","2018-12-15 23:00:00","2018-12-15 23:30:00",3375,900,4275
"2018-12-15 10:10:21","2018-12-16 00:00:00","2018-12-16 00:30:00",3219,750,3969
"2018-12-15 10:10:21","2018-12-16 01:00:00","2018-12-16 01:30:00",2996,687,3683
"2018-12-15 10:10:21","2018-12-16 02:00:00","2018-12-16 02:30:00",2758,664,3422
"2018-12-15 10:10:21","2018-12-16 03:00:00","2018-12-16 03:30:00",2674,618,3292
"2018-12-15 10:10:21","2018-12-16 04:00:00","2018-12-16 04:30:00",2627,615,3242
"2018-12-15 10:10:21","2018-12-16 05:00:00","2018-12-16 05:30:00",2602,604,3206
"2018-12-15 10:10:21","2018-12-16 06:00:00","2018-12-16 06:30:00",2657,631,3288
"2018-12-15 10:10:21","2018-12-16 07:00:00","2018-12-16 07:30:00",2755,709,3464
"2018-12-15 10:10:21","2018-12-16 08:00:00","2018-12-16 08:30:00",2923,802,3725
"2018-12-15 10:10:21","2018-12-16 09:00:00","2018-12-16 09:30:00",3093,903,3996
"2018-12-15 10:10:21","2018-12-16 10:00:00","2018-12-16 10:30:00",3383,991,4374
"2018-12-15 10:10:21","2018-12-16 11:00:00","2018-12-16 11:30:00",3542,1042,4584
"2018-12-15 10:10:21","2018-12-16 12:00:00","2018-12-16 12:30:00",3597,1099,4696
"2018-12-15 10:10:21","2018-12-16 13:00:00","2018-12-16 13:30:00",3659,1122,4781
"2018-12-15 10:10:21","2018-12-16 14:00:00","2018-12-16 14:30:00",3622,1087,4709
"2018-12-15 10:10:21","2018-12-16 15:00:00","2018-12-16 15:30:00",3555,1096,4651
"2018-12-15 10:10:21","2018-12-16 16:00:00","2018-12-16 16:30:00",3619,1152,4771
"2018-12-15 10:10:21","2018-12-16 17:00:00","2018-12-16 17:30:00",3991,1315,5306
"2018-12-15 10:10:21","2018-12-16 18:00:00","2018-12-16 18:30:00",4122,1307,5429
"2018-12-15 10:10:21","2018-12-16 19:00:00","2018-12-16 19:30:00",4038,1248,5286
"2018-12-15 10:10:21","2018-12-16 20:00:00","2018-12-16 20:30:00",3935,1157,5092
"2018-12-15 10:10:21","2018-12-16 21:00:00","2018-12-16 21:30:00",3748,1114,4862
"2018-12-15 10:10:21","2018-12-16 22:00:00","2018-12-16 22:30:00",3434,982,4416
"2018-12-16 10:10:20","2018-12-16 23:00:00","2018-12-16 23:30:00",3291,885,4176
"2018-12-16 10:10:20","2018-12-17 00:00:00","2018-12-17 00:30:00",3062,775,3837
"2018-12-16 10:10:20","2018-12-17 01:00:00","2018-12-17 01:30:00",2828,713,3541
"2018-12-16 10:10:20","2018-12-17 02:00:00","2018-12-17 02:30:00",2663,701,3364
"2018-12-16 10:10:20","2018-12-17 03:00:00","2018-12-17 03:30:00",2598,694,3292
"2018-12-16 10:10:20","2018-12-17 04:00:00","2018-12-17 04:30:00",2582,689,3271
"2018-12-16 10:10:20","2018-12-17 05:00:00","2018-12-17 05:30:00",2603,704,3307
"2018-12-16 10:10:20","2018-12-17 06:00:00","2018-12-17 06:30:00",2789,850,3639
"2018-12-16 10:10:20","2018-12-17 07:00:00","2018-12-17 07:30:00",3322,1100,4422
"2018-12-16 10:10:20","2018-12-17 08:00:00","2018-12-17 08:30:00",3943,1250,5193
"2018-12-16 10:10:20","2018-12-17 09:00:00","2018-12-17 09:30:00",3986,1280,5266
"2018-12-16 10:10:20","2018-12-17 10:00:00","2018-12-17 10:30:00",4090,1291,5381
"2018-12-16 10:10:20","2018-12-17 11:00:00","2018-12-17 11:30:00",4107,1290,5397
"2018-12-16 10:10:20","2018-12-17 12:00:00","2018-12-17 12:30:00",4094,1280,5374
"2018-12-16 10:10:20","2018-12-17 13:00:00","2018-12-17 13:30:00",4132,1281,5413
"2018-12-16 10:10:20","2018-12-17 14:00:00","2018-12-17 14:30:00",4056,1248,5304
"2018-12-16 10:10:20","2018-12-17 15:00:00","2018-12-17 15:30:00",4083,1264,5347
"2018-12-16 10:10:20","2018-12-17 16:00:00","2018-12-17 16:30:00",4258,1450,5708
"2018-12-16 10:10:20","2018-12-17 17:00:00","2018-12-17 17:30:00",4711,1560,6271
"2018-12-16 10:10:20","2018-12-17 18:00:00","2018-12-17 18:30:00",4732,1500,6232
"2018-12-16 10:10:20","2018-12-17 19:00:00","2018-12-17 19:30:00",4538,1387,5925
"2018-12-16 10:10:20","2018-12-17 20:00:00","2018-12-17 20:30:00",4326,1304,5630
"2018-12-16 10:10:20","2018-12-17 21:00:00","2018-12-17 21:30:00",4094,1216,5310
"2018-12-16 10:10:20","2018-12-17 22:00:00","2018-12-17 22:30:00",3770,1085,4855
"2018-12-17 10:10:26","2018-12-17 23:00:00","2018-12-17 23:30:00",3409,918,4327
"2018-12-17 10:10:26","2018-12-18 00:00:00","2018-12-18 00:30:00",3232,699,3931
"2018-12-17 10:10:26","2018-12-18 01:00:00","2018-12-18 01:30:00",2947,640,3587
"2018-12-17 10:10:26","2018-12-18 02:00:00","2018-12-18 02:30:00",2773,633,3406
"2018-12-17 10:10:26","2018-12-18 03:00:00","2018-12-18 03:30:00",2652,617,3269
"2018-12-17 10:10:26","2018-12-18 04:00:00","2018-12-18 04:30:00",2646,613,3259
"2018-12-17 10:10:26","2018-12-18 05:00:00","2018-12-18 05:30:00",2669,627,3296
"2018-12-17 10:10:26","2018-12-18 06:00:00","2018-12-18 06:30:00",2875,703,3578
"2018-12-17 10:10:26","2018-12-18 07:00:00","2018-12-18 07:30:00",3394,921,4315
"2018-12-17 10:10:26","2018-12-18 08:00:00","2018-12-18 08:30:00",3999,1181,5180
"2018-12-17 10:10:26","2018-12-18 09:00:00","2018-12-18 09:30:00",4022,1222,5244
"2018-12-17 10:10:26","2018-12-18 10:00:00","2018-12-18 10:30:00",4124,1231,5355
"2018-12-17 10:10:26","2018-12-18 11:00:00","2018-12-18 11:30:00",4134,1237,5371
"2018-12-17 10:10:26","2018-12-18 12:00:00","2018-12-18 12:30:00",4121,1231,5352
"2018-12-17 10:10:26","2018-12-18 13:00:00","2018-12-18 13:30:00",4139,1207,5346
"2018-12-17 10:10:26","2018-12-18 14:00:00","2018-12-18 14:30:00",4122,1180,5302
"2018-12-17 10:10:26","2018-12-18 15:00:00","2018-12-18 15:30:00",4146,1205,5351
"2018-12-17 10:10:26","2018-12-18 16:00:00","2018-12-18 16:30:00",4336,1302,5638
"2018-12-17 10:10:26","2018-12-18 17:00:00","2018-12-18 17:30:00",4756,1462,6218
"2018-12-17 10:10:26","2018-12-18 18:00:00","2018-12-18 18:30:00",4774,1423,6197
"2018-12-17 10:10:26","2018-12-18 19:00:00","2018-12-18 19:30:00",4627,1319,5946
"2018-12-17 10:10:26","2018-12-18 20:00:00","2018-12-18 20:30:00",4463,1279,5742
"2018-12-17 10:10:26","2018-12-18 21:00:00","2018-12-18 21:30:00",4247,1173,5420
"2018-12-17 10:10:26","2018-12-18 22:00:00","2018-12-18 22:30:00",3891,1055,4946
"2018-12-18 10:10:25","2018-12-18 23:00:00","2018-12-18 23:30:00",3572,908,4480
"2018-12-18 10:10:25","2018-12-19 00:00:00","2018-12-19 00:30:00",3349,756,4105
"2018-12-18 10:10:25","2018-12-19 01:00:00","2018-12-19 01:30:00",3084,689,3773
"2018-12-18 10:10:25","2018-12-19 02:00:00","2018-12-19 02:30:00",2901,669,3570
"2018-12-18 10:10:25","2018-12-19 03:00:00","2018-12-19 03:30:00",2791,654,3445
"2018-12-18 10:10:25","2018-12-19 04:00:00","2018-12-19 04:30:00",2785,660,3445
"2018-12-18 10:10:25","2018-12-19 05:00:00","2018-12-19 05:30:00",2806,666,3472
"2018-12-18 10:10:25","2018-12-19 06:00:00","2018-12-19 06:30:00",3015,744,3759
"2018-12-18 10:10:25","2018-12-19 07:00:00","2018-12-19 07:30:00",3555,971,4526
"2018-12-18 10:10:25","2018-12-19 08:00:00","2018-12-19 08:30:00",4171,1233,5404
"2018-12-18 10:10:25","2018-12-19 09:00:00","2018-12-19 09:30:00",4179,1281,5460
"2018-12-18 10:10:25","2018-12-19 10:00:00","2018-12-19 10:30:00",4260,1276,5536
"2018-12-18 10:10:25","2018-12-19 11:00:00","2018-12-19 11:30:00",4259,1277,5536
"2018-12-18 10:10:25","2018-12-19 12:00:00","2018-12-19 12:30:00",4233,1270,5503
"2018-12-18 10:10:25","2018-12-19 13:00:00","2018-12-19 13:30:00",4237,1256,5493
"2018-12-18 10:10:25","2018-12-19 14:00:00","2018-12-19 14:30:00",4206,1239,5445
"2018-12-18 10:10:25","2018-12-19 15:00:00","2018-12-19 15:30:00",4218,1274,5492
"2018-12-18 10:10:25","2018-12-19 16:00:00","2018-12-19 16:30:00",4396,1366,5762
"2018-12-18 10:10:25","2018-12-19 17:00:00","2018-12-19 17:30:00",4810,1523,6333
"2018-12-18 10:10:25","2018-12-19 18:00:00","2018-12-19 18:30:00",4813,1482,6295
"2018-12-18 10:10:25","2018-12-19 19:00:00","2018-12-19 19:30:00",4650,1371,6021
"2018-12-18 10:10:25","2018-12-19 20:00:00","2018-12-19 20:30:00",4474,1332,5806
"2018-12-18 10:10:25","2018-12-19 21:00:00","2018-12-19 21:30:00",4240,1229,5469
"2018-12-18 10:10:25","2018-12-19 22:00:00","2018-12-19 22:30:00",3878,1099,4977
"2018-12-19 10:10:31","2018-12-19 23:00:00","2018-12-19 23:30:00",3558,923,4481
"2018-12-19 10:10:31","2018-12-20 00:00:00","2018-12-20 00:30:00",3404,774,4178
"2018-12-19 10:10:31","2018-12-20 01:00:00","2018-12-20 01:30:00",3120,705,3825
"2018-12-19 10:10:31","2018-12-20 02:00:00","2018-12-20 02:30:00",2959,684,3643
"2018-12-19 10:10:31","2018-12-20 03:00:00","2018-12-20 03:30:00",2863,669,3532
"2018-12-19 10:10:31","2018-12-20 04:00:00","2018-12-20 04:30:00",2828,661,3489
"2018-12-19 10:10:31","2018-12-20 05:00:00","2018-12-20 05:30:00",2875,671,3546
"2018-12-19 10:10:31","2018-12-20 06:00:00","2018-12-20 06:30:00",3062,767,3829
"2018-12-19 10:10:31","2018-12-20 07:00:00","2018-12-20 07:30:00",3571,990,4561
"2018-12-19 10:10:31","2018-12-20 08:00:00","2018-12-20 08:30:00",4172,1246,5418
"2018-12-19 10:10:31","2018-12-20 09:00:00","2018-12-20 09:30:00",4217,1307,5524
"2018-12-19 10:10:31","2018-12-20 10:00:00","2018-12-20 10:30:00",4303,1298,5601
"2018-12-19 10:10:31","2018-12-20 11:00:00","2018-12-20 11:30:00",4283,1300,5583
"2018-12-19 10:10:31","2018-12-20 12:00:00","2018-12-20 12:30:00",4268,1281,5549
"2018-12-19 10:10:31","2018-12-20 13:00:00","2018-12-20 13:30:00",4247,1268,5515
"2018-12-19 10:10:31","2018-12-20 14:00:00","2018-12-20 14:30:00",4191,1231,5422
"2018-12-19 10:10:31","2018-12-20 15:00:00","2018-12-20 15:30:00",4158,1249,5407
"2018-12-19 10:10:31","2018-12-20 16:00:00","2018-12-20 16:30:00",4298,1312,5610
"2018-12-19 10:10:31","2018-12-20 17:00:00","2018-12-20 17:30:00",4789,1492,6281
"2018-12-19 10:10:31","2018-12-20 18:00:00","2018-12-20 18:30:00",4839,1444,6283
"2018-12-19 10:10:31","2018-12-20 19:00:00","2018-12-20 19:30:00",4675,1335,6010
"2018-12-19 10:10:31","2018-12-20 20:00:00","2018-12-20 20:30:00",4496,1300,5796
"2018-12-19 10:10:31","2018-12-20 21:00:00","2018-12-20 21:30:00",4245,1202,5447
"2018-12-19 10:10:31","2018-12-20 22:00:00","2018-12-20 22:30:00",3920,1081,5001
"2018-12-20 10:10:26","2018-12-20 23:00:00","2018-12-20 23:30:00",3515,935,4450
"2018-12-20 10:10:26","2018-12-21 00:00:00","2018-12-21 00:30:00",3357,793,4150
"2018-12-20 10:10:26","2018-12-21 01:00:00","2018-12-21 01:30:00",3103,727,3830
"2018-12-20 10:10:26","2018-12-21 02:00:00","2018-12-21 02:30:00",2900,704,3604
"2018-12-20 10:10:26","2018-12-21 03:00:00","2018-12-21 03:30:00",2813,683,3496
"2018-12-20 10:10:26","2018-12-21 04:00:00","2018-12-21 04:30:00",2757,668,3425
"2018-12-20 10:10:26","2018-12-21 05:00:00","2018-12-21 05:30:00",2785,682,3467
"2018-12-20 10:10:26","2018-12-21 06:00:00","2018-12-21 06:30:00",3024,770,3794
"2018-12-20 10:10:26","2018-12-21 07:00:00","2018-12-21 07:30:00",3485,993,4478
"2018-12-20 10:10:26","2018-12-21 08:00:00","2018-12-21 08:30:00",4079,1249,5328
"2018-12-20 10:10:26","2018-12-21 09:00:00","2018-12-21 09:30:00",4133,1280,5413
"2018-12-20 10:10:26","2018-12-21 10:00:00","2018-12-21 10:30:00",4212,1288,5500
"2018-12-20 10:10:26","2018-12-21 11:00:00","2018-12-21 11:30:00",4216,1282,5498
"2018-12-20 10:10:26","2018-12-21 12:00:00","2018-12-21 12:30:00",4235,1284,5519
"2018-12-20 10:10:26","2018-12-21 13:00:00","2018-12-21 13:30:00",4264,1248,5512
"2018-12-20 10:10:26","2018-12-21 14:00:00","2018-12-21 14:30:00",4234,1211,5445
"2018-12-20 10:10:26","2018-12-21 15:00:00","2018-12-21 15:30:00",4248,1207,5455
"2018-12-20 10:10:26","2018-12-21 16:00:00","2018-12-21 16:30:00",4408,1295,5703
"2018-12-20 10:10:26","2018-12-21 17:00:00","2018-12-21 17:30:00",4683,1408,6091
"2018-12-20 10:10:26","2018-12-21 18:00:00","2018-12-21 18:30:00",4709,1367,6076
"2018-12-20 10:10:26","2018-12-21 19:00:00","2018-12-21 19:30:00",4503,1281,5784
"2018-12-20 10:10:26","2018-12-21 20:00:00","2018-12-21 20:30:00",4311,1199,5510
"2018-12-20 10:10:26","2018-12-21 21:00:00","2018-12-21 21:30:00",4098,1126,5224
"2018-12-20 10:10:26","2018-12-21 22:00:00","2018-12-21 22:30:00",3803,1011,4814
"2018-12-21 10:10:30","2018-12-21 23:00:00","2018-12-21 23:30:00",3498,968,4466
"2018-12-21 10:10:30","2018-12-22 00:00:00","2018-12-22 00:30:00",3347,764,4111
"2018-12-21 10:10:30","2018-12-22 01:00:00","2018-12-22 01:30:00",3087,667,3754
"2018-12-21 10:10:30","2018-12-22 02:00:00","2018-12-22 02:30:00",2848,640,3488
"2018-12-21 10:10:30","2018-12-22 03:00:00","2018-12-22 03:30:00",2719,599,3318
"2018-12-21 10:10:30","2018-12-22 04:00:00","2018-12-22 04:30:00",2633,572,3205
"2018-12-21 10:10:30","2018-12-22 05:00:00","2018-12-22 05:30:00",2620,578,3198
"2018-12-21 10:10:30","2018-12-22 06:00:00","2018-12-22 06:30:00",2684,614,3298
"2018-12-21 10:10:30","2018-12-22 07:00:00","2018-12-22 07:30:00",2871,708,3579
"2018-12-21 10:10:30","2018-12-22 08:00:00","2018-12-22 08:30:00",3152,859,4011
"2018-12-21 10:10:30","2018-12-22 09:00:00","2018-12-22 09:30:00",3410,1010,4420
"2018-12-21 10:10:30","2018-12-22 10:00:00","2018-12-22 10:30:00",3693,1097,4790
"2018-12-21 10:10:30","2018-12-22 11:00:00","2018-12-22 11:30:00",3845,1134,4979
"2018-12-21 10:10:30","2018-12-22 12:00:00","2018-12-22 12:30:00",3899,1176,5075
"2018-12-21 10:10:30","2018-12-22 13:00:00","2018-12-22 13:30:00",3933,1160,5093
"2018-12-21 10:10:30","2018-12-22 14:00:00","2018-12-22 14:30:00",3865,1099,4964
"2018-12-21 10:10:30","2018-12-22 15:00:00","2018-12-22 15:30:00",3876,1116,4992
"2018-12-21 10:10:30","2018-12-22 16:00:00","2018-12-22 16:30:00",3954,1184,5138
"2018-12-21 10:10:30","2018-12-22 17:00:00","2018-12-22 17:30:00",4246,1280,5526
"2018-12-21 10:10:30","2018-12-22 18:00:00","2018-12-22 18:30:00",4360,1290,5650
"2018-12-21 10:10:30","2018-12-22 19:00:00","2018-12-22 19:30:00",4138,1187,5325
"2018-12-21 10:10:30","2018-12-22 20:00:00","2018-12-22 20:30:00",3959,1081,5040
"2018-12-21 10:10:30","2018-12-22 21:00:00","2018-12-22 21:30:00",3755,1004,4759
"2018-12-21 10:10:30","2018-12-22 22:00:00","2018-12-22 22:30:00",3459,930,4389
"2018-12-22 10:10:35","2018-12-22 23:00:00","2018-12-22 23:30:00",3305,931,4236
"2018-12-22 10:10:35","2018-12-23 00:00:00","2018-12-23 00:30:00",3213,757,3970
"2018-12-22 10:10:35","2018-12-23 01:00:00","2018-12-23 01:30:00",2990,706,3696
"2018-12-22 10:10:35","2018-12-23 02:00:00","2018-12-23 02:30:00",2786,690,3476
"2018-12-22 10:10:35","2018-12-23 03:00:00","2018-12-23 03:30:00",2626,651,3277
"2018-12-22 10:10:35","2018-12-23 04:00:00","2018-12-23 04:30:00",2581,630,3211
"2018-12-22 10:10:35","2018-12-23 05:00:00","2018-12-23 05:30:00",2552,646,3198
"2018-12-22 10:10:35","2018-12-23 06:00:00","2018-12-23 06:30:00",2541,664,3205
"2018-12-22 10:10:35","2018-12-23 07:00:00","2018-12-23 07:30:00",2683,728,3411
"2018-12-22 10:10:35","2018-12-23 08:00:00","2018-12-23 08:30:00",2852,839,3691
"2018-12-22 10:10:35","2018-12-23 09:00:00","2018-12-23 09:30:00",3088,936,4024
"2018-12-22 10:10:35","2018-12-23 10:00:00","2018-12-23 10:30:00",3409,1012,4421
"2018-12-22 10:10:35","2018-12-23 11:00:00","2018-12-23 11:30:00",3594,1072,4666
"2018-12-22 10:10:35","2018-12-23 12:00:00","2018-12-23 12:30:00",3683,1128,4811
"2018-12-22 10:10:35","2018-12-23 13:00:00","2018-12-23 13:30:00",3756,1163,4919
"2018-12-22 10:10:35","2018-12-23 14:00:00","2018-12-23 14:30:00",3663,1096,4759
"2018-12-22 10:10:35","2018-12-23 15:00:00","2018-12-23 15:30:00",3604,1107,4711
"2018-12-22 10:10:35","2018-12-23 16:00:00","2018-12-23 16:30:00",3635,1149,4784
"2018-12-22 10:10:35","2018-12-23 17:00:00","2018-12-23 17:30:00",4059,1316,5375
"2018-12-22 10:10:35","2018-12-23 18:00:00","2018-12-23 18:30:00",4200,1334,5534
"2018-12-22 10:10:35","2018-12-23 19:00:00","2018-12-23 19:30:00",4096,1250,5346
"2018-12-22 10:10:35","2018-12-23 20:00:00","2018-12-23 20:30:00",3985,1193,5178
"2018-12-22 10:10:35","2018-12-23 21:00:00","2018-12-23 21:30:00",3810,1109,4919
"2018-12-22 10:10:35","2018-12-23 22:00:00","2018-12-23 22:30:00",3559,999,4558
"2018-12-23 10:10:35","2018-12-23 23:00:00","2018-12-23 23:30:00",3169,896,4065
"2018-12-23 10:10:35","2018-12-24 00:00:00","2018-12-24 00:30:00",3253,762,4015
"2018-12-23 10:10:35","2018-12-24 01:00:00","2018-12-24 01:30:00",2925,701,3626
"2018-12-23 10:10:35","2018-12-24 02:00:00","2018-12-24 02:30:00",2670,691,3361
"2018-12-23 10:10:35","2018-12-24 03:00:00","2018-12-24 03:30:00",2490,666,3156
"2018-12-23 10:10:35","2018-12-24 04:00:00","2018-12-24 04:30:00",2422,667,3089
"2018-12-23 10:10:35","2018-12-24 05:00:00","2018-12-24 05:30:00",2431,697,3128
"2018-12-23 10:10:35","2018-12-24 06:00:00","2018-12-24 06:30:00",2500,758,3258
"2018-12-23 10:10:35","2018-12-24 07:00:00","2018-12-24 07:30:00",2712,986,3698
"2018-12-23 10:10:35","2018-12-24 08:00:00","2018-12-24 08:30:00",3049,1227,4276
"2018-12-23 10:10:35","2018-12-24 09:00:00","2018-12-24 09:30:00",3265,1255,4520
"2018-12-23 10:10:35","2018-12-24 10:00:00","2018-12-24 10:30:00",3535,1300,4835
"2018-12-23 10:10:35","2018-12-24 11:00:00","2018-12-24 11:30:00",3620,1266,4886
"2018-12-23 10:10:35","2018-12-24 12:00:00","2018-12-24 12:30:00",3656,1263,4919
"2018-12-23 10:10:35","2018-12-24 13:00:00","2018-12-24 13:30:00",3600,1287,4887
"2018-12-23 10:10:35","2018-12-24 14:00:00","2018-12-24 14:30:00",3497,1235,4732
"2018-12-23 10:10:35","2018-12-24 15:00:00","2018-12-24 15:30:00",3470,1248,4718
"2018-12-23 10:10:35","2018-12-24 16:00:00","2018-12-24 16:30:00",3545,1366,4911
"2018-12-23 10:10:35","2018-12-24 17:00:00","2018-12-24 17:30:00",4092,1531,5623
"2018-12-23 10:10:35","2018-12-24 18:00:00","2018-12-24 18:30:00",4093,1499,5592
"2018-12-23 10:10:35","2018-12-24 19:00:00","2018-12-24 19:30:00",3862,1398,5260
"2018-12-23 10:10:35","2018-12-24 20:00:00","2018-12-24 20:30:00",3711,1316,5027
"2018-12-23 10:10:35","2018-12-24 21:00:00","2018-12-24 21:30:00",3484,1238,4722
"2018-12-23 10:10:35","2018-12-24 22:00:00","2018-12-24 22:30:00",3317,1084,4401
"2018-12-24 10:10:35","2018-12-24 23:00:00","2018-12-24 23:30:00",3212,944,4156
"2018-12-24 10:10:35","2018-12-25 00:00:00","2018-12-25 00:30:00",3026,765,3791
"2018-12-24 10:10:35","2018-12-25 01:00:00","2018-12-25 01:30:00",2787,688,3475
"2018-12-24 10:10:35","2018-12-25 02:00:00","2018-12-25 02:30:00",2483,671,3154
"2018-12-24 10:10:35","2018-12-25 03:00:00","2018-12-25 03:30:00",2283,645,2928
"2018-12-24 10:10:35","2018-12-25 04:00:00","2018-12-25 04:30:00",2254,645,2899
"2018-12-24 10:10:35","2018-12-25 05:00:00","2018-12-25 05:30:00",2230,656,2886
"2018-12-24 10:10:35","2018-12-25 06:00:00","2018-12-25 06:30:00",2336,722,3058
"2018-12-24 10:10:35","2018-12-25 07:00:00","2018-12-25 07:30:00",2484,931,3415
"2018-12-24 10:10:35","2018-12-25 08:00:00","2018-12-25 08:30:00",2705,1169,3874
"2018-12-24 10:10:35","2018-12-25 09:00:00","2018-12-25 09:30:00",3024,1194,4218
"2018-12-24 10:10:35","2018-12-25 10:00:00","2018-12-25 10:30:00",3446,1187,4633
"2018-12-24 10:10:35","2018-12-25 11:00:00","2018-12-25 11:30:00",3612,1176,4788
"2018-12-24 10:10:35","2018-12-25 12:00:00","2018-12-25 12:30:00",3678,1166,4844
"2018-12-24 10:10:35","2018-12-25 13:00:00","2018-12-25 13:30:00",3800,1156,4956
"2018-12-24 10:10:35","2018-12-25 14:00:00","2018-12-25 14:30:00",3757,1132,4889
"2018-12-24 10:10:35","2018-12-25 15:00:00","2018-12-25 15:30:00",3545,1152,4697
"2018-12-24 10:10:35","2018-12-25 16:00:00","2018-12-25 16:30:00",3329,1226,4555
"2018-12-24 10:10:35","2018-12-25 17:00:00","2018-12-25 17:30:00",3311,1402,4713
"2018-12-24 10:10:35","2018-12-25 18:00:00","2018-12-25 18:30:00",3179,1381,4560
"2018-12-24 10:10:35","2018-12-25 19:00:00","2018-12-25 19:30:00",3076,1278,4354
"2018-12-24 10:10:35","2018-12-25 20:00:00","2018-12-25 20:30:00",3050,1227,4277
"2018-12-24 10:10:35","2018-12-25 21:00:00","2018-12-25 21:30:00",2985,1144,4129
"2018-12-24 10:10:35","2018-12-25 22:00:00","2018-12-25 22:30:00",2877,1032,3909
"2018-12-25 10:10:35","2018-12-25 23:00:00","2018-12-25 23:30:00",2904,824,3728
"2018-12-25 10:10:35","2018-12-26 00:00:00","2018-12-26 00:30:00",2784,712,3496
"2018-12-25 10:10:35","2018-12-26 01:00:00","2018-12-26 01:30:00",2557,658,3215
"2018-12-25 10:10:35","2018-12-26 02:00:00","2018-12-26 02:30:00",2344,629,2973
"2018-12-25 10:10:35","2018-12-26 03:00:00","2018-12-26 03:30:00",2239,588,2827
"2018-12-25 10:10:35","2018-12-26 04:00:00","2018-12-26 04:30:00",2168,572,2740
"2018-12-25 10:10:35","2018-12-26 05:00:00","2018-12-26 05:30:00",2138,567,2705
"2018-12-25 10:10:35","2018-12-26 06:00:00","2018-12-26 06:30:00",2154,586,2740
"2018-12-25 10:10:35","2018-12-26 07:00:00","2018-12-26 07:30:00",2250,636,2886
"2018-12-25 10:10:35","2018-12-26 08:00:00","2018-12-26 08:30:00",2341,697,3038
"2018-12-25 10:10:35","2018-12-26 09:00:00","2018-12-26 09:30:00",2476,766,3242
"2018-12-25 10:10:35","2018-12-26 10:00:00","2018-12-26 10:30:00",2806,892,3698
"2018-12-25 10:10:35","2018-12-26 11:00:00","2018-12-26 11:30:00",3087,956,4043
"2018-12-25 10:10:35","2018-12-26 12:00:00","2018-12-26 12:30:00",3248,1007,4255
"2018-12-25 10:10:35","2018-12-26 13:00:00","2018-12-26 13:30:00",3345,1067,4412
"2018-12-25 10:10:35","2018-12-26 14:00:00","2018-12-26 14:30:00",3312,1038,4350
"2018-12-25 10:10:35","2018-12-26 15:00:00","2018-12-26 15:30:00",3256,1026,4282
"2018-12-25 10:10:35","2018-12-26 16:00:00","2018-12-26 16:30:00",3328,1054,4382
"2018-12-25 10:10:35","2018-12-26 17:00:00","2018-12-26 17:30:00",3604,1194,4798
"2018-12-25 10:10:35","2018-12-26 18:00:00","2018-12-26 18:30:00",3636,1185,4821
"2018-12-25 10:10:35","2018-12-26 19:00:00","2018-12-26 19:30:00",3526,1118,4644
"2018-12-25 10:10:35","2018-12-26 20:00:00","2018-12-26 20:30:00",3353,1058,4411
"2018-12-25 10:10:35","2018-12-26 21:00:00","2018-12-26 21:30:00",3196,1014,4210
"2018-12-25 10:10:35","2018-12-26 22:00:00","2018-12-26 22:30:00",3076,941,4017
"2018-12-26 10:10:11","2018-12-26 23:00:00","2018-12-26 23:30:00",2968,860,3828
"2018-12-26 10:10:11","2018-12-27 00:00:00","2018-12-27 00:30:00",2917,725,3642
"2018-12-26 10:10:11","2018-12-27 01:00:00","2018-12-27 01:30:00",2746,646,3392
"2018-12-26 10:10:11","2018-12-27 02:00:00","2018-12-27 02:30:00",2534,609,3143
"2018-12-26 10:10:11","2018-12-27 03:00:00","2018-12-27 03:30:00",2452,583,3035
"2018-12-26 10:10:11","2018-12-27 04:00:00","2018-12-27 04:30:00",2356,574,2930
"2018-12-26 10:10:11","2018-12-27 05:00:00","2018-12-27 05:30:00",2303,580,2883
"2018-12-26 10:10:11","2018-12-27 06:00:00","2018-12-27 06:30:00",2343,628,2971
"2018-12-26 10:10:11","2018-12-27 07:00:00","2018-12-27 07:30:00",2554,755,3309
"2018-12-26 10:10:11","2018-12-27 08:00:00","2018-12-27 08:30:00",2731,944,3675
"2018-12-26 10:10:11","2018-12-27 09:00:00","2018-12-27 09:30:00",2892,1028,3920
"2018-12-26 10:10:11","2018-12-27 10:00:00","2018-12-27 10:30:00",3189,1095,4284
"2018-12-26 10:10:11","2018-12-27 11:00:00","2018-12-27 11:30:00",3394,1097,4491
"2018-12-26 10:10:11","2018-12-27 12:00:00","2018-12-27 12:30:00",3469,1122,4591
"2018-12-26 10:10:11","2018-12-27 13:00:00","2018-12-27 13:30:00",3501,1143,4644
"2018-12-26 10:10:11","2018-12-27 14:00:00","2018-12-27 14:30:00",3408,1124,4532
"2018-12-26 10:10:11","2018-12-27 15:00:00","2018-12-27 15:30:00",3376,1087,4463
"2018-12-26 10:10:11","2018-12-27 16:00:00","2018-12-27 16:30:00",3459,1068,4527
"2018-12-26 10:10:11","2018-12-27 17:00:00","2018-12-27 17:30:00",3915,1152,5067
"2018-12-26 10:10:11","2018-12-27 18:00:00","2018-12-27 18:30:00",4032,1131,5163
"2018-12-26 10:10:11","2018-12-27 19:00:00","2018-12-27 19:30:00",3943,1058,5001
"2018-12-26 10:10:11","2018-12-27 20:00:00","2018-12-27 20:30:00",3738,1028,4766
"2018-12-26 10:10:11","2018-12-27 21:00:00","2018-12-27 21:30:00",3568,988,4556
"2018-12-26 10:10:11","2018-12-27 22:00:00","2018-12-27 22:30:00",3350,907,4257
"2018-12-27 10:10:06","2018-12-27 23:00:00","2018-12-27 23:30:00",3202,874,4076
"2018-12-27 10:10:06","2018-12-28 00:00:00","2018-12-28 00:30:00",3074,776,3850
"2018-12-27 10:10:06","2018-12-28 01:00:00","2018-12-28 01:30:00",2888,699,3587
"2018-12-27 10:10:06","2018-12-28 02:00:00","2018-12-28 02:30:00",2654,678,3332
"2018-12-27 10:10:06","2018-12-28 03:00:00","2018-12-28 03:30:00",2564,651,3215
"2018-12-27 10:10:06","2018-12-28 04:00:00","2018-12-28 04:30:00",2458,636,3094
"2018-12-27 10:10:06","2018-12-28 05:00:00","2018-12-28 05:30:00",2400,632,3032
"2018-12-27 10:10:06","2018-12-28 06:00:00","2018-12-28 06:30:00",2444,710,3154
"2018-12-27 10:10:06","2018-12-28 07:00:00","2018-12-28 07:30:00",2676,820,3496
"2018-12-27 10:10:06","2018-12-28 08:00:00","2018-12-28 08:30:00",2870,930,3800
"2018-12-27 10:10:06","2018-12-28 09:00:00","2018-12-28 09:30:00",3048,1020,4068
"2018-12-27 10:10:06","2018-12-28 10:00:00","2018-12-28 10:30:00",3374,1080,4454
"2018-12-27 10:10:06","2018-12-28 11:00:00","2018-12-28 11:30:00",3599,1094,4693
"2018-12-27 10:10:06","2018-12-28 12:00:00","2018-12-28 12:30:00",3681,1092,4773
"2018-12-27 10:10:06","2018-12-28 13:00:00","2018-12-28 13:30:00",3717,1100,4817
"2018-12-27 10:10:06","2018-12-28 14:00:00","2018-12-28 14:30:00",3614,1076,4690
"2018-12-27 10:10:06","2018-12-28 15:00:00","2018-12-28 15:30:00",3580,1080,4660
"2018-12-27 10:10:06","2018-12-28 16:00:00","2018-12-28 16:30:00",3670,1250,4920
"2018-12-27 10:10:06","2018-12-28 17:00:00","2018-12-28 17:30:00",4172,1370,5542
"2018-12-27 10:10:06","2018-12-28 18:00:00","2018-12-28 18:30:00",4300,1340,5640
"2018-12-27 10:10:06","2018-12-28 19:00:00","2018-12-28 19:30:00",4202,1258,5460
"2018-12-27 10:10:06","2018-12-28 20:00:00","2018-12-28 20:30:00",3977,1169,5146
"2018-12-27 10:10:06","2018-12-28 21:00:00","2018-12-28 21:30:00",3791,1096,4887
"2018-12-27 10:10:06","2018-12-28 22:00:00","2018-12-28 22:30:00",3551,993,4544
"2018-12-28 10:10:10","2018-12-28 23:00:00","2018-12-28 23:30:00",3388,886,4274
"2018-12-28 10:10:10","2018-12-29 00:00:00","2018-12-29 00:30:00",3143,793,3936
"2018-12-28 10:10:10","2018-12-29 01:00:00","2018-12-29 01:30:00",2842,736,3578
"2018-12-28 10:10:10","2018-12-29 02:00:00","2018-12-29 02:30:00",2667,728,3395
"2018-12-28 10:10:10","2018-12-29 03:00:00","2018-12-29 03:30:00",2510,692,3202
"2018-12-28 10:10:10","2018-12-29 04:00:00","2018-12-29 04:30:00",2446,671,3117
"2018-12-28 10:10:10","2018-12-29 05:00:00","2018-12-29 05:30:00",2400,666,3066
"2018-12-28 10:10:10","2018-12-29 06:00:00","2018-12-29 06:30:00",2446,675,3121
"2018-12-28 10:10:10","2018-12-29 07:00:00","2018-12-29 07:30:00",2628,750,3378
"2018-12-28 10:10:10","2018-12-29 08:00:00","2018-12-29 08:30:00",2932,830,3762
"2018-12-28 10:10:10","2018-12-29 09:00:00","2018-12-29 09:30:00",3169,920,4089
"2018-12-28 10:10:10","2018-12-29 10:00:00","2018-12-29 10:30:00",3387,990,4377
"2018-12-28 10:10:10","2018-12-29 11:00:00","2018-12-29 11:30:00",3456,1020,4476
"2018-12-28 10:10:10","2018-12-29 12:00:00","2018-12-29 12:30:00",3481,1021,4502
"2018-12-28 10:10:10","2018-12-29 13:00:00","2018-12-29 13:30:00",3494,1036,4530
"2018-12-28 10:10:10","2018-12-29 14:00:00","2018-12-29 14:30:00",3433,990,4423
"2018-12-28 10:10:10","2018-12-29 15:00:00","2018-12-29 15:30:00",3405,975,4380
"2018-12-28 10:10:10","2018-12-29 16:00:00","2018-12-29 16:30:00",3562,1130,4692
"2018-12-28 10:10:10","2018-12-29 17:00:00","2018-12-29 17:30:00",4014,1270,5284
"2018-12-28 10:10:10","2018-12-29 18:00:00","2018-12-29 18:30:00",4150,1280,5430
"2018-12-28 10:10:10","2018-12-29 19:00:00","2018-12-29 19:30:00",4039,1212,5251
"2018-12-28 10:10:10","2018-12-29 20:00:00","2018-12-29 20:30:00",3847,1134,4981
"2018-12-28 10:10:10","2018-12-29 21:00:00","2018-12-29 21:30:00",3636,1033,4669
"2018-12-28 10:10:10","2018-12-29 22:00:00","2018-12-29 22:30:00",3384,934,4318
"2018-12-29 10:10:15","2018-12-29 23:00:00","2018-12-29 23:30:00",3178,865,4043
"2018-12-29 10:10:15","2018-12-30 00:00:00","2018-12-30 00:30:00",3177,741,3918
"2018-12-29 10:10:15","2018-12-30 01:00:00","2018-12-30 01:30:00",2880,723,3603
"2018-12-29 10:10:15","2018-12-30 02:00:00","2018-12-30 02:30:00",2668,672,3340
"2018-12-29 10:10:15","2018-12-30 03:00:00","2018-12-30 03:30:00",2519,643,3162
"2018-12-29 10:10:15","2018-12-30 04:00:00","2018-12-30 04:30:00",2459,621,3080
"2018-12-29 10:10:15","2018-12-30 05:00:00","2018-12-30 05:30:00",2400,629,3029
"2018-12-29 10:10:15","2018-12-30 06:00:00","2018-12-30 06:30:00",2432,651,3083
"2018-12-29 10:10:15","2018-12-30 07:00:00","2018-12-30 07:30:00",2557,696,3253
"2018-12-29 10:10:15","2018-12-30 08:00:00","2018-12-30 08:30:00",2766,763,3529
"2018-12-29 10:10:15","2018-12-30 09:00:00","2018-12-30 09:30:00",3055,863,3918
"2018-12-29 10:10:15","2018-12-30 10:00:00","2018-12-30 10:30:00",3367,964,4331
"2018-12-29 10:10:15","2018-12-30 11:00:00","2018-12-30 11:30:00",3551,1025,4576
"2018-12-29 10:10:15","2018-12-30 12:00:00","2018-12-30 12:30:00",3633,1085,4718
"2018-12-29 10:10:15","2018-12-30 13:00:00","2018-12-30 13:30:00",3676,1093,4769
"2018-12-29 10:10:15","2018-12-30 14:00:00","2018-12-30 14:30:00",3596,1073,4669
"2018-12-29 10:10:15","2018-12-30 15:00:00","2018-12-30 15:30:00",3547,1076,4623
"2018-12-29 10:10:15","2018-12-30 16:00:00","2018-12-30 16:30:00",3650,1216,4866
"2018-12-29 10:10:15","2018-12-30 17:00:00","2018-12-30 17:30:00",4013,1291,5304
"2018-12-29 10:10:15","2018-12-30 18:00:00","2018-12-30 18:30:00",4095,1240,5335
"2018-12-29 10:10:15","2018-12-30 19:00:00","2018-12-30 19:30:00",3991,1161,5152
"2018-12-29 10:10:15","2018-12-30 20:00:00","2018-12-30 20:30:00",3846,1089,4935
"2018-12-29 10:10:15","2018-12-30 21:00:00","2018-12-30 21:30:00",3676,1019,4695
"2018-12-29 10:10:15","2018-12-30 22:00:00","2018-12-30 22:30:00",3453,927,4380
"2018-12-30 10:10:16","2018-12-30 23:00:00","2018-12-30 23:30:00",3071,826,3897
"2018-12-30 10:10:16","2018-12-31 00:00:00","2018-12-31 00:30:00",3235,638,3873
"2018-12-30 10:10:16","2018-12-31 01:00:00","2018-12-31 01:30:00",2956,587,3543
"2018-12-30 10:10:16","2018-12-31 02:00:00","2018-12-31 02:30:00",2793,588,3381
"2018-12-30 10:10:16","2018-12-31 03:00:00","2018-12-31 03:30:00",2647,566,3213
"2018-12-30 10:10:16","2018-12-31 04:00:00","2018-12-31 04:30:00",2587,563,3150
"2018-12-30 10:10:16","2018-12-31 05:00:00","2018-12-31 05:30:00",2544,594,3138
"2018-12-30 10:10:16","2018-12-31 06:00:00","2018-12-31 06:30:00",2587,657,3244
"2018-12-30 10:10:16","2018-12-31 07:00:00","2018-12-31 07:30:00",2757,864,3621
"2018-12-30 10:10:16","2018-12-31 08:00:00","2018-12-31 08:30:00",3039,1083,4122
"2018-12-30 10:10:16","2018-12-31 09:00:00","2018-12-31 09:30:00",3260,1105,4365
"2018-12-30 10:10:16","2018-12-31 10:00:00","2018-12-31 10:30:00",3462,1122,4584
"2018-12-30 10:10:16","2018-12-31 11:00:00","2018-12-31 11:30:00",3526,1105,4631
"2018-12-30 10:10:16","2018-12-31 12:00:00","2018-12-31 12:30:00",3550,1109,4659
"2018-12-30 10:10:16","2018-12-31 13:00:00","2018-12-31 13:30:00",3562,1150,4712
"2018-12-30 10:10:16","2018-12-31 14:00:00","2018-12-31 14:30:00",3505,1100,4605
"2018-12-30 10:10:16","2018-12-31 15:00:00","2018-12-31 15:30:00",3479,1118,4597
"2018-12-30 10:10:16","2018-12-31 16:00:00","2018-12-31 16:30:00",3625,1228,4853
"2018-12-30 10:10:16","2018-12-31 17:00:00","2018-12-31 17:30:00",4045,1384,5429
"2018-12-30 10:10:16","2018-12-31 18:00:00","2018-12-31 18:30:00",4172,1355,5527
"2018-12-30 10:10:16","2018-12-31 19:00:00","2018-12-31 19:30:00",4068,1263,5331
"2018-12-30 10:10:16","2018-12-31 20:00:00","2018-12-31 20:30:00",3890,1172,5062
"2018-12-30 10:10:16","2018-12-31 21:00:00","2018-12-31 21:30:00",3694,1105,4799
"2018-12-30 10:10:16","2018-12-31 22:00:00","2018-12-31 22:30:00",3460,970,4430
"2018-12-31 10:10:15","2018-12-31 23:00:00","2018-12-31 23:30:00",3055,752,3807
"2018-12-31 10:10:15","2019-01-01 00:00:00","2019-01-01 00:30:00",3145,643,3788
"2018-12-31 10:10:15","2019-01-01 01:00:00","2019-01-01 01:30:00",2985,590,3575
"2018-12-31 10:10:15","2019-01-01 02:00:00","2019-01-01 02:30:00",2729,574,3303
"2018-12-31 10:10:15","2019-01-01 03:00:00","2019-01-01 03:30:00",2540,552,3092
"2018-12-31 10:10:15","2019-01-01 04:00:00","2019-01-01 04:30:00",2461,550,3011
"2018-12-31 10:10:15","2019-01-01 05:00:00","2019-01-01 05:30:00",2356,562,2918
"2018-12-31 10:10:15","2019-01-01 06:00:00","2019-01-01 06:30:00",2354,624,2978
"2018-12-31 10:10:15","2019-01-01 07:00:00","2019-01-01 07:30:00",2388,756,3144
"2018-12-31 10:10:15","2019-01-01 08:00:00","2019-01-01 08:30:00",2424,938,3362
"2018-12-31 10:10:15","2019-01-01 09:00:00","2019-01-01 09:30:00",2455,1006,3461
"2018-12-31 10:10:15","2019-01-01 10:00:00","2019-01-01 10:30:00",2780,1054,3834
"2018-12-31 10:10:15","2019-01-01 11:00:00","2019-01-01 11:30:00",3100,1090,4190
"2018-12-31 10:10:15","2019-01-01 12:00:00","2019-01-01 12:30:00",3313,1084,4397
"2018-12-31 10:10:15","2019-01-01 13:00:00","2019-01-01 13:30:00",3500,1075,4575
"2018-12-31 10:10:15","2019-01-01 14:00:00","2019-01-01 14:30:00",3430,1060,4490
"2018-12-31 10:10:15","2019-01-01 15:00:00","2019-01-01 15:30:00",3410,1067,4477
"2018-12-31 10:10:15","2019-01-01 16:00:00","2019-01-01 16:30:00",3530,1152,4682
"2018-12-31 10:10:15","2019-01-01 17:00:00","2019-01-01 17:30:00",3851,1335,5186
"2018-12-31 10:10:15","2019-01-01 18:00:00","2019-01-01 18:30:00",3878,1336,5214
"2018-12-31 10:10:15","2019-01-01 19:00:00","2019-01-01 19:30:00",3689,1262,4951
"2018-12-31 10:10:15","2019-01-01 20:00:00","2019-01-01 20:30:00",3528,1209,4737
"2018-12-31 10:10:15","2019-01-01 21:00:00","2019-01-01 21:30:00",3414,1134,4548
"2018-12-31 10:10:15","2019-01-01 22:00:00","2019-01-01 22:30:00",3202,1018,4220
"2019-01-01 10:10:21","2019-01-01 23:00:00","2019-01-01 23:30:00",3076,842,3918
"2019-01-01 10:10:21","2019-01-02 00:00:00","2019-01-02 00:30:00",2903,702,3605
"2019-01-01 10:10:21","2019-01-02 01:00:00","2019-01-02 01:30:00",2676,637,3313
"2019-01-01 10:10:21","2019-01-02 02:00:00","2019-01-02 02:30:00",2518,623,3141
"2019-01-01 10:10:21","2019-01-02 03:00:00","2019-01-02 03:30:00",2421,614,3035
"2019-01-01 10:10:21","2019-01-02 04:00:00","2019-01-02 04:30:00",2380,598,2978
"2019-01-01 10:10:21","2019-01-02 05:00:00","2019-01-02 05:30:00",2360,577,2937
"2019-01-01 10:10:21","2019-01-02 06:00:00","2019-01-02 06:30:00",2495,690,3185
"2019-01-01 10:10:21","2019-01-02 07:00:00","2019-01-02 07:30:00",2880,830,3710
"2019-01-01 10:10:21","2019-01-02 08:00:00","2019-01-02 08:30:00",3210,970,4180
"2019-01-01 10:10:21","2019-01-02 09:00:00","2019-01-02 09:30:00",3460,1070,4530
"2019-01-01 10:10:21","2019-01-02 10:00:00","2019-01-02 10:30:00",3640,1120,4760
"2019-01-01 10:10:21","2019-01-02 11:00:00","2019-01-02 11:30:00",3820,1138,4958
"2019-01-01 10:10:21","2019-01-02 12:00:00","2019-01-02 12:30:00",3880,1151,5031
"2019-01-01 10:10:21","2019-01-02 13:00:00","2019-01-02 13:30:00",3960,1167,5127
"2019-01-01 10:10:21","2019-01-02 14:00:00","2019-01-02 14:30:00",3970,1174,5144
"2019-01-01 10:10:21","2019-01-02 15:00:00","2019-01-02 15:30:00",3990,1200,5190
"2019-01-01 10:10:21","2019-01-02 16:00:00","2019-01-02 16:30:00",4150,1380,5530
"2019-01-01 10:10:21","2019-01-02 17:00:00","2019-01-02 17:30:00",4460,1470,5930
"2019-01-01 10:10:21","2019-01-02 18:00:00","2019-01-02 18:30:00",4500,1430,5930
"2019-01-01 10:10:21","2019-01-02 19:00:00","2019-01-02 19:30:00",4300,1317,5617
"2019-01-01 10:10:21","2019-01-02 20:00:00","2019-01-02 20:30:00",4095,1202,5297
"2019-01-01 10:10:21","2019-01-02 21:00:00","2019-01-02 21:30:00",3850,1091,4941
"2019-01-01 10:10:21","2019-01-02 22:00:00","2019-01-02 22:30:00",3550,963,4513
"2019-01-02 10:10:21","2019-01-02 23:00:00","2019-01-02 23:30:00",3355,829,4184
"2019-01-02 10:10:21","2019-01-03 00:00:00","2019-01-03 00:30:00",3132,667,3799
"2019-01-02 10:10:21","2019-01-03 01:00:00","2019-01-03 01:30:00",2912,614,3526
"2019-01-02 10:10:21","2019-01-03 02:00:00","2019-01-03 02:30:00",2728,601,3329
"2019-01-02 10:10:21","2019-01-03 03:00:00","2019-01-03 03:30:00",2622,570,3192
"2019-01-02 10:10:21","2019-01-03 04:00:00","2019-01-03 04:30:00",2608,555,3163
"2019-01-02 10:10:21","2019-01-03 05:00:00","2019-01-03 05:30:00",2607,549,3156
"2019-01-02 10:10:21","2019-01-03 06:00:00","2019-01-03 06:30:00",2710,577,3287
"2019-01-02 10:10:21","2019-01-03 07:00:00","2019-01-03 07:30:00",3100,658,3758
"2019-01-02 10:10:21","2019-01-03 08:00:00","2019-01-03 08:30:00",3420,762,4182
"2019-01-02 10:10:21","2019-01-03 09:00:00","2019-01-03 09:30:00",3720,815,4535
"2019-01-02 10:10:21","2019-01-03 10:00:00","2019-01-03 10:30:00",3900,868,4768
"2019-01-02 10:10:21","2019-01-03 11:00:00","2019-01-03 11:30:00",4040,933,4973
"2019-01-02 10:10:21","2019-01-03 12:00:00","2019-01-03 12:30:00",4130,962,5092
"2019-01-02 10:10:21","2019-01-03 13:00:00","2019-01-03 13:30:00",4210,1006,5216
"2019-01-02 10:10:21","2019-01-03 14:00:00","2019-01-03 14:30:00",4140,980,5120
"2019-01-02 10:10:21","2019-01-03 15:00:00","2019-01-03 15:30:00",4100,974,5074
"2019-01-02 10:10:21","2019-01-03 16:00:00","2019-01-03 16:30:00",4200,1019,5219
"2019-01-02 10:10:21","2019-01-03 17:00:00","2019-01-03 17:30:00",4560,1173,5733
"2019-01-02 10:10:21","2019-01-03 18:00:00","2019-01-03 18:30:00",4610,1161,5771
"2019-01-02 10:10:21","2019-01-03 19:00:00","2019-01-03 19:30:00",4420,1081,5501
"2019-01-02 10:10:21","2019-01-03 20:00:00","2019-01-03 20:30:00",4180,1023,5203
"2019-01-02 10:10:21","2019-01-03 21:00:00","2019-01-03 21:30:00",3920,946,4866
"2019-01-02 10:10:21","2019-01-03 22:00:00","2019-01-03 22:30:00",3630,880,4510
"2019-01-03 10:10:21","2019-01-03 23:00:00","2019-01-03 23:30:00",3400,939,4339
"2019-01-03 10:10:21","2019-01-04 00:00:00","2019-01-04 00:30:00",3260,680,3940
"2019-01-03 10:10:21","2019-01-04 01:00:00","2019-01-04 01:30:00",3020,599,3619
"2019-01-03 10:10:21","2019-01-04 02:00:00","2019-01-04 02:30:00",2840,570,3410
"2019-01-03 10:10:21","2019-01-04 03:00:00","2019-01-04 03:30:00",2750,545,3295
"2019-01-03 10:10:21","2019-01-04 04:00:00","2019-01-04 04:30:00",2680,525,3205
"2019-01-03 10:10:21","2019-01-04 05:00:00","2019-01-04 05:30:00",2660,532,3192
"2019-01-03 10:10:21","2019-01-04 06:00:00","2019-01-04 06:30:00",2820,597,3417
"2019-01-03 10:10:21","2019-01-04 07:00:00","2019-01-04 07:30:00",3150,712,3862
"2019-01-03 10:10:21","2019-01-04 08:00:00","2019-01-04 08:30:00",3515,843,4358
"2019-01-03 10:10:21","2019-01-04 09:00:00","2019-01-04 09:30:00",3750,938,4688
"2019-01-03 10:10:21","2019-01-04 10:00:00","2019-01-04 10:30:00",3920,1007,4927
"2019-01-03 10:10:21","2019-01-04 11:00:00","2019-01-04 11:30:00",3980,1035,5015
"2019-01-03 10:10:21","2019-01-04 12:00:00","2019-01-04 12:30:00",4050,1060,5110
"2019-01-03 10:10:21","2019-01-04 13:00:00","2019-01-04 13:30:00",4080,1064,5144
"2019-01-03 10:10:21","2019-01-04 14:00:00","2019-01-04 14:30:00",3990,1015,5005
"2019-01-03 10:10:21","2019-01-04 15:00:00","2019-01-04 15:30:00",3950,1003,4953
"2019-01-03 10:10:21","2019-01-04 16:00:00","2019-01-04 16:30:00",4010,1062,5072
"2019-01-03 10:10:21","2019-01-04 17:00:00","2019-01-04 17:30:00",4470,1241,5711
"2019-01-03 10:10:21","2019-01-04 18:00:00","2019-01-04 18:30:00",4610,1270,5880
"2019-01-03 10:10:21","2019-01-04 19:00:00","2019-01-04 19:30:00",4460,1178,5638
"2019-01-03 10:10:21","2019-01-04 20:00:00","2019-01-04 20:30:00",4200,1086,5286
"2019-01-03 10:10:21","2019-01-04 21:00:00","2019-01-04 21:30:00",4000,1007,5007
"2019-01-03 10:10:21","2019-01-04 22:00:00","2019-01-04 22:30:00",3670,902,4572
"2019-01-04 10:10:26","2019-01-04 23:00:00","2019-01-04 23:30:00",3490,924,4414
"2019-01-04 10:10:26","2019-01-05 00:00:00","2019-01-05 00:30:00",3349,697,4046
"2019-01-04 10:10:26","2019-01-05 01:00:00","2019-01-05 01:30:00",3065,627,3692
"2019-01-04 10:10:26","2019-01-05 02:00:00","2019-01-05 02:30:00",2822,592,3414
"2019-01-04 10:10:26","2019-01-05 03:00:00","2019-01-05 03:30:00",2680,557,3237
"2019-01-04 10:10:26","2019-01-05 04:00:00","2019-01-05 04:30:00",2613,539,3152
"2019-01-04 10:10:26","2019-01-05 05:00:00","2019-01-05 05:30:00",2541,536,3077
"2019-01-04 10:10:26","2019-01-05 06:00:00","2019-01-05 06:30:00",2575,575,3150
"2019-01-04 10:10:26","2019-01-05 07:00:00","2019-01-05 07:30:00",2759,658,3417
"2019-01-04 10:10:26","2019-01-05 08:00:00","2019-01-05 08:30:00",2974,783,3757
"2019-01-04 10:10:26","2019-01-05 09:00:00","2019-01-05 09:30:00",3193,906,4099
"2019-01-04 10:10:26","2019-01-05 10:00:00","2019-01-05 10:30:00",3485,991,4476
"2019-01-04 10:10:26","2019-01-05 11:00:00","2019-01-05 11:30:00",3633,1048,4681
"2019-01-04 10:10:26","2019-01-05 12:00:00","2019-01-05 12:30:00",3703,1091,4794
"2019-01-04 10:10:26","2019-01-05 13:00:00","2019-01-05 13:30:00",3710,1081,4791
"2019-01-04 10:10:26","2019-01-05 14:00:00","2019-01-05 14:30:00",3641,1039,4680
"2019-01-04 10:10:26","2019-01-05 15:00:00","2019-01-05 15:30:00",3630,1020,4650
"2019-01-04 10:10:26","2019-01-05 16:00:00","2019-01-05 16:30:00",3668,1047,4715
"2019-01-04 10:10:26","2019-01-05 17:00:00","2019-01-05 17:30:00",4118,1198,5316
"2019-01-04 10:10:26","2019-01-05 18:00:00","2019-01-05 18:30:00",4308,1216,5524
"2019-01-04 10:10:26","2019-01-05 19:00:00","2019-01-05 19:30:00",4123,1121,5244
"2019-01-04 10:10:26","2019-01-05 20:00:00","2019-01-05 20:30:00",3921,1041,4962
"2019-01-04 10:10:26","2019-01-05 21:00:00","2019-01-05 21:30:00",3733,952,4685
"2019-01-04 10:10:26","2019-01-05 22:00:00","2019-01-05 22:30:00",3506,872,4378
"2019-01-05 10:10:26","2019-01-05 23:00:00","2019-01-05 23:30:00",3356,949,4305
"2019-01-05 10:10:26","2019-01-06 00:00:00","2019-01-06 00:30:00",3258,699,3957
"2019-01-05 10:10:26","2019-01-06 01:00:00","2019-01-06 01:30:00",3038,627,3665
"2019-01-05 10:10:26","2019-01-06 02:00:00","2019-01-06 02:30:00",2845,605,3450
"2019-01-05 10:10:26","2019-01-06 03:00:00","2019-01-06 03:30:00",2714,567,3281
"2019-01-05 10:10:26","2019-01-06 04:00:00","2019-01-06 04:30:00",2624,551,3175
"2019-01-05 10:10:26","2019-01-06 05:00:00","2019-01-06 05:30:00",2572,559,3131
"2019-01-05 10:10:26","2019-01-06 06:00:00","2019-01-06 06:30:00",2586,577,3163
"2019-01-05 10:10:26","2019-01-06 07:00:00","2019-01-06 07:30:00",2648,639,3287
"2019-01-05 10:10:26","2019-01-06 08:00:00","2019-01-06 08:30:00",2754,712,3466
"2019-01-05 10:10:26","2019-01-06 09:00:00","2019-01-06 09:30:00",2847,793,3640
"2019-01-05 10:10:26","2019-01-06 10:00:00","2019-01-06 10:30:00",3167,900,4067
"2019-01-05 10:10:26","2019-01-06 11:00:00","2019-01-06 11:30:00",3414,985,4399
"2019-01-05 10:10:26","2019-01-06 12:00:00","2019-01-06 12:30:00",3615,1040,4655
"2019-01-05 10:10:26","2019-01-06 13:00:00","2019-01-06 13:30:00",3687,1092,4779
"2019-01-05 10:10:26","2019-01-06 14:00:00","2019-01-06 14:30:00",3576,1006,4582
"2019-01-05 10:10:26","2019-01-06 15:00:00","2019-01-06 15:30:00",3503,973,4476
"2019-01-05 10:10:26","2019-01-06 16:00:00","2019-01-06 16:30:00",3545,1029,4574
"2019-01-05 10:10:26","2019-01-06 17:00:00","2019-01-06 17:30:00",4021,1199,5220
"2019-01-05 10:10:26","2019-01-06 18:00:00","2019-01-06 18:30:00",4280,1200,5480
"2019-01-05 10:10:26","2019-01-06 19:00:00","2019-01-06 19:30:00",4140,1128,5268
"2019-01-05 10:10:26","2019-01-06 20:00:00","2019-01-06 20:30:00",3933,1048,4981
"2019-01-05 10:10:26","2019-01-06 21:00:00","2019-01-06 21:30:00",3765,988,4753
"2019-01-05 10:10:26","2019-01-06 22:00:00","2019-01-06 22:30:00",3486,893,4379
"2019-01-06 10:10:25","2019-01-06 23:00:00","2019-01-06 23:30:00",3256,823,4079
"2019-01-06 10:10:25","2019-01-07 00:00:00","2019-01-07 00:30:00",3226,656,3882
"2019-01-06 10:10:25","2019-01-07 01:00:00","2019-01-07 01:30:00",3016,602,3618
"2019-01-06 10:10:25","2019-01-07 02:00:00","2019-01-07 02:30:00",2856,597,3453
"2019-01-06 10:10:25","2019-01-07 03:00:00","2019-01-07 03:30:00",2758,572,3330
"2019-01-06 10:10:25","2019-01-07 04:00:00","2019-01-07 04:30:00",2710,553,3263
"2019-01-06 10:10:25","2019-01-07 05:00:00","2019-01-07 05:30:00",2732,569,3301
"2019-01-06 10:10:25","2019-01-07 06:00:00","2019-01-07 06:30:00",2907,607,3514
"2019-01-06 10:10:25","2019-01-07 07:00:00","2019-01-07 07:30:00",3417,700,4117
"2019-01-06 10:10:25","2019-01-07 08:00:00","2019-01-07 08:30:00",4017,832,4849
"2019-01-06 10:10:25","2019-01-07 09:00:00","2019-01-07 09:30:00",4043,919,4962
"2019-01-06 10:10:25","2019-01-07 10:00:00","2019-01-07 10:30:00",4177,984,5161
"2019-01-06 10:10:25","2019-01-07 11:00:00","2019-01-07 11:30:00",4214,1022,5236
"2019-01-06 10:10:25","2019-01-07 12:00:00","2019-01-07 12:30:00",4251,1017,5268
"2019-01-06 10:10:25","2019-01-07 13:00:00","2019-01-07 13:30:00",4304,1043,5347
"2019-01-06 10:10:25","2019-01-07 14:00:00","2019-01-07 14:30:00",4252,1052,5304
"2019-01-06 10:10:25","2019-01-07 15:00:00","2019-01-07 15:30:00",4306,1069,5375
"2019-01-06 10:10:25","2019-01-07 16:00:00","2019-01-07 16:30:00",4463,1142,5605
"2019-01-06 10:10:25","2019-01-07 17:00:00","2019-01-07 17:30:00",4879,1354,6233
"2019-01-06 10:10:25","2019-01-07 18:00:00","2019-01-07 18:30:00",4945,1352,6297
"2019-01-06 10:10:25","2019-01-07 19:00:00","2019-01-07 19:30:00",4677,1221,5898
"2019-01-06 10:10:25","2019-01-07 20:00:00","2019-01-07 20:30:00",4449,1101,5550
"2019-01-06 10:10:25","2019-01-07 21:00:00","2019-01-07 21:30:00",4240,1017,5257
"2019-01-06 10:10:25","2019-01-07 22:00:00","2019-01-07 22:30:00",3872,924,4796
"2019-01-07 10:10:31","2019-01-07 23:00:00","2019-01-07 23:30:00",3484,920,4404
"2019-01-07 10:10:31","2019-01-08 00:00:00","2019-01-08 00:30:00",3268,774,4042
"2019-01-07 10:10:31","2019-01-08 01:00:00","2019-01-08 01:30:00",2985,722,3707
"2019-01-07 10:10:31","2019-01-08 02:00:00","2019-01-08 02:30:00",2780,696,3476
"2019-01-07 10:10:31","2019-01-08 03:00:00","2019-01-08 03:30:00",2697,658,3355
"2019-01-07 10:10:31","2019-01-08 04:00:00","2019-01-08 04:30:00",2651,648,3299
"2019-01-07 10:10:31","2019-01-08 05:00:00","2019-01-08 05:30:00",2640,655,3295
"2019-01-07 10:10:31","2019-01-08 06:00:00","2019-01-08 06:30:00",2791,768,3559
"2019-01-07 10:10:31","2019-01-08 07:00:00","2019-01-08 07:30:00",3326,1070,4396
"2019-01-07 10:10:31","2019-01-08 08:00:00","2019-01-08 08:30:00",4000,1250,5250
"2019-01-07 10:10:31","2019-01-08 09:00:00","2019-01-08 09:30:00",4004,1265,5269
"2019-01-07 10:10:31","2019-01-08 10:00:00","2019-01-08 10:30:00",4188,1270,5458
"2019-01-07 10:10:31","2019-01-08 11:00:00","2019-01-08 11:30:00",4245,1270,5515
"2019-01-07 10:10:31","2019-01-08 12:00:00","2019-01-08 12:30:00",4281,1272,5553
"2019-01-07 10:10:31","2019-01-08 13:00:00","2019-01-08 13:30:00",4268,1260,5528
"2019-01-07 10:10:31","2019-01-08 14:00:00","2019-01-08 14:30:00",4220,1210,5430
"2019-01-07 10:10:31","2019-01-08 15:00:00","2019-01-08 15:30:00",4225,1231,5456
"2019-01-07 10:10:31","2019-01-08 16:00:00","2019-01-08 16:30:00",4339,1330,5669
"2019-01-07 10:10:31","2019-01-08 17:00:00","2019-01-08 17:30:00",4739,1540,6279
"2019-01-07 10:10:31","2019-01-08 18:00:00","2019-01-08 18:30:00",4850,1500,6350
"2019-01-07 10:10:31","2019-01-08 19:00:00","2019-01-08 19:30:00",4588,1400,5988
"2019-01-07 10:10:31","2019-01-08 20:00:00","2019-01-08 20:30:00",4355,1271,5626
"2019-01-07 10:10:31","2019-01-08 21:00:00","2019-01-08 21:30:00",4084,1183,5267
"2019-01-07 10:10:31","2019-01-08 22:00:00","2019-01-08 22:30:00",3687,1067,4754
"2019-01-08 10:10:26","2019-01-08 23:00:00","2019-01-08 23:30:00",3358,943,4301
"2019-01-08 10:10:26","2019-01-09 00:00:00","2019-01-09 00:30:00",3275,798,4073
"2019-01-08 10:10:26","2019-01-09 01:00:00","2019-01-09 01:30:00",2994,744,3738
"2019-01-08 10:10:26","2019-01-09 02:00:00","2019-01-09 02:30:00",2789,724,3513
"2019-01-08 10:10:26","2019-01-09 03:00:00","2019-01-09 03:30:00",2707,679,3386
"2019-01-08 10:10:26","2019-01-09 04:00:00","2019-01-09 04:30:00",2661,664,3325
"2019-01-08 10:10:26","2019-01-09 05:00:00","2019-01-09 05:30:00",2650,686,3336
"2019-01-08 10:10:26","2019-01-09 06:00:00","2019-01-09 06:30:00",2801,800,3601
"2019-01-08 10:10:26","2019-01-09 07:00:00","2019-01-09 07:30:00",3333,1080,4413
"2019-01-08 10:10:26","2019-01-09 08:00:00","2019-01-09 08:30:00",4000,1230,5230
"2019-01-08 10:10:26","2019-01-09 09:00:00","2019-01-09 09:30:00",4008,1250,5258
"2019-01-08 10:10:26","2019-01-09 10:00:00","2019-01-09 10:30:00",4191,1250,5441
"2019-01-08 10:10:26","2019-01-09 11:00:00","2019-01-09 11:30:00",4248,1250,5498
"2019-01-08 10:10:26","2019-01-09 12:00:00","2019-01-09 12:30:00",4283,1259,5542
"2019-01-08 10:10:26","2019-01-09 13:00:00","2019-01-09 13:30:00",4270,1250,5520
"2019-01-08 10:10:26","2019-01-09 14:00:00","2019-01-09 14:30:00",4222,1210,5432
"2019-01-08 10:10:26","2019-01-09 15:00:00","2019-01-09 15:30:00",4227,1252,5479
"2019-01-08 10:10:26","2019-01-09 16:00:00","2019-01-09 16:30:00",4341,1350,5691
"2019-01-08 10:10:26","2019-01-09 17:00:00","2019-01-09 17:30:00",4739,1579,6318
"2019-01-08 10:10:26","2019-01-09 18:00:00","2019-01-09 18:30:00",4850,1530,6380
"2019-01-08 10:10:26","2019-01-09 19:00:00","2019-01-09 19:30:00",4589,1400,5989
"2019-01-08 10:10:26","2019-01-09 20:00:00","2019-01-09 20:30:00",4357,1283,5640
"2019-01-08 10:10:26","2019-01-09 21:00:00","2019-01-09 21:30:00",4087,1192,5279
"2019-01-08 10:10:26","2019-01-09 22:00:00","2019-01-09 22:30:00",3693,1068,4761
"2019-01-09 10:10:30","2019-01-09 23:00:00","2019-01-09 23:30:00",3378,960,4338
"2019-01-09 10:10:30","2019-01-10 00:00:00","2019-01-10 00:30:00",3215,758,3973
"2019-01-09 10:10:30","2019-01-10 01:00:00","2019-01-10 01:30:00",2978,702,3680
"2019-01-09 10:10:30","2019-01-10 02:00:00","2019-01-10 02:30:00",2816,689,3505
"2019-01-09 10:10:30","2019-01-10 03:00:00","2019-01-10 03:30:00",2720,662,3382
"2019-01-09 10:10:30","2019-01-10 04:00:00","2019-01-10 04:30:00",2671,651,3322
"2019-01-09 10:10:30","2019-01-10 05:00:00","2019-01-10 05:30:00",2666,651,3317
"2019-01-09 10:10:30","2019-01-10 06:00:00","2019-01-10 06:30:00",2810,720,3530
"2019-01-09 10:10:30","2019-01-10 07:00:00","2019-01-10 07:30:00",3323,893,4216
"2019-01-09 10:10:30","2019-01-10 08:00:00","2019-01-10 08:30:00",4000,1103,5103
"2019-01-09 10:10:30","2019-01-10 09:00:00","2019-01-10 09:30:00",3953,1170,5123
"2019-01-09 10:10:30","2019-01-10 10:00:00","2019-01-10 10:30:00",4049,1235,5284
"2019-01-09 10:10:30","2019-01-10 11:00:00","2019-01-10 11:30:00",4080,1243,5323
"2019-01-09 10:10:30","2019-01-10 12:00:00","2019-01-10 12:30:00",4095,1258,5353
"2019-01-09 10:10:30","2019-01-10 13:00:00","2019-01-10 13:30:00",4108,1248,5356
"2019-01-09 10:10:30","2019-01-10 14:00:00","2019-01-10 14:30:00",4030,1203,5233
"2019-01-09 10:10:30","2019-01-10 15:00:00","2019-01-10 15:30:00",4052,1223,5275
"2019-01-09 10:10:30","2019-01-10 16:00:00","2019-01-10 16:30:00",4149,1272,5421
"2019-01-09 10:10:30","2019-01-10 17:00:00","2019-01-10 17:30:00",4611,1484,6095
"2019-01-09 10:10:30","2019-01-10 18:00:00","2019-01-10 18:30:00",4760,1478,6238
"2019-01-09 10:10:30","2019-01-10 19:00:00","2019-01-10 19:30:00",4575,1365,5940
"2019-01-09 10:10:30","2019-01-10 20:00:00","2019-01-10 20:30:00",4317,1258,5575
"2019-01-09 10:10:30","2019-01-10 21:00:00","2019-01-10 21:30:00",4084,1188,5272
"2019-01-09 10:10:30","2019-01-10 22:00:00","2019-01-10 22:30:00",3667,1073,4740
"2019-01-10 10:10:36","2019-01-10 23:00:00","2019-01-10 23:30:00",3361,1050,4411
"2019-01-10 10:10:36","2019-01-11 00:00:00","2019-01-11 00:30:00",3388,823,4211
"2019-01-10 10:10:36","2019-01-11 01:00:00","2019-01-11 01:30:00",3083,734,3817
"2019-01-10 10:10:36","2019-01-11 02:00:00","2019-01-11 02:30:00",2898,729,3627
"2019-01-10 10:10:36","2019-01-11 03:00:00","2019-01-11 03:30:00",2755,699,3454
"2019-01-10 10:10:36","2019-01-11 04:00:00","2019-01-11 04:30:00",2745,680,3425
"2019-01-10 10:10:36","2019-01-11 05:00:00","2019-01-11 05:30:00",2723,681,3404
"2019-01-10 10:10:36","2019-01-11 06:00:00","2019-01-11 06:30:00",2899,750,3649
"2019-01-10 10:10:36","2019-01-11 07:00:00","2019-01-11 07:30:00",3219,900,4119
"2019-01-10 10:10:36","2019-01-11 08:00:00","2019-01-11 08:30:00",3596,1091,4687
"2019-01-10 10:10:36","2019-01-11 09:00:00","2019-01-11 09:30:00",3755,1178,4933
"2019-01-10 10:10:36","2019-01-11 10:00:00","2019-01-11 10:30:00",3992,1224,5216
"2019-01-10 10:10:36","2019-01-11 11:00:00","2019-01-11 11:30:00",4052,1237,5289
"2019-01-10 10:10:36","2019-01-11 12:00:00","2019-01-11 12:30:00",4070,1239,5309
"2019-01-10 10:10:36","2019-01-11 13:00:00","2019-01-11 13:30:00",4105,1232,5337
"2019-01-10 10:10:36","2019-01-11 14:00:00","2019-01-11 14:30:00",3936,1187,5123
"2019-01-10 10:10:36","2019-01-11 15:00:00","2019-01-11 15:30:00",3951,1171,5122
"2019-01-10 10:10:36","2019-01-11 16:00:00","2019-01-11 16:30:00",4061,1223,5284
"2019-01-10 10:10:36","2019-01-11 17:00:00","2019-01-11 17:30:00",4425,1390,5815
"2019-01-10 10:10:36","2019-01-11 18:00:00","2019-01-11 18:30:00",4557,1377,5934
"2019-01-10 10:10:36","2019-01-11 19:00:00","2019-01-11 19:30:00",4371,1279,5650
"2019-01-10 10:10:36","2019-01-11 20:00:00","2019-01-11 20:30:00",4204,1184,5388
"2019-01-10 10:10:36","2019-01-11 21:00:00","2019-01-11 21:30:00",3982,1104,5086
"2019-01-10 10:10:36","2019-01-11 22:00:00","2019-01-11 22:30:00",3676,973,4649
"2019-01-11 10:10:36","2019-01-11 23:00:00","2019-01-11 23:30:00",3494,899,4393
"2019-01-11 10:10:36","2019-01-12 00:00:00","2019-01-12 00:30:00",3390,762,4152
"2019-01-11 10:10:36","2019-01-12 01:00:00","2019-01-12 01:30:00",3094,693,3787
"2019-01-11 10:10:36","2019-01-12 02:00:00","2019-01-12 02:30:00",2883,651,3534
"2019-01-11 10:10:36","2019-01-12 03:00:00","2019-01-12 03:30:00",2743,627,3370
"2019-01-11 10:10:36","2019-01-12 04:00:00","2019-01-12 04:30:00",2646,612,3258
"2019-01-11 10:10:36","2019-01-12 05:00:00","2019-01-12 05:30:00",2601,600,3201
"2019-01-11 10:10:36","2019-01-12 06:00:00","2019-01-12 06:30:00",2626,625,3251
"2019-01-11 10:10:36","2019-01-12 07:00:00","2019-01-12 07:30:00",2741,703,3444
"2019-01-11 10:10:36","2019-01-12 08:00:00","2019-01-12 08:30:00",2945,822,3767
"2019-01-11 10:10:36","2019-01-12 09:00:00","2019-01-12 09:30:00",3167,927,4094
"2019-01-11 10:10:36","2019-01-12 10:00:00","2019-01-12 10:30:00",3431,1029,4460
"2019-01-11 10:10:36","2019-01-12 11:00:00","2019-01-12 11:30:00",3597,1075,4672
"2019-01-11 10:10:36","2019-01-12 12:00:00","2019-01-12 12:30:00",3707,1098,4805
"2019-01-11 10:10:36","2019-01-12 13:00:00","2019-01-12 13:30:00",3692,1090,4782
"2019-01-11 10:10:36","2019-01-12 14:00:00","2019-01-12 14:30:00",3702,1028,4730
"2019-01-11 10:10:36","2019-01-12 15:00:00","2019-01-12 15:30:00",3748,1007,4755
"2019-01-11 10:10:36","2019-01-12 16:00:00","2019-01-12 16:30:00",3850,1120,4970
"2019-01-11 10:10:36","2019-01-12 17:00:00","2019-01-12 17:30:00",4222,1269,5491
"2019-01-11 10:10:36","2019-01-12 18:00:00","2019-01-12 18:30:00",4364,1262,5626
"2019-01-11 10:10:36","2019-01-12 19:00:00","2019-01-12 19:30:00",4148,1201,5349
"2019-01-11 10:10:36","2019-01-12 20:00:00","2019-01-12 20:30:00",3924,1080,5004
"2019-01-11 10:10:36","2019-01-12 21:00:00","2019-01-12 21:30:00",3707,999,4706
"2019-01-11 10:10:36","2019-01-12 22:00:00","2019-01-12 22:30:00",3507,936,4443
"2019-01-12 10:10:05","2019-01-12 23:00:00","2019-01-12 23:30:00",3350,888,4238
"2019-01-12 10:10:05","2019-01-13 00:00:00","2019-01-13 00:30:00",3131,779,3910
"2019-01-12 10:10:05","2019-01-13 01:00:00","2019-01-13 01:30:00",2920,702,3622
"2019-01-12 10:10:05","2019-01-13 02:00:00","2019-01-13 02:30:00",2704,679,3383
"2019-01-12 10:10:05","2019-01-13 03:00:00","2019-01-13 03:30:00",2592,650,3242
"2019-01-12 10:10:05","2019-01-13 04:00:00","2019-01-13 04:30:00",2522,624,3146
"2019-01-12 10:10:05","2019-01-13 05:00:00","2019-01-13 05:30:00",2498,619,3117
"2019-01-12 10:10:05","2019-01-13 06:00:00","2019-01-13 06:30:00",2524,642,3166
"2019-01-12 10:10:05","2019-01-13 07:00:00","2019-01-13 07:30:00",2602,716,3318
"2019-01-12 10:10:05","2019-01-13 08:00:00","2019-01-13 08:30:00",2696,786,3482
"2019-01-12 10:10:05","2019-01-13 09:00:00","2019-01-13 09:30:00",2818,868,3686
"2019-01-12 10:10:05","2019-01-13 10:00:00","2019-01-13 10:30:00",3176,930,4106
"2019-01-12 10:10:05","2019-01-13 11:00:00","2019-01-13 11:30:00",3384,1028,4412
"2019-01-12 10:10:05","2019-01-13 12:00:00","2019-01-13 12:30:00",3526,1112,4638
"2019-01-12 10:10:05","2019-01-13 13:00:00","2019-01-13 13:30:00",3656,1165,4821
"2019-01-12 10:10:05","2019-01-13 14:00:00","2019-01-13 14:30:00",3600,1132,4732
"2019-01-12 10:10:05","2019-01-13 15:00:00","2019-01-13 15:30:00",3608,1115,4723
"2019-01-12 10:10:05","2019-01-13 16:00:00","2019-01-13 16:30:00",3712,1186,4898
"2019-01-12 10:10:05","2019-01-13 17:00:00","2019-01-13 17:30:00",4013,1351,5364
"2019-01-12 10:10:05","2019-01-13 18:00:00","2019-01-13 18:30:00",4165,1390,5555
"2019-01-12 10:10:05","2019-01-13 19:00:00","2019-01-13 19:30:00",4060,1263,5323
"2019-01-12 10:10:05","2019-01-13 20:00:00","2019-01-13 20:30:00",3888,1188,5076
"2019-01-12 10:10:05","2019-01-13 21:00:00","2019-01-13 21:30:00",3675,1069,4744
"2019-01-12 10:10:05","2019-01-13 22:00:00","2019-01-13 22:30:00",3394,974,4368
"2019-01-13 10:10:11","2019-01-13 23:00:00","2019-01-13 23:30:00",3140,754,3894
"2019-01-13 10:10:11","2019-01-14 00:00:00","2019-01-14 00:30:00",3041,748,3789
"2019-01-13 10:10:11","2019-01-14 01:00:00","2019-01-14 01:30:00",2817,698,3515
"2019-01-13 10:10:11","2019-01-14 02:00:00","2019-01-14 02:30:00",2674,676,3350
"2019-01-13 10:10:11","2019-01-14 03:00:00","2019-01-14 03:30:00",2539,639,3178
"2019-01-13 10:10:11","2019-01-14 04:00:00","2019-01-14 04:30:00",2543,621,3164
"2019-01-13 10:10:11","2019-01-14 05:00:00","2019-01-14 05:30:00",2555,654,3209
"2019-01-13 10:10:11","2019-01-14 06:00:00","2019-01-14 06:30:00",2738,727,3465
"2019-01-13 10:10:11","2019-01-14 07:00:00","2019-01-14 07:30:00",3235,945,4180
"2019-01-13 10:10:11","2019-01-14 08:00:00","2019-01-14 08:30:00",3830,1178,5008
"2019-01-13 10:10:11","2019-01-14 09:00:00","2019-01-14 09:30:00",3830,1233,5063
"2019-01-13 10:10:11","2019-01-14 10:00:00","2019-01-14 10:30:00",3881,1280,5161
"2019-01-13 10:10:11","2019-01-14 11:00:00","2019-01-14 11:30:00",3914,1291,5205
"2019-01-13 10:10:11","2019-01-14 12:00:00","2019-01-14 12:30:00",3983,1292,5275
"2019-01-13 10:10:11","2019-01-14 13:00:00","2019-01-14 13:30:00",4019,1277,5296
"2019-01-13 10:10:11","2019-01-14 14:00:00","2019-01-14 14:30:00",3937,1191,5128
"2019-01-13 10:10:11","2019-01-14 15:00:00","2019-01-14 15:30:00",3975,1187,5162
"2019-01-13 10:10:11","2019-01-14 16:00:00","2019-01-14 16:30:00",4071,1275,5346
"2019-01-13 10:10:11","2019-01-14 17:00:00","2019-01-14 17:30:00",4462,1527,5989
"2019-01-13 10:10:11","2019-01-14 18:00:00","2019-01-14 18:30:00",4678,1448,6126
"2019-01-13 10:10:11","2019-01-14 19:00:00","2019-01-14 19:30:00",4477,1316,5793
"2019-01-13 10:10:11","2019-01-14 20:00:00","2019-01-14 20:30:00",4243,1217,5460
"2019-01-13 10:10:11","2019-01-14 21:00:00","2019-01-14 21:30:00",4008,1127,5135
"2019-01-13 10:10:11","2019-01-14 22:00:00","2019-01-14 22:30:00",3671,1006,4677
"2019-01-14 10:10:10","2019-01-14 23:00:00","2019-01-14 23:30:00",3422,941,4363
"2019-01-14 10:10:10","2019-01-15 00:00:00","2019-01-15 00:30:00",3223,760,3983
"2019-01-14 10:10:10","2019-01-15 01:00:00","2019-01-15 01:30:00",3011,704,3715
"2019-01-14 10:10:10","2019-01-15 02:00:00","2019-01-15 02:30:00",2835,701,3536
"2019-01-14 10:10:10","2019-01-15 03:00:00","2019-01-15 03:30:00",2746,658,3404
"2019-01-14 10:10:10","2019-01-15 04:00:00","2019-01-15 04:30:00",2727,657,3384
"2019-01-14 10:10:10","2019-01-15 05:00:00","2019-01-15 05:30:00",2719,660,3379
"2019-01-14 10:10:10","2019-01-15 06:00:00","2019-01-15 06:30:00",2928,744,3672
"2019-01-14 10:10:10","2019-01-15 07:00:00","2019-01-15 07:30:00",3375,929,4304
"2019-01-14 10:10:10","2019-01-15 08:00:00","2019-01-15 08:30:00",3986,1175,5161
"2019-01-14 10:10:10","2019-01-15 09:00:00","2019-01-15 09:30:00",4004,1175,5179
"2019-01-14 10:10:10","2019-01-15 10:00:00","2019-01-15 10:30:00",4102,1207,5309
"2019-01-14 10:10:10","2019-01-15 11:00:00","2019-01-15 11:30:00",4090,1210,5300
"2019-01-14 10:10:10","2019-01-15 12:00:00","2019-01-15 12:30:00",4098,1220,5318
"2019-01-14 10:10:10","2019-01-15 13:00:00","2019-01-15 13:30:00",4095,1216,5311
"2019-01-14 10:10:10","2019-01-15 14:00:00","2019-01-15 14:30:00",4005,1177,5182
"2019-01-14 10:10:10","2019-01-15 15:00:00","2019-01-15 15:30:00",3987,1177,5164
"2019-01-14 10:10:10","2019-01-15 16:00:00","2019-01-15 16:30:00",4142,1239,5381
"2019-01-14 10:10:10","2019-01-15 17:00:00","2019-01-15 17:30:00",4508,1471,5979
"2019-01-14 10:10:10","2019-01-15 18:00:00","2019-01-15 18:30:00",4729,1401,6130
"2019-01-14 10:10:10","2019-01-15 19:00:00","2019-01-15 19:30:00",4537,1302,5839
"2019-01-14 10:10:10","2019-01-15 20:00:00","2019-01-15 20:30:00",4362,1221,5583
"2019-01-14 10:10:10","2019-01-15 21:00:00","2019-01-15 21:30:00",4090,1137,5227
"2019-01-14 10:10:10","2019-01-15 22:00:00","2019-01-15 22:30:00",3687,1001,4688
"2019-01-15 10:10:11","2019-01-15 23:00:00","2019-01-15 23:30:00",3328,860,4188
"2019-01-15 10:10:11","2019-01-16 00:00:00","2019-01-16 00:30:00",3149,745,3894
"2019-01-15 10:10:11","2019-01-16 01:00:00","2019-01-16 01:30:00",2897,690,3587
"2019-01-15 10:10:11","2019-01-16 02:00:00","2019-01-16 02:30:00",2714,691,3405
"2019-01-15 10:10:11","2019-01-16 03:00:00","2019-01-16 03:30:00",2628,667,3295
"2019-01-15 10:10:11","2019-01-16 04:00:00","2019-01-16 04:30:00",2611,671,3282
"2019-01-15 10:10:11","2019-01-16 05:00:00","2019-01-16 05:30:00",2615,688,3303
"2019-01-15 10:10:11","2019-01-16 06:00:00","2019-01-16 06:30:00",2798,774,3572
"2019-01-15 10:10:11","2019-01-16 07:00:00","2019-01-16 07:30:00",3312,972,4284
"2019-01-15 10:10:11","2019-01-16 08:00:00","2019-01-16 08:30:00",3936,1215,5151
"2019-01-15 10:10:11","2019-01-16 09:00:00","2019-01-16 09:30:00",3944,1251,5195
"2019-01-15 10:10:11","2019-01-16 10:00:00","2019-01-16 10:30:00",4011,1291,5302
"2019-01-15 10:10:11","2019-01-16 11:00:00","2019-01-16 11:30:00",4035,1287,5322
"2019-01-15 10:10:11","2019-01-16 12:00:00","2019-01-16 12:30:00",4037,1286,5323
"2019-01-15 10:10:11","2019-01-16 13:00:00","2019-01-16 13:30:00",4052,1285,5337
"2019-01-15 10:10:11","2019-01-16 14:00:00","2019-01-16 14:30:00",4000,1248,5248
"2019-01-15 10:10:11","2019-01-16 15:00:00","2019-01-16 15:30:00",4048,1268,5316
"2019-01-15 10:10:11","2019-01-16 16:00:00","2019-01-16 16:30:00",4194,1347,5541
"2019-01-15 10:10:11","2019-01-16 17:00:00","2019-01-16 17:30:00",4613,1590,6203
"2019-01-15 10:10:11","2019-01-16 18:00:00","2019-01-16 18:30:00",4742,1541,6283
"2019-01-15 10:10:11","2019-01-16 19:00:00","2019-01-16 19:30:00",4534,1433,5967
"2019-01-15 10:10:11","2019-01-16 20:00:00","2019-01-16 20:30:00",4297,1346,5643
"2019-01-15 10:10:11","2019-01-16 21:00:00","2019-01-16 21:30:00",4045,1251,5296
"2019-01-15 10:10:11","2019-01-16 22:00:00","2019-01-16 22:30:00",3655,1103,4758
"2019-01-16 10:10:15","2019-01-16 23:00:00","2019-01-16 23:30:00",3338,924,4262
"2019-01-16 10:10:15","2019-01-17 00:00:00","2019-01-17 00:30:00",3149,796,3945
"2019-01-16 10:10:15","2019-01-17 01:00:00","2019-01-17 01:30:00",2897,740,3637
"2019-01-16 10:10:15","2019-01-17 02:00:00","2019-01-17 02:30:00",2714,731,3445
"2019-01-16 10:10:15","2019-01-17 03:00:00","2019-01-17 03:30:00",2628,712,3340
"2019-01-16 10:10:15","2019-01-17 04:00:00","2019-01-17 04:30:00",2611,699,3310
"2019-01-16 10:10:15","2019-01-17 05:00:00","2019-01-17 05:30:00",2615,706,3321
"2019-01-16 10:10:15","2019-01-17 06:00:00","2019-01-17 06:30:00",2798,796,3594
"2019-01-16 10:10:15","2019-01-17 07:00:00","2019-01-17 07:30:00",3312,1028,4340
"2019-01-16 10:10:15","2019-01-17 08:00:00","2019-01-17 08:30:00",3936,1309,5245
"2019-01-16 10:10:15","2019-01-17 09:00:00","2019-01-17 09:30:00",3944,1329,5273
"2019-01-16 10:10:15","2019-01-17 10:00:00","2019-01-17 10:30:00",4011,1349,5360
"2019-01-16 10:10:15","2019-01-17 11:00:00","2019-01-17 11:30:00",4035,1355,5390
"2019-01-16 10:10:15","2019-01-17 12:00:00","2019-01-17 12:30:00",4037,1340,5377
"2019-01-16 10:10:15","2019-01-17 13:00:00","2019-01-17 13:30:00",4052,1347,5399
"2019-01-16 10:10:15","2019-01-17 14:00:00","2019-01-17 14:30:00",4000,1319,5319
"2019-01-16 10:10:15","2019-01-17 15:00:00","2019-01-17 15:30:00",4048,1325,5373
"2019-01-16 10:10:15","2019-01-17 16:00:00","2019-01-17 16:30:00",4194,1408,5602
"2019-01-16 10:10:15","2019-01-17 17:00:00","2019-01-17 17:30:00",4613,1623,6236
"2019-01-16 10:10:15","2019-01-17 18:00:00","2019-01-17 18:30:00",4742,1596,6338
"2019-01-16 10:10:15","2019-01-17 19:00:00","2019-01-17 19:30:00",4534,1474,6008
"2019-01-16 10:10:15","2019-01-17 20:00:00","2019-01-17 20:30:00",4297,1402,5699
"2019-01-16 10:10:15","2019-01-17 21:00:00","2019-01-17 21:30:00",4045,1293,5338
"2019-01-16 10:10:15","2019-01-17 22:00:00","2019-01-17 22:30:00",3655,1142,4797
"2019-01-17 10:10:15","2019-01-17 23:00:00","2019-01-17 23:30:00",3438,924,4362
"2019-01-17 10:10:15","2019-01-18 00:00:00","2019-01-18 00:30:00",3171,806,3977
"2019-01-17 10:10:15","2019-01-18 01:00:00","2019-01-18 01:30:00",2914,733,3647
"2019-01-17 10:10:15","2019-01-18 02:00:00","2019-01-18 02:30:00",2734,741,3475
"2019-01-17 10:10:15","2019-01-18 03:00:00","2019-01-18 03:30:00",2634,712,3346
"2019-01-17 10:10:15","2019-01-18 04:00:00","2019-01-18 04:30:00",2607,687,3294
"2019-01-17 10:10:15","2019-01-18 05:00:00","2019-01-18 05:30:00",2606,698,3304
"2019-01-17 10:10:15","2019-01-18 06:00:00","2019-01-18 06:30:00",2788,765,3553
"2019-01-17 10:10:15","2019-01-18 07:00:00","2019-01-18 07:30:00",3340,959,4299
"2019-01-17 10:10:15","2019-01-18 08:00:00","2019-01-18 08:30:00",3954,1190,5144
"2019-01-17 10:10:15","2019-01-18 09:00:00","2019-01-18 09:30:00",3997,1245,5242
"2019-01-17 10:10:15","2019-01-18 10:00:00","2019-01-18 10:30:00",4052,1268,5320
"2019-01-17 10:10:15","2019-01-18 11:00:00","2019-01-18 11:30:00",4050,1280,5330
"2019-01-17 10:10:15","2019-01-18 12:00:00","2019-01-18 12:30:00",4056,1252,5308
"2019-01-17 10:10:15","2019-01-18 13:00:00","2019-01-18 13:30:00",4040,1290,5330
"2019-01-17 10:10:15","2019-01-18 14:00:00","2019-01-18 14:30:00",3951,1238,5189
"2019-01-17 10:10:15","2019-01-18 15:00:00","2019-01-18 15:30:00",3976,1217,5193
"2019-01-17 10:10:15","2019-01-18 16:00:00","2019-01-18 16:30:00",4052,1261,5313
"2019-01-17 10:10:15","2019-01-18 17:00:00","2019-01-18 17:30:00",4446,1455,5901
"2019-01-17 10:10:15","2019-01-18 18:00:00","2019-01-18 18:30:00",4588,1405,5993
"2019-01-17 10:10:15","2019-01-18 19:00:00","2019-01-18 19:30:00",4410,1306,5716
"2019-01-17 10:10:15","2019-01-18 20:00:00","2019-01-18 20:30:00",4188,1201,5389
"2019-01-17 10:10:15","2019-01-18 21:00:00","2019-01-18 21:30:00",3927,1112,5039
"2019-01-17 10:10:15","2019-01-18 22:00:00","2019-01-18 22:30:00",3649,1005,4654
"2019-01-18 10:10:21","2019-01-18 23:00:00","2019-01-18 23:30:00",3497,951,4448
"2019-01-18 10:10:21","2019-01-19 00:00:00","2019-01-19 00:30:00",3227,774,4001
"2019-01-18 10:10:21","2019-01-19 01:00:00","2019-01-19 01:30:00",2995,679,3674
"2019-01-18 10:10:21","2019-01-19 02:00:00","2019-01-19 02:30:00",2773,675,3448
"2019-01-18 10:10:21","2019-01-19 03:00:00","2019-01-19 03:30:00",2628,656,3284
"2019-01-18 10:10:21","2019-01-19 04:00:00","2019-01-19 04:30:00",2599,633,3232
"2019-01-18 10:10:21","2019-01-19 05:00:00","2019-01-19 05:30:00",2601,624,3225
"2019-01-18 10:10:21","2019-01-19 06:00:00","2019-01-19 06:30:00",2644,667,3311
"2019-01-18 10:10:21","2019-01-19 07:00:00","2019-01-19 07:30:00",2819,750,3569
"2019-01-18 10:10:21","2019-01-19 08:00:00","2019-01-19 08:30:00",3079,891,3970
"2019-01-18 10:10:21","2019-01-19 09:00:00","2019-01-19 09:30:00",3381,1013,4394
"2019-01-18 10:10:21","2019-01-19 10:00:00","2019-01-19 10:30:00",3645,1061,4706
"2019-01-18 10:10:21","2019-01-19 11:00:00","2019-01-19 11:30:00",3799,1093,4892
"2019-01-18 10:10:21","2019-01-19 12:00:00","2019-01-19 12:30:00",3836,1107,4943
"2019-01-18 10:10:21","2019-01-19 13:00:00","2019-01-19 13:30:00",3857,1105,4962
"2019-01-18 10:10:21","2019-01-19 14:00:00","2019-01-19 14:30:00",3773,1077,4850
"2019-01-18 10:10:21","2019-01-19 15:00:00","2019-01-19 15:30:00",3686,1072,4758
"2019-01-18 10:10:21","2019-01-19 16:00:00","2019-01-19 16:30:00",3745,1113,4858
"2019-01-18 10:10:21","2019-01-19 17:00:00","2019-01-19 17:30:00",4163,1315,5478
"2019-01-18 10:10:21","2019-01-19 18:00:00","2019-01-19 18:30:00",4350,1367,5717
"2019-01-18 10:10:21","2019-01-19 19:00:00","2019-01-19 19:30:00",4135,1277,5412
"2019-01-18 10:10:21","2019-01-19 20:00:00","2019-01-19 20:30:00",3891,1139,5030
"2019-01-18 10:10:21","2019-01-19 21:00:00","2019-01-19 21:30:00",3694,1065,4759
"2019-01-18 10:10:21","2019-01-19 22:00:00","2019-01-19 22:30:00",3439,977,4416
"2019-01-19 10:10:21","2019-01-19 23:00:00","2019-01-19 23:30:00",3294,911,4205
"2019-01-19 10:10:21","2019-01-20 00:00:00","2019-01-20 00:30:00",3184,747,3931
"2019-01-19 10:10:21","2019-01-20 01:00:00","2019-01-20 01:30:00",2916,682,3598
"2019-01-19 10:10:21","2019-01-20 02:00:00","2019-01-20 02:30:00",2721,658,3379
"2019-01-19 10:10:21","2019-01-20 03:00:00","2019-01-20 03:30:00",2567,624,3191
"2019-01-19 10:10:21","2019-01-20 04:00:00","2019-01-20 04:30:00",2517,611,3128
"2019-01-19 10:10:21","2019-01-20 05:00:00","2019-01-20 05:30:00",2496,610,3106
"2019-01-19 10:10:21","2019-01-20 06:00:00","2019-01-20 06:30:00",2521,641,3162
"2019-01-19 10:10:21","2019-01-20 07:00:00","2019-01-20 07:30:00",2604,705,3309
"2019-01-19 10:10:21","2019-01-20 08:00:00","2019-01-20 08:30:00",2750,814,3564
"2019-01-19 10:10:21","2019-01-20 09:00:00","2019-01-20 09:30:00",2923,918,3841
"2019-01-19 10:10:21","2019-01-20 10:00:00","2019-01-20 10:30:00",3279,984,4263
"2019-01-19 10:10:21","2019-01-20 11:00:00","2019-01-20 11:30:00",3518,1040,4558
"2019-01-19 10:10:21","2019-01-20 12:00:00","2019-01-20 12:30:00",3683,1093,4776
"2019-01-19 10:10:21","2019-01-20 13:00:00","2019-01-20 13:30:00",3771,1165,4936
"2019-01-19 10:10:21","2019-01-20 14:00:00","2019-01-20 14:30:00",3694,1107,4801
"2019-01-19 10:10:21","2019-01-20 15:00:00","2019-01-20 15:30:00",3645,1087,4732
"2019-01-19 10:10:21","2019-01-20 16:00:00","2019-01-20 16:30:00",3693,1149,4842
"2019-01-19 10:10:21","2019-01-20 17:00:00","2019-01-20 17:30:00",4076,1352,5428
"2019-01-19 10:10:21","2019-01-20 18:00:00","2019-01-20 18:30:00",4300,1356,5656
"2019-01-19 10:10:21","2019-01-20 19:00:00","2019-01-20 19:30:00",4142,1278,5420
"2019-01-19 10:10:21","2019-01-20 20:00:00","2019-01-20 20:30:00",3916,1198,5114
"2019-01-19 10:10:21","2019-01-20 21:00:00","2019-01-20 21:30:00",3714,1111,4825
"2019-01-19 10:10:21","2019-01-20 22:00:00","2019-01-20 22:30:00",3350,1018,4368
"2019-01-21 10:10:25","2019-01-20 23:00:00","2019-01-20 23:30:00",3119,768,3887
"2019-01-21 10:10:25","2019-01-21 00:00:00","2019-01-21 00:30:00",3002,736,3738
"2019-01-21 10:10:25","2019-01-21 01:00:00","2019-01-21 01:30:00",2847,685,3532
"2019-01-21 10:10:25","2019-01-21 02:00:00","2019-01-21 02:30:00",2652,684,3336
"2019-01-21 10:10:25","2019-01-21 03:00:00","2019-01-21 03:30:00",2606,667,3273
"2019-01-21 10:10:25","2019-01-21 04:00:00","2019-01-21 04:30:00",2606,672,3278
"2019-01-21 10:10:25","2019-01-21 05:00:00","2019-01-21 05:30:00",2639,680,3319
"2019-01-21 10:10:25","2019-01-21 06:00:00","2019-01-21 06:30:00",2793,756,3549
"2019-01-21 10:10:25","2019-01-21 07:00:00","2019-01-21 07:30:00",3352,973,4325
"2019-01-21 10:10:25","2019-01-21 08:00:00","2019-01-21 08:30:00",3978,1242,5220
"2019-01-21 10:10:25","2019-01-21 09:00:00","2019-01-21 09:30:00",3984,1273,5257
"2019-01-21 10:10:25","2019-01-21 10:00:00","2019-01-21 10:30:00",4206,1292,5498
"2019-01-21 10:10:25","2019-01-21 11:00:00","2019-01-21 11:30:00",4186,1300,5486
"2019-01-21 10:10:25","2019-01-21 12:00:00","2019-01-21 12:30:00",4165,1305,5470
"2019-01-21 10:10:25","2019-01-21 13:00:00","2019-01-21 13:30:00",4150,1303,5453
"2019-01-21 10:10:25","2019-01-21 14:00:00","2019-01-21 14:30:00",4066,1263,5329
"2019-01-21 10:10:25","2019-01-21 15:00:00","2019-01-21 15:30:00",4088,1260,5348
"2019-01-21 10:10:25","2019-01-21 16:00:00","2019-01-21 16:30:00",4260,1400,5660
"2019-01-21 10:10:25","2019-01-21 17:00:00","2019-01-21 17:30:00",4748,1600,6348
"2019-01-21 10:10:25","2019-01-21 18:00:00","2019-01-21 18:30:00",4902,1547,6449
"2019-01-21 10:10:25","2019-01-21 19:00:00","2019-01-21 19:30:00",4728,1413,6141
"2019-01-21 10:10:25","2019-01-21 20:00:00","2019-01-21 20:30:00",4458,1325,5783
"2019-01-21 10:10:25","2019-01-21 21:00:00","2019-01-21 21:30:00",4233,1255,5488
"2019-01-21 10:10:25","2019-01-21 22:00:00","2019-01-21 22:30:00",3856,1102,4958
"2019-01-20 10:10:25","2019-01-21 23:00:00","2019-01-21 23:30:00",3465,941,4406
"2019-01-20 10:10:25","2019-01-22 00:00:00","2019-01-22 00:30:00",3260,756,4016
"2019-01-20 10:10:25","2019-01-22 01:00:00","2019-01-22 01:30:00",3061,706,3767
"2019-01-20 10:10:25","2019-01-22 02:00:00","2019-01-22 02:30:00",2903,702,3605
"2019-01-20 10:10:25","2019-01-22 03:00:00","2019-01-22 03:30:00",2830,686,3516
"2019-01-20 10:10:25","2019-01-22 04:00:00","2019-01-22 04:30:00",2784,671,3455
"2019-01-20 10:10:25","2019-01-22 05:00:00","2019-01-22 05:30:00",2820,688,3508
"2019-01-20 10:10:25","2019-01-22 06:00:00","2019-01-22 06:30:00",2987,764,3751
"2019-01-20 10:10:25","2019-01-22 07:00:00","2019-01-22 07:30:00",3523,982,4505
"2019-01-20 10:10:25","2019-01-22 08:00:00","2019-01-22 08:30:00",4099,1242,5341
"2019-01-20 10:10:25","2019-01-22 09:00:00","2019-01-22 09:30:00",4138,1233,5371
"2019-01-20 10:10:25","2019-01-22 10:00:00","2019-01-22 10:30:00",4222,1264,5486
"2019-01-20 10:10:25","2019-01-22 11:00:00","2019-01-22 11:30:00",4226,1284,5510
"2019-01-20 10:10:25","2019-01-22 12:00:00","2019-01-22 12:30:00",4143,1234,5377
"2019-01-20 10:10:25","2019-01-22 13:00:00","2019-01-22 13:30:00",4175,1277,5452
"2019-01-20 10:10:25","2019-01-22 14:00:00","2019-01-22 14:30:00",4136,1236,5372
"2019-01-20 10:10:25","2019-01-22 15:00:00","2019-01-22 15:30:00",4191,1244,5435
"2019-01-20 10:10:25","2019-01-22 16:00:00","2019-01-22 16:30:00",4322,1305,5627
"2019-01-20 10:10:25","2019-01-22 17:00:00","2019-01-22 17:30:00",4711,1513,6224
"2019-01-20 10:10:25","2019-01-22 18:00:00","2019-01-22 18:30:00",4895,1517,6412
"2019-01-20 10:10:25","2019-01-22 19:00:00","2019-01-22 19:30:00",4719,1399,6118
"2019-01-20 10:10:25","2019-01-22 20:00:00","2019-01-22 20:30:00",4494,1331,5825
"2019-01-20 10:10:25","2019-01-22 21:00:00","2019-01-22 21:30:00",4301,1227,5528
"2019-01-20 10:10:25","2019-01-22 22:00:00","2019-01-22 22:30:00",3873,1089,4962
"2019-01-22 10:10:26","2019-01-22 23:00:00","2019-01-22 23:30:00",3523,960,4483
"2019-01-22 10:10:26","2019-01-23 00:00:00","2019-01-23 00:30:00",3276,788,4064
"2019-01-22 10:10:26","2019-01-23 01:00:00","2019-01-23 01:30:00",3029,731,3760
"2019-01-22 10:10:26","2019-01-23 02:00:00","2019-01-23 02:30:00",2903,728,3631
"2019-01-22 10:10:26","2019-01-23 03:00:00","2019-01-23 03:30:00",2805,713,3518
"2019-01-22 10:10:26","2019-01-23 04:00:00","2019-01-23 04:30:00",2759,697,3456
"2019-01-22 10:10:26","2019-01-23 05:00:00","2019-01-23 05:30:00",2798,709,3507
"2019-01-22 10:10:26","2019-01-23 06:00:00","2019-01-23 06:30:00",2959,781,3740
"2019-01-22 10:10:26","2019-01-23 07:00:00","2019-01-23 07:30:00",3483,1000,4483
"2019-01-22 10:10:26","2019-01-23 08:00:00","2019-01-23 08:30:00",4098,1275,5373
"2019-01-22 10:10:26","2019-01-23 09:00:00","2019-01-23 09:30:00",4142,1272,5414
"2019-01-22 10:10:26","2019-01-23 10:00:00","2019-01-23 10:30:00",4226,1305,5531
"2019-01-22 10:10:26","2019-01-23 11:00:00","2019-01-23 11:30:00",4225,1311,5536
"2019-01-22 10:10:26","2019-01-23 12:00:00","2019-01-23 12:30:00",4224,1258,5482
"2019-01-22 10:10:26","2019-01-23 13:00:00","2019-01-23 13:30:00",4255,1296,5551
"2019-01-22 10:10:26","2019-01-23 14:00:00","2019-01-23 14:30:00",4176,1251,5427
"2019-01-22 10:10:26","2019-01-23 15:00:00","2019-01-23 15:30:00",4211,1257,5468
"2019-01-22 10:10:26","2019-01-23 16:00:00","2019-01-23 16:30:00",4314,1326,5640
"2019-01-22 10:10:26","2019-01-23 17:00:00","2019-01-23 17:30:00",4713,1542,6255
"2019-01-22 10:10:26","2019-01-23 18:00:00","2019-01-23 18:30:00",4900,1542,6442
"2019-01-22 10:10:26","2019-01-23 19:00:00","2019-01-23 19:30:00",4710,1423,6133
"2019-01-22 10:10:26","2019-01-23 20:00:00","2019-01-23 20:30:00",4439,1353,5792
"2019-01-22 10:10:26","2019-01-23 21:00:00","2019-01-23 21:30:00",4244,1249,5493
"2019-01-22 10:10:26","2019-01-23 22:00:00","2019-01-23 22:30:00",3855,1107,4962
"2019-01-23 10:10:30","2019-01-23 23:00:00","2019-01-23 23:30:00",3528,963,4491
"2019-01-23 10:10:30","2019-01-24 00:00:00","2019-01-24 00:30:00",3276,834,4110
"2019-01-23 10:10:30","2019-01-24 01:00:00","2019-01-24 01:30:00",3029,760,3789
"2019-01-23 10:10:30","2019-01-24 02:00:00","2019-01-24 02:30:00",2903,754,3657
"2019-01-23 10:10:30","2019-01-24 03:00:00","2019-01-24 03:30:00",2805,737,3542
"2019-01-23 10:10:30","2019-01-24 04:00:00","2019-01-24 04:30:00",2759,726,3485
"2019-01-23 10:10:30","2019-01-24 05:00:00","2019-01-24 05:30:00",2798,747,3545
"2019-01-23 10:10:30","2019-01-24 06:00:00","2019-01-24 06:30:00",2959,814,3773
"2019-01-23 10:10:30","2019-01-24 07:00:00","2019-01-24 07:30:00",3483,1023,4506
"2019-01-23 10:10:30","2019-01-24 08:00:00","2019-01-24 08:30:00",4098,1272,5370
"2019-01-23 10:10:30","2019-01-24 09:00:00","2019-01-24 09:30:00",4142,1314,5456
"2019-01-23 10:10:30","2019-01-24 10:00:00","2019-01-24 10:30:00",4226,1347,5573
"2019-01-23 10:10:30","2019-01-24 11:00:00","2019-01-24 11:30:00",4225,1329,5554
"2019-01-23 10:10:30","2019-01-24 12:00:00","2019-01-24 12:30:00",4224,1333,5557
"2019-01-23 10:10:30","2019-01-24 13:00:00","2019-01-24 13:30:00",4255,1318,5573
"2019-01-23 10:10:30","2019-01-24 14:00:00","2019-01-24 14:30:00",4176,1282,5458
"2019-01-23 10:10:30","2019-01-24 15:00:00","2019-01-24 15:30:00",4211,1291,5502
"2019-01-23 10:10:30","2019-01-24 16:00:00","2019-01-24 16:30:00",4314,1333,5647
"2019-01-23 10:10:30","2019-01-24 17:00:00","2019-01-24 17:30:00",4713,1535,6248
"2019-01-23 10:10:30","2019-01-24 18:00:00","2019-01-24 18:30:00",4900,1555,6455
"2019-01-23 10:10:30","2019-01-24 19:00:00","2019-01-24 19:30:00",4710,1455,6165
"2019-01-23 10:10:30","2019-01-24 20:00:00","2019-01-24 20:30:00",4439,1379,5818
"2019-01-23 10:10:30","2019-01-24 21:00:00","2019-01-24 21:30:00",4244,1276,5520
"2019-01-23 10:10:30","2019-01-24 22:00:00","2019-01-24 22:30:00",3855,1134,4989
"2019-01-24 10:10:31","2019-01-24 23:00:00","2019-01-24 23:30:00",3528,963,4491
"2019-01-24 10:10:31","2019-01-25 00:00:00","2019-01-25 00:30:00",3225,732,3957
"2019-01-24 10:10:31","2019-01-25 01:00:00","2019-01-25 01:30:00",3056,685,3741
"2019-01-24 10:10:31","2019-01-25 02:00:00","2019-01-25 02:30:00",2806,676,3482
"2019-01-24 10:10:31","2019-01-25 03:00:00","2019-01-25 03:30:00",2787,654,3441
"2019-01-24 10:10:31","2019-01-25 04:00:00","2019-01-25 04:30:00",2761,624,3385
"2019-01-24 10:10:31","2019-01-25 05:00:00","2019-01-25 05:30:00",2754,639,3393
"2019-01-24 10:10:31","2019-01-25 06:00:00","2019-01-25 06:30:00",2932,715,3647
"2019-01-24 10:10:31","2019-01-25 07:00:00","2019-01-25 07:30:00",3412,901,4313
"2019-01-24 10:10:31","2019-01-25 08:00:00","2019-01-25 08:30:00",3895,1150,5045
"2019-01-24 10:10:31","2019-01-25 09:00:00","2019-01-25 09:30:00",3936,1195,5131
"2019-01-24 10:10:31","2019-01-25 10:00:00","2019-01-25 10:30:00",4000,1215,5215
"2019-01-24 10:10:31","2019-01-25 11:00:00","2019-01-25 11:30:00",4065,1207,5272
"2019-01-24 10:10:31","2019-01-25 12:00:00","2019-01-25 12:30:00",4080,1215,5295
"2019-01-24 10:10:31","2019-01-25 13:00:00","2019-01-25 13:30:00",4035,1190,5225
"2019-01-24 10:10:31","2019-01-25 14:00:00","2019-01-25 14:30:00",3956,1162,5118
"2019-01-24 10:10:31","2019-01-25 15:00:00","2019-01-25 15:30:00",3967,1152,5119
"2019-01-24 10:10:31","2019-01-25 16:00:00","2019-01-25 16:30:00",4067,1165,5232
"2019-01-24 10:10:31","2019-01-25 17:00:00","2019-01-25 17:30:00",4426,1346,5772
"2019-01-24 10:10:31","2019-01-25 18:00:00","2019-01-25 18:30:00",4625,1325,5950
"2019-01-24 10:10:31","2019-01-25 19:00:00","2019-01-25 19:30:00",4453,1253,5706
"2019-01-24 10:10:31","2019-01-25 20:00:00","2019-01-25 20:30:00",4227,1162,5389
"2019-01-24 10:10:31","2019-01-25 21:00:00","2019-01-25 21:30:00",4002,1078,5080
"2019-01-24 10:10:31","2019-01-25 22:00:00","2019-01-25 22:30:00",3693,974,4667
"2019-01-25 10:10:36","2019-01-25 23:00:00","2019-01-25 23:30:00",3375,878,4253
"2019-01-25 10:10:36","2019-01-26 00:00:00","2019-01-26 00:30:00",3278,753,4031
"2019-01-25 10:10:36","2019-01-26 01:00:00","2019-01-26 01:30:00",3021,680,3701
"2019-01-25 10:10:36","2019-01-26 02:00:00","2019-01-26 02:30:00",2806,658,3464
"2019-01-25 10:10:36","2019-01-26 03:00:00","2019-01-26 03:30:00",2693,630,3323
"2019-01-25 10:10:36","2019-01-26 04:00:00","2019-01-26 04:30:00",2645,625,3270
"2019-01-25 10:10:36","2019-01-26 05:00:00","2019-01-26 05:30:00",2620,620,3240
"2019-01-25 10:10:36","2019-01-26 06:00:00","2019-01-26 06:30:00",2683,670,3353
"2019-01-25 10:10:36","2019-01-26 07:00:00","2019-01-26 07:30:00",2845,760,3605
"2019-01-25 10:10:36","2019-01-26 08:00:00","2019-01-26 08:30:00",3092,900,3992
"2019-01-25 10:10:36","2019-01-26 09:00:00","2019-01-26 09:30:00",3378,1010,4388
"2019-01-25 10:10:36","2019-01-26 10:00:00","2019-01-26 10:30:00",3662,1090,4752
"2019-01-25 10:10:36","2019-01-26 11:00:00","2019-01-26 11:30:00",3784,1103,4887
"2019-01-25 10:10:36","2019-01-26 12:00:00","2019-01-26 12:30:00",3826,1122,4948
"2019-01-25 10:10:36","2019-01-26 13:00:00","2019-01-26 13:30:00",3824,1093,4917
"2019-01-25 10:10:36","2019-01-26 14:00:00","2019-01-26 14:30:00",3717,1083,4800
"2019-01-25 10:10:36","2019-01-26 15:00:00","2019-01-26 15:30:00",3681,1070,4751
"2019-01-25 10:10:36","2019-01-26 16:00:00","2019-01-26 16:30:00",3750,1100,4850
"2019-01-25 10:10:36","2019-01-26 17:00:00","2019-01-26 17:30:00",4070,1300,5370
"2019-01-25 10:10:36","2019-01-26 18:00:00","2019-01-26 18:30:00",4300,1310,5610
"2019-01-25 10:10:36","2019-01-26 19:00:00","2019-01-26 19:30:00",4105,1230,5335
"2019-01-25 10:10:36","2019-01-26 20:00:00","2019-01-26 20:30:00",3883,1111,4994
"2019-01-25 10:10:36","2019-01-26 21:00:00","2019-01-26 21:30:00",3643,1038,4681
"2019-01-25 10:10:36","2019-01-26 22:00:00","2019-01-26 22:30:00",3412,942,4354
"2019-01-26 10:10:35","2019-01-26 23:00:00","2019-01-26 23:30:00",3256,891,4147
"2019-01-26 10:10:35","2019-01-27 00:00:00","2019-01-27 00:30:00",3169,753,3922
"2019-01-26 10:10:35","2019-01-27 01:00:00","2019-01-27 01:30:00",2922,681,3603
"2019-01-26 10:10:35","2019-01-27 02:00:00","2019-01-27 02:30:00",2685,665,3350
"2019-01-26 10:10:35","2019-01-27 03:00:00","2019-01-27 03:30:00",2580,633,3213
"2019-01-26 10:10:35","2019-01-27 04:00:00","2019-01-27 04:30:00",2547,617,3164
"2019-01-26 10:10:35","2019-01-27 05:00:00","2019-01-27 05:30:00",2480,608,3088
"2019-01-26 10:10:35","2019-01-27 06:00:00","2019-01-27 06:30:00",2548,634,3182
"2019-01-26 10:10:35","2019-01-27 07:00:00","2019-01-27 07:30:00",2650,700,3350
"2019-01-26 10:10:35","2019-01-27 08:00:00","2019-01-27 08:30:00",2777,788,3565
"2019-01-26 10:10:35","2019-01-27 09:00:00","2019-01-27 09:30:00",2907,879,3786
"2019-01-26 10:10:35","2019-01-27 10:00:00","2019-01-27 10:30:00",3252,984,4236
"2019-01-26 10:10:35","2019-01-27 11:00:00","2019-01-27 11:30:00",3483,1040,4523
"2019-01-26 10:10:35","2019-01-27 12:00:00","2019-01-27 12:30:00",3621,1084,4705
"2019-01-26 10:10:35","2019-01-27 13:00:00","2019-01-27 13:30:00",3703,1146,4849
"2019-01-26 10:10:35","2019-01-27 14:00:00","2019-01-27 14:30:00",3568,1071,4639
"2019-01-26 10:10:35","2019-01-27 15:00:00","2019-01-27 15:30:00",3511,1068,4579
"2019-01-26 10:10:35","2019-01-27 16:00:00","2019-01-27 16:30:00",3518,1096,4614
"2019-01-26 10:10:35","2019-01-27 17:00:00","2019-01-27 17:30:00",3795,1271,5066
"2019-01-26 10:10:35","2019-01-27 18:00:00","2019-01-27 18:30:00",4250,1333,5583
"2019-01-26 10:10:35","2019-01-27 19:00:00","2019-01-27 19:30:00",4135,1245,5380
"2019-01-26 10:10:35","2019-01-27 20:00:00","2019-01-27 20:30:00",3954,1173,5127
"2019-01-26 10:10:35","2019-01-27 21:00:00","2019-01-27 21:30:00",3768,1095,4863
"2019-01-26 10:10:35","2019-01-27 22:00:00","2019-01-27 22:30:00",3478,1007,4485
"2019-01-27 10:10:06","2019-01-27 23:00:00","2019-01-27 23:30:00",3244,755,3999
"2019-01-27 10:10:06","2019-01-28 00:00:00","2019-01-28 00:30:00",3116,751,3867
"2019-01-27 10:10:06","2019-01-28 01:00:00","2019-01-28 01:30:00",2912,711,3623
"2019-01-27 10:10:06","2019-01-28 02:00:00","2019-01-28 02:30:00",2766,700,3466
"2019-01-27 10:10:06","2019-01-28 03:00:00","2019-01-28 03:30:00",2661,674,3335
"2019-01-27 10:10:06","2019-01-28 04:00:00","2019-01-28 04:30:00",2600,666,3266
"2019-01-27 10:10:06","2019-01-28 05:00:00","2019-01-28 05:30:00",2626,686,3312
"2019-01-27 10:10:06","2019-01-28 06:00:00","2019-01-28 06:30:00",2813,775,3588
"2019-01-27 10:10:06","2019-01-28 07:00:00","2019-01-28 07:30:00",3370,991,4361
"2019-01-27 10:10:06","2019-01-28 08:00:00","2019-01-28 08:30:00",3970,1237,5207
"2019-01-27 10:10:06","2019-01-28 09:00:00","2019-01-28 09:30:00",4070,1293,5363
"2019-01-27 10:10:06","2019-01-28 10:00:00","2019-01-28 10:30:00",4188,1326,5514
"2019-01-27 10:10:06","2019-01-28 11:00:00","2019-01-28 11:30:00",4210,1307,5517
"2019-01-27 10:10:06","2019-01-28 12:00:00","2019-01-28 12:30:00",4285,1313,5598
"2019-01-27 10:10:06","2019-01-28 13:00:00","2019-01-28 13:30:00",4350,1330,5680
"2019-01-27 10:10:06","2019-01-28 14:00:00","2019-01-28 14:30:00",4310,1294,5604
"2019-01-27 10:10:06","2019-01-28 15:00:00","2019-01-28 15:30:00",4375,1291,5666
"2019-01-27 10:10:06","2019-01-28 16:00:00","2019-01-28 16:30:00",4463,1362,5825
"2019-01-27 10:10:06","2019-01-28 17:00:00","2019-01-28 17:30:00",4786,1569,6355
"2019-01-27 10:10:06","2019-01-28 18:00:00","2019-01-28 18:30:00",4887,1507,6394
"2019-01-27 10:10:06","2019-01-28 19:00:00","2019-01-28 19:30:00",4666,1404,6070
"2019-01-27 10:10:06","2019-01-28 20:00:00","2019-01-28 20:30:00",4428,1285,5713
"2019-01-27 10:10:06","2019-01-28 21:00:00","2019-01-28 21:30:00",4131,1216,5347
"2019-01-27 10:10:06","2019-01-28 22:00:00","2019-01-28 22:30:00",3754,1076,4830
"2019-01-28 10:10:06","2019-01-28 23:00:00","2019-01-28 23:30:00",3574,887,4461
"2019-01-28 10:10:06","2019-01-29 00:00:00","2019-01-29 00:30:00",3290,776,4066
"2019-01-28 10:10:06","2019-01-29 01:00:00","2019-01-29 01:30:00",3091,716,3807
"2019-01-28 10:10:06","2019-01-29 02:00:00","2019-01-29 02:30:00",2955,723,3678
"2019-01-28 10:10:06","2019-01-29 03:00:00","2019-01-29 03:30:00",2870,700,3570
"2019-01-28 10:10:06","2019-01-29 04:00:00","2019-01-29 04:30:00",2794,689,3483
"2019-01-28 10:10:06","2019-01-29 05:00:00","2019-01-29 05:30:00",2818,706,3524
"2019-01-28 10:10:06","2019-01-29 06:00:00","2019-01-29 06:30:00",3029,811,3840
"2019-01-28 10:10:06","2019-01-29 07:00:00","2019-01-29 07:30:00",3561,1042,4603
"2019-01-28 10:10:06","2019-01-29 08:00:00","2019-01-29 08:30:00",4118,1277,5395
"2019-01-28 10:10:06","2019-01-29 09:00:00","2019-01-29 09:30:00",4144,1305,5449
"2019-01-28 10:10:06","2019-01-29 10:00:00","2019-01-29 10:30:00",4250,1318,5568
"2019-01-28 10:10:06","2019-01-29 11:00:00","2019-01-29 11:30:00",4253,1307,5560
"2019-01-28 10:10:06","2019-01-29 12:00:00","2019-01-29 12:30:00",4280,1273,5553
"2019-01-28 10:10:06","2019-01-29 13:00:00","2019-01-29 13:30:00",4310,1280,5590
"2019-01-28 10:10:06","2019-01-29 14:00:00","2019-01-29 14:30:00",4235,1245,5480
"2019-01-28 10:10:06","2019-01-29 15:00:00","2019-01-29 15:30:00",4277,1270,5547
"2019-01-28 10:10:06","2019-01-29 16:00:00","2019-01-29 16:30:00",4386,1322,5708
"2019-01-28 10:10:06","2019-01-29 17:00:00","2019-01-29 17:30:00",4703,1527,6230
"2019-01-28 10:10:06","2019-01-29 18:00:00","2019-01-29 18:30:00",4900,1543,6443
"2019-01-28 10:10:06","2019-01-29 19:00:00","2019-01-29 19:30:00",4735,1437,6172
"2019-01-28 10:10:06","2019-01-29 20:00:00","2019-01-29 20:30:00",4471,1348,5819
"2019-01-28 10:10:06","2019-01-29 21:00:00","2019-01-29 21:30:00",4232,1263,5495
"2019-01-28 10:10:06","2019-01-29 22:00:00","2019-01-29 22:30:00",3843,1101,4944
"2019-01-29 10:10:11","2019-01-29 23:00:00","2019-01-29 23:30:00",3590,966,4556
"2019-01-29 10:10:11","2019-01-30 00:00:00","2019-01-30 00:30:00",3269,800,4069
"2019-01-29 10:10:11","2019-01-30 01:00:00","2019-01-30 01:30:00",3068,742,3810
"2019-01-29 10:10:11","2019-01-30 02:00:00","2019-01-30 02:30:00",2932,743,3675
"2019-01-29 10:10:11","2019-01-30 03:00:00","2019-01-30 03:30:00",2846,715,3561
"2019-01-29 10:10:11","2019-01-30 04:00:00","2019-01-30 04:30:00",2769,698,3467
"2019-01-29 10:10:11","2019-01-30 05:00:00","2019-01-30 05:30:00",2794,711,3505
"2019-01-29 10:10:11","2019-01-30 06:00:00","2019-01-30 06:30:00",3006,812,3818
"2019-01-29 10:10:11","2019-01-30 07:00:00","2019-01-30 07:30:00",3542,1039,4581
"2019-01-29 10:10:11","2019-01-30 08:00:00","2019-01-30 08:30:00",4102,1293,5395
"2019-01-29 10:10:11","2019-01-30 09:00:00","2019-01-30 09:30:00",4129,1312,5441
"2019-01-29 10:10:11","2019-01-30 10:00:00","2019-01-30 10:30:00",4235,1351,5586
"2019-01-29 10:10:11","2019-01-30 11:00:00","2019-01-30 11:30:00",4239,1324,5563
"2019-01-29 10:10:11","2019-01-30 12:00:00","2019-01-30 12:30:00",4266,1307,5573
"2019-01-29 10:10:11","2019-01-30 13:00:00","2019-01-30 13:30:00",4296,1307,5603
"2019-01-29 10:10:11","2019-01-30 14:00:00","2019-01-30 14:30:00",4221,1268,5489
"2019-01-29 10:10:11","2019-01-30 15:00:00","2019-01-30 15:30:00",4263,1281,5544
"2019-01-29 10:10:11","2019-01-30 16:00:00","2019-01-30 16:30:00",4373,1333,5706
"2019-01-29 10:10:11","2019-01-30 17:00:00","2019-01-30 17:30:00",4692,1547,6239
"2019-01-29 10:10:11","2019-01-30 18:00:00","2019-01-30 18:30:00",4890,1580,6470
"2019-01-29 10:10:11","2019-01-30 19:00:00","2019-01-30 19:30:00",4724,1486,6210
"2019-01-29 10:10:11","2019-01-30 20:00:00","2019-01-30 20:30:00",4458,1401,5859
"2019-01-29 10:10:11","2019-01-30 21:00:00","2019-01-30 21:30:00",4218,1312,5530
"2019-01-29 10:10:11","2019-01-30 22:00:00","2019-01-30 22:30:00",3826,1156,4982
"2019-01-30 10:10:10","2019-01-30 23:00:00","2019-01-30 23:30:00",3501,985,4486
"2019-01-30 10:10:10","2019-01-31 00:00:00","2019-01-31 00:30:00",3313,801,4114
"2019-01-30 10:10:10","2019-01-31 01:00:00","2019-01-31 01:30:00",3098,750,3848
"2019-01-30 10:10:10","2019-01-31 02:00:00","2019-01-31 02:30:00",2922,767,3689
"2019-01-30 10:10:10","2019-01-31 03:00:00","2019-01-31 03:30:00",2842,742,3584
"2019-01-30 10:10:10","2019-01-31 04:00:00","2019-01-31 04:30:00",2803,729,3532
"2019-01-30 10:10:10","2019-01-31 05:00:00","2019-01-31 05:30:00",2802,734,3536
"2019-01-30 10:10:10","2019-01-31 06:00:00","2019-01-31 06:30:00",2956,830,3786
"2019-01-30 10:10:10","2019-01-31 07:00:00","2019-01-31 07:30:00",3564,1046,4610
"2019-01-30 10:10:10","2019-01-31 08:00:00","2019-01-31 08:30:00",4120,1295,5415
"2019-01-30 10:10:10","2019-01-31 09:00:00","2019-01-31 09:30:00",4159,1318,5477
"2019-01-30 10:10:10","2019-01-31 10:00:00","2019-01-31 10:30:00",4296,1342,5638
"2019-01-30 10:10:10","2019-01-31 11:00:00","2019-01-31 11:30:00",4297,1345,5642
"2019-01-30 10:10:10","2019-01-31 12:00:00","2019-01-31 12:30:00",4267,1300,5567
"2019-01-30 10:10:10","2019-01-31 13:00:00","2019-01-31 13:30:00",4331,1305,5636
"2019-01-30 10:10:10","2019-01-31 14:00:00","2019-01-31 14:30:00",4182,1255,5437
"2019-01-30 10:10:10","2019-01-31 15:00:00","2019-01-31 15:30:00",4239,1265,5504
"2019-01-30 10:10:10","2019-01-31 16:00:00","2019-01-31 16:30:00",4336,1320,5656
"2019-01-30 10:10:10","2019-01-31 17:00:00","2019-01-31 17:30:00",4568,1560,6128
"2019-01-30 10:10:10","2019-01-31 18:00:00","2019-01-31 18:30:00",4950,1570,6520
"2019-01-30 10:10:10","2019-01-31 19:00:00","2019-01-31 19:30:00",4815,1480,6295
"2019-01-30 10:10:10","2019-01-31 20:00:00","2019-01-31 20:30:00",4598,1400,5998
"2019-01-30 10:10:10","2019-01-31 21:00:00","2019-01-31 21:30:00",4321,1280,5601
"2019-01-30 10:10:10","2019-01-31 22:00:00","2019-01-31 22:30:00",3944,1150,5094
"2019-01-31 10:10:16","2019-01-31 23:00:00","2019-01-31 23:30:00",3593,963,4556
"2019-01-31 10:10:16","2019-02-01 00:00:00","2019-02-01 00:30:00",3384,841,4225
"2019-01-31 10:10:16","2019-02-01 01:00:00","2019-02-01 01:30:00",3148,787,3935
"2019-01-31 10:10:16","2019-02-01 02:00:00","2019-02-01 02:30:00",2958,775,3733
"2019-01-31 10:10:16","2019-02-01 03:00:00","2019-02-01 03:30:00",2886,736,3622
"2019-01-31 10:10:16","2019-02-01 04:00:00","2019-02-01 04:30:00",2825,734,3559
"2019-01-31 10:10:16","2019-02-01 05:00:00","2019-02-01 05:30:00",2820,751,3571
"2019-01-31 10:10:16","2019-02-01 06:00:00","2019-02-01 06:30:00",2996,900,3896
"2019-01-31 10:10:16","2019-02-01 07:00:00","2019-02-01 07:30:00",3504,1150,4654
"2019-01-31 10:10:16","2019-02-01 08:00:00","2019-02-01 08:30:00",4089,1322,5411
"2019-01-31 10:10:16","2019-02-01 09:00:00","2019-02-01 09:30:00",4117,1340,5457
"2019-01-31 10:10:16","2019-02-01 10:00:00","2019-02-01 10:30:00",4248,1359,5607
"2019-01-31 10:10:16","2019-02-01 11:00:00","2019-02-01 11:30:00",4244,1330,5574
"2019-01-31 10:10:16","2019-02-01 12:00:00","2019-02-01 12:30:00",4199,1293,5492
"2019-01-31 10:10:16","2019-02-01 13:00:00","2019-02-01 13:30:00",4192,1264,5456
"2019-01-31 10:10:16","2019-02-01 14:00:00","2019-02-01 14:30:00",4120,1196,5316
"2019-01-31 10:10:16","2019-02-01 15:00:00","2019-02-01 15:30:00",4102,1168,5270
"2019-01-31 10:10:16","2019-02-01 16:00:00","2019-02-01 16:30:00",4168,1223,5391
"2019-01-31 10:10:16","2019-02-01 17:00:00","2019-02-01 17:30:00",4355,1430,5785
"2019-01-31 10:10:16","2019-02-01 18:00:00","2019-02-01 18:30:00",4700,1480,6180
"2019-01-31 10:10:16","2019-02-01 19:00:00","2019-02-01 19:30:00",4563,1362,5925
"2019-01-31 10:10:16","2019-02-01 20:00:00","2019-02-01 20:30:00",4276,1250,5526
"2019-01-31 10:10:16","2019-02-01 21:00:00","2019-02-01 21:30:00",4069,1143,5212
"2019-01-31 10:10:16","2019-02-01 22:00:00","2019-02-01 22:30:00",3697,1028,4725
"2019-02-02 10:10:16","2019-02-01 23:00:00","2019-02-01 23:30:00",3507,958,4465
"2019-02-02 10:10:16","2019-02-02 00:00:00","2019-02-02 00:30:00",3404,780,4184
"2019-02-02 10:10:16","2019-02-02 01:00:00","2019-02-02 01:30:00",3144,752,3896
"2019-02-02 10:10:16","2019-02-02 02:00:00","2019-02-02 02:30:00",2965,715,3680
"2019-02-02 10:10:16","2019-02-02 03:00:00","2019-02-02 03:30:00",2823,689,3512
"2019-02-02 10:10:16","2019-02-02 04:00:00","2019-02-02 04:30:00",2761,673,3434
"2019-02-02 10:10:16","2019-02-02 05:00:00","2019-02-02 05:30:00",2715,695,3410
"2019-02-02 10:10:16","2019-02-02 06:00:00","2019-02-02 06:30:00",2776,754,3530
"2019-02-02 10:10:16","2019-02-02 07:00:00","2019-02-02 07:30:00",2982,856,3838
"2019-02-02 10:10:16","2019-02-02 08:00:00","2019-02-02 08:30:00",3208,968,4176
"2019-02-02 10:10:16","2019-02-02 09:00:00","2019-02-02 09:30:00",3504,1108,4612
"2019-02-02 10:10:16","2019-02-02 10:00:00","2019-02-02 10:30:00",3820,1162,4982
"2019-02-02 10:10:16","2019-02-02 11:00:00","2019-02-02 11:30:00",3940,1176,5116
"2019-02-02 10:10:16","2019-02-02 12:00:00","2019-02-02 12:30:00",3930,1176,5106
"2019-02-02 10:10:16","2019-02-02 13:00:00","2019-02-02 13:30:00",4015,1136,5151
"2019-02-02 10:10:16","2019-02-02 14:00:00","2019-02-02 14:30:00",3898,1096,4994
"2019-02-02 10:10:16","2019-02-02 15:00:00","2019-02-02 15:30:00",3801,1102,4903
"2019-02-02 10:10:16","2019-02-02 16:00:00","2019-02-02 16:30:00",3839,1140,4979
"2019-02-02 10:10:16","2019-02-02 17:00:00","2019-02-02 17:30:00",3964,1298,5262
"2019-02-02 10:10:16","2019-02-02 18:00:00","2019-02-02 18:30:00",4350,1358,5708
"2019-02-02 10:10:16","2019-02-02 19:00:00","2019-02-02 19:30:00",4252,1265,5517
"2019-02-02 10:10:16","2019-02-02 20:00:00","2019-02-02 20:30:00",4023,1163,5186
"2019-02-02 10:10:16","2019-02-02 21:00:00","2019-02-02 21:30:00",3798,1085,4883
"2019-02-02 10:10:16","2019-02-02 22:00:00","2019-02-02 22:30:00",3555,990,4545
"2019-02-01 10:10:16","2019-02-02 23:00:00","2019-02-02 23:30:00",3418,874,4292
"2019-02-01 10:10:16","2019-02-03 00:00:00","2019-02-03 00:30:00",3272,743,4015
"2019-02-01 10:10:16","2019-02-03 01:00:00","2019-02-03 01:30:00",3029,664,3693
"2019-02-01 10:10:16","2019-02-03 02:00:00","2019-02-03 02:30:00",2863,655,3518
"2019-02-01 10:10:16","2019-02-03 03:00:00","2019-02-03 03:30:00",2760,622,3382
"2019-02-01 10:10:16","2019-02-03 04:00:00","2019-02-03 04:30:00",2709,609,3318
"2019-02-01 10:10:16","2019-02-03 05:00:00","2019-02-03 05:30:00",2674,602,3276
"2019-02-01 10:10:16","2019-02-03 06:00:00","2019-02-03 06:30:00",2690,631,3321
"2019-02-01 10:10:16","2019-02-03 07:00:00","2019-02-03 07:30:00",2755,693,3448
"2019-02-01 10:10:16","2019-02-03 08:00:00","2019-02-03 08:30:00",2897,800,3697
"2019-02-01 10:10:16","2019-02-03 09:00:00","2019-02-03 09:30:00",3121,872,3993
"2019-02-01 10:10:16","2019-02-03 10:00:00","2019-02-03 10:30:00",3440,969,4409
"2019-02-01 10:10:16","2019-02-03 11:00:00","2019-02-03 11:30:00",3628,1005,4633
"2019-02-01 10:10:16","2019-02-03 12:00:00","2019-02-03 12:30:00",3675,1058,4733
"2019-02-01 10:10:16","2019-02-03 13:00:00","2019-02-03 13:30:00",3754,1076,4830
"2019-02-01 10:10:16","2019-02-03 14:00:00","2019-02-03 14:30:00",3726,1032,4758
"2019-02-01 10:10:16","2019-02-03 15:00:00","2019-02-03 15:30:00",3633,990,4623
"2019-02-01 10:10:16","2019-02-03 16:00:00","2019-02-03 16:30:00",3672,1033,4705
"2019-02-01 10:10:16","2019-02-03 17:00:00","2019-02-03 17:30:00",3879,1173,5052
"2019-02-01 10:10:16","2019-02-03 18:00:00","2019-02-03 18:30:00",4300,1284,5584
"2019-02-01 10:10:16","2019-02-03 19:00:00","2019-02-03 19:30:00",4209,1187,5396
"2019-02-01 10:10:16","2019-02-03 20:00:00","2019-02-03 20:30:00",4015,1108,5123
"2019-02-01 10:10:16","2019-02-03 21:00:00","2019-02-03 21:30:00",3836,1067,4903
"2019-02-01 10:10:16","2019-02-03 22:00:00","2019-02-03 22:30:00",3523,972,4495
"2019-02-03 10:10:21","2019-02-03 23:00:00","2019-02-03 23:30:00",3321,780,4101
"2019-02-03 10:10:21","2019-02-04 00:00:00","2019-02-04 00:30:00",3006,662,3668
"2019-02-03 10:10:21","2019-02-04 01:00:00","2019-02-04 01:30:00",2760,627,3387
"2019-02-03 10:10:21","2019-02-04 02:00:00","2019-02-04 02:30:00",2590,644,3234
"2019-02-03 10:10:21","2019-02-04 03:00:00","2019-02-04 03:30:00",2510,599,3109
"2019-02-03 10:10:21","2019-02-04 04:00:00","2019-02-04 04:30:00",2494,594,3088
"2019-02-03 10:10:21","2019-02-04 05:00:00","2019-02-04 05:30:00",2519,625,3144
"2019-02-03 10:10:21","2019-02-04 06:00:00","2019-02-04 06:30:00",2710,698,3408
"2019-02-03 10:10:21","2019-02-04 07:00:00","2019-02-04 07:30:00",3236,927,4163
"2019-02-03 10:10:21","2019-02-04 08:00:00","2019-02-04 08:30:00",3792,1144,4936
"2019-02-03 10:10:21","2019-02-04 09:00:00","2019-02-04 09:30:00",3874,1175,5049
"2019-02-03 10:10:21","2019-02-04 10:00:00","2019-02-04 10:30:00",4023,1230,5253
"2019-02-03 10:10:21","2019-02-04 11:00:00","2019-02-04 11:30:00",4055,1225,5280
"2019-02-03 10:10:21","2019-02-04 12:00:00","2019-02-04 12:30:00",4022,1191,5213
"2019-02-03 10:10:21","2019-02-04 13:00:00","2019-02-04 13:30:00",4007,1216,5223
"2019-02-03 10:10:21","2019-02-04 14:00:00","2019-02-04 14:30:00",3853,1159,5012
"2019-02-03 10:10:21","2019-02-04 15:00:00","2019-02-04 15:30:00",3895,1182,5077
"2019-02-03 10:10:21","2019-02-04 16:00:00","2019-02-04 16:30:00",4027,1224,5251
"2019-02-03 10:10:21","2019-02-04 17:00:00","2019-02-04 17:30:00",4313,1375,5688
"2019-02-03 10:10:21","2019-02-04 18:00:00","2019-02-04 18:30:00",4705,1448,6153
"2019-02-03 10:10:21","2019-02-04 19:00:00","2019-02-04 19:30:00",4577,1326,5903
"2019-02-03 10:10:21","2019-02-04 20:00:00","2019-02-04 20:30:00",4434,1257,5691
"2019-02-03 10:10:21","2019-02-04 21:00:00","2019-02-04 21:30:00",4144,1177,5321
"2019-02-03 10:10:21","2019-02-04 22:00:00","2019-02-04 22:30:00",3777,1037,4814
"2019-02-04 10:10:21","2019-02-04 23:00:00","2019-02-04 23:30:00",3455,878,4333
"2019-02-04 10:10:21","2019-02-05 00:00:00","2019-02-05 00:30:00",3281,791,4072
"2019-02-04 10:10:21","2019-02-05 01:00:00","2019-02-05 01:30:00",3071,752,3823
"2019-02-04 10:10:21","2019-02-05 02:00:00","2019-02-05 02:30:00",2899,731,3630
"2019-02-04 10:10:21","2019-02-05 03:00:00","2019-02-05 03:30:00",2821,709,3530
"2019-02-04 10:10:21","2019-02-05 04:00:00","2019-02-05 04:30:00",2782,697,3479
"2019-02-04 10:10:21","2019-02-05 05:00:00","2019-02-05 05:30:00",2782,679,3461
"2019-02-04 10:10:21","2019-02-05 06:00:00","2019-02-05 06:30:00",2932,762,3694
"2019-02-04 10:10:21","2019-02-05 07:00:00","2019-02-05 07:30:00",3526,961,4487
"2019-02-04 10:10:21","2019-02-05 08:00:00","2019-02-05 08:30:00",4069,1175,5244
"2019-02-04 10:10:21","2019-02-05 09:00:00","2019-02-05 09:30:00",4107,1185,5292
"2019-02-04 10:10:21","2019-02-05 10:00:00","2019-02-05 10:30:00",4241,1232,5473
"2019-02-04 10:10:21","2019-02-05 11:00:00","2019-02-05 11:30:00",4242,1222,5464
"2019-02-04 10:10:21","2019-02-05 12:00:00","2019-02-05 12:30:00",4212,1214,5426
"2019-02-04 10:10:21","2019-02-05 13:00:00","2019-02-05 13:30:00",4275,1222,5497
"2019-02-04 10:10:21","2019-02-05 14:00:00","2019-02-05 14:30:00",4129,1192,5321
"2019-02-04 10:10:21","2019-02-05 15:00:00","2019-02-05 15:30:00",4186,1198,5384
"2019-02-04 10:10:21","2019-02-05 16:00:00","2019-02-05 16:30:00",4280,1230,5510
"2019-02-04 10:10:21","2019-02-05 17:00:00","2019-02-05 17:30:00",4507,1336,5843
"2019-02-04 10:10:21","2019-02-05 18:00:00","2019-02-05 18:30:00",4880,1430,6310
"2019-02-04 10:10:21","2019-02-05 19:00:00","2019-02-05 19:30:00",4748,1349,6097
"2019-02-04 10:10:21","2019-02-05 20:00:00","2019-02-05 20:30:00",4536,1204,5740
"2019-02-04 10:10:21","2019-02-05 21:00:00","2019-02-05 21:30:00",4265,1146,5411
"2019-02-04 10:10:21","2019-02-05 22:00:00","2019-02-05 22:30:00",3897,1011,4908
"2019-02-05 10:10:21","2019-02-05 23:00:00","2019-02-05 23:30:00",3542,955,4497
"2019-02-05 10:10:21","2019-02-06 00:00:00","2019-02-06 00:30:00",3281,748,4029
"2019-02-05 10:10:21","2019-02-06 01:00:00","2019-02-06 01:30:00",3063,711,3774
"2019-02-05 10:10:21","2019-02-06 02:00:00","2019-02-06 02:30:00",2885,699,3584
"2019-02-05 10:10:21","2019-02-06 03:00:00","2019-02-06 03:30:00",2800,681,3481
"2019-02-05 10:10:21","2019-02-06 04:00:00","2019-02-06 04:30:00",2756,672,3428
"2019-02-05 10:10:21","2019-02-06 05:00:00","2019-02-06 05:30:00",2749,674,3423
"2019-02-05 10:10:21","2019-02-06 06:00:00","2019-02-06 06:30:00",2891,764,3655
"2019-02-05 10:10:21","2019-02-06 07:00:00","2019-02-06 07:30:00",3470,976,4446
"2019-02-05 10:10:21","2019-02-06 08:00:00","2019-02-06 08:30:00",3996,1194,5190
"2019-02-05 10:10:21","2019-02-06 09:00:00","2019-02-06 09:30:00",4025,1223,5248
"2019-02-05 10:10:21","2019-02-06 10:00:00","2019-02-06 10:30:00",4148,1266,5414
"2019-02-05 10:10:21","2019-02-06 11:00:00","2019-02-06 11:30:00",4141,1237,5378
"2019-02-05 10:10:21","2019-02-06 12:00:00","2019-02-06 12:30:00",4103,1217,5320
"2019-02-05 10:10:21","2019-02-06 13:00:00","2019-02-06 13:30:00",4156,1212,5368
"2019-02-05 10:10:21","2019-02-06 14:00:00","2019-02-06 14:30:00",4006,1183,5189
"2019-02-05 10:10:21","2019-02-06 15:00:00","2019-02-06 15:30:00",4052,1178,5230
"2019-02-05 10:10:21","2019-02-06 16:00:00","2019-02-06 16:30:00",4135,1222,5357
"2019-02-05 10:10:21","2019-02-06 17:00:00","2019-02-06 17:30:00",4345,1346,5691
"2019-02-05 10:10:21","2019-02-06 18:00:00","2019-02-06 18:30:00",4695,1463,6158
"2019-02-05 10:10:21","2019-02-06 19:00:00","2019-02-06 19:30:00",4600,1355,5955
"2019-02-05 10:10:21","2019-02-06 20:00:00","2019-02-06 20:30:00",4426,1287,5713
"2019-02-05 10:10:21","2019-02-06 21:00:00","2019-02-06 21:30:00",4192,1201,5393
"2019-02-05 10:10:21","2019-02-06 22:00:00","2019-02-06 22:30:00",3857,1049,4906
"2019-02-06 10:10:25","2019-02-06 23:00:00","2019-02-06 23:30:00",3316,955,4271
"2019-02-06 10:10:25","2019-02-07 00:00:00","2019-02-07 00:30:00",3197,788,3985
"2019-02-06 10:10:25","2019-02-07 01:00:00","2019-02-07 01:30:00",3021,744,3765
"2019-02-06 10:10:25","2019-02-07 02:00:00","2019-02-07 02:30:00",2844,734,3578
"2019-02-06 10:10:25","2019-02-07 03:00:00","2019-02-07 03:30:00",2758,729,3487
"2019-02-06 10:10:25","2019-02-07 04:00:00","2019-02-07 04:30:00",2711,722,3433
"2019-02-06 10:10:25","2019-02-07 05:00:00","2019-02-07 05:30:00",2727,706,3433
"2019-02-06 10:10:25","2019-02-07 06:00:00","2019-02-07 06:30:00",2927,837,3764
"2019-02-06 10:10:25","2019-02-07 07:00:00","2019-02-07 07:30:00",3467,1055,4522
"2019-02-06 10:10:25","2019-02-07 08:00:00","2019-02-07 08:30:00",4018,1315,5333
"2019-02-06 10:10:25","2019-02-07 09:00:00","2019-02-07 09:30:00",4026,1328,5354
"2019-02-06 10:10:25","2019-02-07 10:00:00","2019-02-07 10:30:00",4170,1310,5480
"2019-02-06 10:10:25","2019-02-07 11:00:00","2019-02-07 11:30:00",4206,1310,5516
"2019-02-06 10:10:25","2019-02-07 12:00:00","2019-02-07 12:30:00",4200,1307,5507
"2019-02-06 10:10:25","2019-02-07 13:00:00","2019-02-07 13:30:00",4241,1304,5545
"2019-02-06 10:10:25","2019-02-07 14:00:00","2019-02-07 14:30:00",4170,1251,5421
"2019-02-06 10:10:25","2019-02-07 15:00:00","2019-02-07 15:30:00",4093,1272,5365
"2019-02-06 10:10:25","2019-02-07 16:00:00","2019-02-07 16:30:00",4183,1285,5468
"2019-02-06 10:10:25","2019-02-07 17:00:00","2019-02-07 17:30:00",4336,1440,5776
"2019-02-06 10:10:25","2019-02-07 18:00:00","2019-02-07 18:30:00",4650,1524,6174
"2019-02-06 10:10:25","2019-02-07 19:00:00","2019-02-07 19:30:00",4480,1392,5872
"2019-02-06 10:10:25","2019-02-07 20:00:00","2019-02-07 20:30:00",4232,1334,5566
"2019-02-06 10:10:25","2019-02-07 21:00:00","2019-02-07 21:30:00",3992,1242,5234
"2019-02-06 10:10:25","2019-02-07 22:00:00","2019-02-07 22:30:00",3620,1093,4713
"2019-02-07 10:10:26","2019-02-07 23:00:00","2019-02-07 23:30:00",3316,942,4258
"2019-02-07 10:10:26","2019-02-08 00:00:00","2019-02-08 00:30:00",3305,797,4102
"2019-02-07 10:10:26","2019-02-08 01:00:00","2019-02-08 01:30:00",3076,717,3793
"2019-02-07 10:10:26","2019-02-08 02:00:00","2019-02-08 02:30:00",2959,708,3667
"2019-02-07 10:10:26","2019-02-08 03:00:00","2019-02-08 03:30:00",2843,669,3512
"2019-02-07 10:10:26","2019-02-08 04:00:00","2019-02-08 04:30:00",2763,656,3419
"2019-02-07 10:10:26","2019-02-08 05:00:00","2019-02-08 05:30:00",2792,647,3439
"2019-02-07 10:10:26","2019-02-08 06:00:00","2019-02-08 06:30:00",2961,725,3686
"2019-02-07 10:10:26","2019-02-08 07:00:00","2019-02-08 07:30:00",3430,905,4335
"2019-02-07 10:10:26","2019-02-08 08:00:00","2019-02-08 08:30:00",4009,1103,5112
"2019-02-07 10:10:26","2019-02-08 09:00:00","2019-02-08 09:30:00",4081,1101,5182
"2019-02-07 10:10:26","2019-02-08 10:00:00","2019-02-08 10:30:00",4226,1129,5355
"2019-02-07 10:10:26","2019-02-08 11:00:00","2019-02-08 11:30:00",4185,1146,5331
"2019-02-07 10:10:26","2019-02-08 12:00:00","2019-02-08 12:30:00",4220,1138,5358
"2019-02-07 10:10:26","2019-02-08 13:00:00","2019-02-08 13:30:00",4120,1152,5272
"2019-02-07 10:10:26","2019-02-08 14:00:00","2019-02-08 14:30:00",3972,1117,5089
"2019-02-07 10:10:26","2019-02-08 15:00:00","2019-02-08 15:30:00",3940,1096,5036
"2019-02-07 10:10:26","2019-02-08 16:00:00","2019-02-08 16:30:00",4005,1127,5132
"2019-02-07 10:10:26","2019-02-08 17:00:00","2019-02-08 17:30:00",4216,1236,5452
"2019-02-07 10:10:26","2019-02-08 18:00:00","2019-02-08 18:30:00",4646,1325,5971
"2019-02-07 10:10:26","2019-02-08 19:00:00","2019-02-08 19:30:00",4544,1275,5819
"2019-02-07 10:10:26","2019-02-08 20:00:00","2019-02-08 20:30:00",4303,1196,5499
"2019-02-07 10:10:26","2019-02-08 21:00:00","2019-02-08 21:30:00",4079,1109,5188
"2019-02-07 10:10:26","2019-02-08 22:00:00","2019-02-08 22:30:00",3761,979,4740
"2019-02-08 10:10:35","2019-02-08 23:00:00","2019-02-08 23:30:00",3428,911,4339
"2019-02-08 10:10:35","2019-02-09 00:00:00","2019-02-09 00:30:00",3431,743,4174
"2019-02-08 10:10:35","2019-02-09 01:00:00","2019-02-09 01:30:00",3181,674,3855
"2019-02-08 10:10:35","2019-02-09 02:00:00","2019-02-09 02:30:00",2984,659,3643
"2019-02-08 10:10:35","2019-02-09 03:00:00","2019-02-09 03:30:00",2842,618,3460
"2019-02-08 10:10:35","2019-02-09 04:00:00","2019-02-09 04:30:00",2781,625,3406
"2019-02-08 10:10:35","2019-02-09 05:00:00","2019-02-09 05:30:00",2706,587,3293
"2019-02-08 10:10:35","2019-02-09 06:00:00","2019-02-09 06:30:00",2764,619,3383
"2019-02-08 10:10:35","2019-02-09 07:00:00","2019-02-09 07:30:00",2973,709,3682
"2019-02-08 10:10:35","2019-02-09 08:00:00","2019-02-09 08:30:00",3172,822,3994
"2019-02-08 10:10:35","2019-02-09 09:00:00","2019-02-09 09:30:00",3426,935,4361
"2019-02-08 10:10:35","2019-02-09 10:00:00","2019-02-09 10:30:00",3664,1040,4704
"2019-02-08 10:10:35","2019-02-09 11:00:00","2019-02-09 11:30:00",3756,1071,4827
"2019-02-08 10:10:35","2019-02-09 12:00:00","2019-02-09 12:30:00",3754,1064,4818
"2019-02-08 10:10:35","2019-02-09 13:00:00","2019-02-09 13:30:00",3783,1044,4827
"2019-02-08 10:10:35","2019-02-09 14:00:00","2019-02-09 14:30:00",3656,1012,4668
"2019-02-08 10:10:35","2019-02-09 15:00:00","2019-02-09 15:30:00",3627,1013,4640
"2019-02-08 10:10:35","2019-02-09 16:00:00","2019-02-09 16:30:00",3670,1053,4723
"2019-02-08 10:10:35","2019-02-09 17:00:00","2019-02-09 17:30:00",3892,1148,5040
"2019-02-08 10:10:35","2019-02-09 18:00:00","2019-02-09 18:30:00",4250,1274,5524
"2019-02-08 10:10:35","2019-02-09 19:00:00","2019-02-09 19:30:00",4182,1231,5413
"2019-02-08 10:10:35","2019-02-09 20:00:00","2019-02-09 20:30:00",3971,1121,5092
"2019-02-08 10:10:35","2019-02-09 21:00:00","2019-02-09 21:30:00",3713,1035,4748
"2019-02-08 10:10:35","2019-02-09 22:00:00","2019-02-09 22:30:00",3495,946,4441
"2019-02-09 10:10:15","2019-02-09 23:00:00","2019-02-09 23:30:00",3309,915,4224
"2019-02-09 10:10:15","2019-02-10 00:00:00","2019-02-10 00:30:00",3313,750,4063
"2019-02-09 10:10:15","2019-02-10 01:00:00","2019-02-10 01:30:00",3084,691,3775
"2019-02-09 10:10:15","2019-02-10 02:00:00","2019-02-10 02:30:00",2915,695,3610
"2019-02-09 10:10:15","2019-02-10 03:00:00","2019-02-10 03:30:00",2759,652,3411
"2019-02-09 10:10:15","2019-02-10 04:00:00","2019-02-10 04:30:00",2729,642,3371
"2019-02-09 10:10:15","2019-02-10 05:00:00","2019-02-10 05:30:00",2703,612,3315
"2019-02-09 10:10:15","2019-02-10 06:00:00","2019-02-10 06:30:00",2709,647,3356
"2019-02-09 10:10:15","2019-02-10 07:00:00","2019-02-10 07:30:00",2775,710,3485
"2019-02-09 10:10:15","2019-02-10 08:00:00","2019-02-10 08:30:00",2919,805,3724
"2019-02-09 10:10:15","2019-02-10 09:00:00","2019-02-10 09:30:00",3134,936,4070
"2019-02-09 10:10:15","2019-02-10 10:00:00","2019-02-10 10:30:00",3427,984,4411
"2019-02-09 10:10:15","2019-02-10 11:00:00","2019-02-10 11:30:00",3648,1052,4700
"2019-02-09 10:10:15","2019-02-10 12:00:00","2019-02-10 12:30:00",3724,1125,4849
"2019-02-09 10:10:15","2019-02-10 13:00:00","2019-02-10 13:30:00",3827,1196,5023
"2019-02-09 10:10:15","2019-02-10 14:00:00","2019-02-10 14:30:00",3702,1133,4835
"2019-02-09 10:10:15","2019-02-10 15:00:00","2019-02-10 15:30:00",3672,1106,4778
"2019-02-09 10:10:15","2019-02-10 16:00:00","2019-02-10 16:30:00",3605,1145,4750
"2019-02-09 10:10:15","2019-02-10 17:00:00","2019-02-10 17:30:00",3744,1285,5029
"2019-02-09 10:10:15","2019-02-10 18:00:00","2019-02-10 18:30:00",4166,1298,5464
"2019-02-09 10:10:15","2019-02-10 19:00:00","2019-02-10 19:30:00",4138,1217,5355
"2019-02-09 10:10:15","2019-02-10 20:00:00","2019-02-10 20:30:00",3949,1150,5099
"2019-02-09 10:10:15","2019-02-10 21:00:00","2019-02-10 21:30:00",3754,1077,4831
"2019-02-09 10:10:15","2019-02-10 22:00:00","2019-02-10 22:30:00",3481,956,4437
"2019-02-10 10:10:36","2019-02-10 23:00:00","2019-02-10 23:30:00",3252,869,4121
"2019-02-10 10:10:36","2019-02-11 00:00:00","2019-02-11 00:30:00",3133,745,3878
"2019-02-10 10:10:36","2019-02-11 01:00:00","2019-02-11 01:30:00",2905,690,3595
"2019-02-10 10:10:36","2019-02-11 02:00:00","2019-02-11 02:30:00",2734,701,3435
"2019-02-10 10:10:36","2019-02-11 03:00:00","2019-02-11 03:30:00",2667,672,3339
"2019-02-10 10:10:36","2019-02-11 04:00:00","2019-02-11 04:30:00",2663,655,3318
"2019-02-10 10:10:36","2019-02-11 05:00:00","2019-02-11 05:30:00",2656,663,3319
"2019-02-10 10:10:36","2019-02-11 06:00:00","2019-02-11 06:30:00",2892,752,3644
"2019-02-10 10:10:36","2019-02-11 07:00:00","2019-02-11 07:30:00",3381,983,4364
"2019-02-10 10:10:36","2019-02-11 08:00:00","2019-02-11 08:30:00",3900,1214,5114
"2019-02-10 10:10:36","2019-02-11 09:00:00","2019-02-11 09:30:00",3941,1275,5216
"2019-02-10 10:10:36","2019-02-11 10:00:00","2019-02-11 10:30:00",4017,1299,5316
"2019-02-10 10:10:36","2019-02-11 11:00:00","2019-02-11 11:30:00",4065,1277,5342
"2019-02-10 10:10:36","2019-02-11 12:00:00","2019-02-11 12:30:00",4091,1266,5357
"2019-02-10 10:10:36","2019-02-11 13:00:00","2019-02-11 13:30:00",4093,1260,5353
"2019-02-10 10:10:36","2019-02-11 14:00:00","2019-02-11 14:30:00",3988,1199,5187
"2019-02-10 10:10:36","2019-02-11 15:00:00","2019-02-11 15:30:00",3986,1175,5161
"2019-02-10 10:10:36","2019-02-11 16:00:00","2019-02-11 16:30:00",4054,1278,5332
"2019-02-10 10:10:36","2019-02-11 17:00:00","2019-02-11 17:30:00",4264,1403,5667
"2019-02-10 10:10:36","2019-02-11 18:00:00","2019-02-11 18:30:00",4720,1500,6220
"2019-02-10 10:10:36","2019-02-11 19:00:00","2019-02-11 19:30:00",4584,1386,5970
"2019-02-10 10:10:36","2019-02-11 20:00:00","2019-02-11 20:30:00",4364,1271,5635
"2019-02-10 10:10:36","2019-02-11 21:00:00","2019-02-11 21:30:00",4100,1174,5274
"2019-02-10 10:10:36","2019-02-11 22:00:00","2019-02-11 22:30:00",3729,1037,4766
"2019-02-11 10:10:20","2019-02-11 23:00:00","2019-02-11 23:30:00",3358,919,4277
"2019-02-11 10:10:20","2019-02-12 00:00:00","2019-02-12 00:30:00",3359,741,4100
"2019-02-11 10:10:20","2019-02-12 01:00:00","2019-02-12 01:30:00",3103,681,3784
"2019-02-11 10:10:20","2019-02-12 02:00:00","2019-02-12 02:30:00",2908,690,3598
"2019-02-11 10:10:20","2019-02-12 03:00:00","2019-02-12 03:30:00",2808,661,3469
"2019-02-11 10:10:20","2019-02-12 04:00:00","2019-02-12 04:30:00",2884,641,3525
"2019-02-11 10:10:20","2019-02-12 05:00:00","2019-02-12 05:30:00",2860,644,3504
"2019-02-11 10:10:20","2019-02-12 06:00:00","2019-02-12 06:30:00",2993,725,3718
"2019-02-11 10:10:20","2019-02-12 07:00:00","2019-02-12 07:30:00",3421,918,4339
"2019-02-11 10:10:20","2019-02-12 08:00:00","2019-02-12 08:30:00",3891,1131,5022
"2019-02-11 10:10:20","2019-02-12 09:00:00","2019-02-12 09:30:00",4015,1155,5170
"2019-02-11 10:10:20","2019-02-12 10:00:00","2019-02-12 10:30:00",4149,1178,5327
"2019-02-11 10:10:20","2019-02-12 11:00:00","2019-02-12 11:30:00",4154,1168,5322
"2019-02-11 10:10:20","2019-02-12 12:00:00","2019-02-12 12:30:00",4125,1163,5288
"2019-02-11 10:10:20","2019-02-12 13:00:00","2019-02-12 13:30:00",4127,1149,5276
"2019-02-11 10:10:20","2019-02-12 14:00:00","2019-02-12 14:30:00",4013,1104,5117
"2019-02-11 10:10:20","2019-02-12 15:00:00","2019-02-12 15:30:00",4027,1095,5122
"2019-02-11 10:10:20","2019-02-12 16:00:00","2019-02-12 16:30:00",4065,1156,5221
"2019-02-11 10:10:20","2019-02-12 17:00:00","2019-02-12 17:30:00",4221,1308,5529
"2019-02-11 10:10:20","2019-02-12 18:00:00","2019-02-12 18:30:00",4614,1376,5990
"2019-02-11 10:10:20","2019-02-12 19:00:00","2019-02-12 19:30:00",4599,1302,5901
"2019-02-11 10:10:20","2019-02-12 20:00:00","2019-02-12 20:30:00",4370,1210,5580
"2019-02-11 10:10:20","2019-02-12 21:00:00","2019-02-12 21:30:00",4109,1125,5234
"2019-02-11 10:10:20","2019-02-12 22:00:00","2019-02-12 22:30:00",3823,977,4800
"2019-02-12 10:10:36","2019-02-12 23:00:00","2019-02-12 23:30:00",3507,849,4356
"2019-02-12 10:10:36","2019-02-13 00:00:00","2019-02-13 00:30:00",3235,729,3964
"2019-02-12 10:10:36","2019-02-13 01:00:00","2019-02-13 01:30:00",3049,662,3711
"2019-02-12 10:10:36","2019-02-13 02:00:00","2019-02-13 02:30:00",2846,666,3512
"2019-02-12 10:10:36","2019-02-13 03:00:00","2019-02-13 03:30:00",2786,641,3427
"2019-02-12 10:10:36","2019-02-13 04:00:00","2019-02-13 04:30:00",2757,633,3390
"2019-02-12 10:10:36","2019-02-13 05:00:00","2019-02-13 05:30:00",2740,633,3373
"2019-02-12 10:10:36","2019-02-13 06:00:00","2019-02-13 06:30:00",2924,711,3635
"2019-02-12 10:10:36","2019-02-13 07:00:00","2019-02-13 07:30:00",3442,902,4344
"2019-02-12 10:10:36","2019-02-13 08:00:00","2019-02-13 08:30:00",4018,1122,5140
"2019-02-12 10:10:36","2019-02-13 09:00:00","2019-02-13 09:30:00",4011,1162,5173
"2019-02-12 10:10:36","2019-02-13 10:00:00","2019-02-13 10:30:00",4056,1177,5233
"2019-02-12 10:10:36","2019-02-13 11:00:00","2019-02-13 11:30:00",4054,1173,5227
"2019-02-12 10:10:36","2019-02-13 12:00:00","2019-02-13 12:30:00",4068,1162,5230
"2019-02-12 10:10:36","2019-02-13 13:00:00","2019-02-13 13:30:00",4076,1151,5227
"2019-02-12 10:10:36","2019-02-13 14:00:00","2019-02-13 14:30:00",4028,1120,5148
"2019-02-12 10:10:36","2019-02-13 15:00:00","2019-02-13 15:30:00",4050,1120,5170
"2019-02-12 10:10:36","2019-02-13 16:00:00","2019-02-13 16:30:00",4133,1182,5315
"2019-02-12 10:10:36","2019-02-13 17:00:00","2019-02-13 17:30:00",4350,1337,5687
"2019-02-12 10:10:36","2019-02-13 18:00:00","2019-02-13 18:30:00",4695,1401,6096
"2019-02-12 10:10:36","2019-02-13 19:00:00","2019-02-13 19:30:00",4593,1318,5911
"2019-02-12 10:10:36","2019-02-13 20:00:00","2019-02-13 20:30:00",4442,1232,5674
"2019-02-12 10:10:36","2019-02-13 21:00:00","2019-02-13 21:30:00",4215,1140,5355
"2019-02-12 10:10:36","2019-02-13 22:00:00","2019-02-13 22:30:00",3776,993,4769
"2019-02-13 10:10:21","2019-02-13 23:00:00","2019-02-13 23:30:00",3315,861,4176
"2019-02-13 10:10:21","2019-02-14 00:00:00","2019-02-14 00:30:00",3263,726,3989
"2019-02-13 10:10:21","2019-02-14 01:00:00","2019-02-14 01:30:00",3008,663,3671
"2019-02-13 10:10:21","2019-02-14 02:00:00","2019-02-14 02:30:00",2931,654,3585
"2019-02-13 10:10:21","2019-02-14 03:00:00","2019-02-14 03:30:00",2840,640,3480
"2019-02-13 10:10:21","2019-02-14 04:00:00","2019-02-14 04:30:00",2806,632,3438
"2019-02-13 10:10:21","2019-02-14 05:00:00","2019-02-14 05:30:00",2770,639,3409
"2019-02-13 10:10:21","2019-02-14 06:00:00","2019-02-14 06:30:00",2982,718,3700
"2019-02-13 10:10:21","2019-02-14 07:00:00","2019-02-14 07:30:00",3516,930,4446
"2019-02-13 10:10:21","2019-02-14 08:00:00","2019-02-14 08:30:00",3958,1156,5114
"2019-02-13 10:10:21","2019-02-14 09:00:00","2019-02-14 09:30:00",4011,1185,5196
"2019-02-13 10:10:21","2019-02-14 10:00:00","2019-02-14 10:30:00",4079,1227,5306
"2019-02-13 10:10:21","2019-02-14 11:00:00","2019-02-14 11:30:00",4089,1206,5295
"2019-02-13 10:10:21","2019-02-14 12:00:00","2019-02-14 12:30:00",4069,1200,5269
"2019-02-13 10:10:21","2019-02-14 13:00:00","2019-02-14 13:30:00",4097,1181,5278
"2019-02-13 10:10:21","2019-02-14 14:00:00","2019-02-14 14:30:00",4017,1142,5159
"2019-02-13 10:10:21","2019-02-14 15:00:00","2019-02-14 15:30:00",4021,1134,5155
"2019-02-13 10:10:21","2019-02-14 16:00:00","2019-02-14 16:30:00",4101,1195,5296
"2019-02-13 10:10:21","2019-02-14 17:00:00","2019-02-14 17:30:00",4292,1337,5629
"2019-02-13 10:10:21","2019-02-14 18:00:00","2019-02-14 18:30:00",4695,1439,6134
"2019-02-13 10:10:21","2019-02-14 19:00:00","2019-02-14 19:30:00",4562,1357,5919
"2019-02-13 10:10:21","2019-02-14 20:00:00","2019-02-14 20:30:00",4311,1269,5580
"2019-02-13 10:10:21","2019-02-14 21:00:00","2019-02-14 21:30:00",4069,1188,5257
"2019-02-13 10:10:21","2019-02-14 22:00:00","2019-02-14 22:30:00",3660,1044,4704
"2019-02-14 10:10:35","2019-02-14 23:00:00","2019-02-14 23:30:00",3316,870,4186
"2019-02-14 10:10:35","2019-02-15 00:00:00","2019-02-15 00:30:00",3132,756,3888
"2019-02-14 10:10:35","2019-02-15 01:00:00","2019-02-15 01:30:00",2998,685,3683
"2019-02-14 10:10:35","2019-02-15 02:00:00","2019-02-15 02:30:00",2843,679,3522
"2019-02-14 10:10:35","2019-02-15 03:00:00","2019-02-15 03:30:00",2756,651,3407
"2019-02-14 10:10:35","2019-02-15 04:00:00","2019-02-15 04:30:00",2739,638,3377
"2019-02-14 10:10:35","2019-02-15 05:00:00","2019-02-15 05:30:00",2743,649,3392
"2019-02-14 10:10:35","2019-02-15 06:00:00","2019-02-15 06:30:00",2910,755,3665
"2019-02-14 10:10:35","2019-02-15 07:00:00","2019-02-15 07:30:00",3500,980,4480
"2019-02-14 10:10:35","2019-02-15 08:00:00","2019-02-15 08:30:00",3990,1197,5187
"2019-02-14 10:10:35","2019-02-15 09:00:00","2019-02-15 09:30:00",3980,1231,5211
"2019-02-14 10:10:35","2019-02-15 10:00:00","2019-02-15 10:30:00",4030,1227,5257
"2019-02-14 10:10:35","2019-02-15 11:00:00","2019-02-15 11:30:00",4020,1205,5225
"2019-02-14 10:10:35","2019-02-15 12:00:00","2019-02-15 12:30:00",4030,1192,5222
"2019-02-14 10:10:35","2019-02-15 13:00:00","2019-02-15 13:30:00",3980,1148,5128
"2019-02-14 10:10:35","2019-02-15 14:00:00","2019-02-15 14:30:00",3865,1118,4983
"2019-02-14 10:10:35","2019-02-15 15:00:00","2019-02-15 15:30:00",3886,1091,4977
"2019-02-14 10:10:35","2019-02-15 16:00:00","2019-02-15 16:30:00",3941,1086,5027
"2019-02-14 10:10:35","2019-02-15 17:00:00","2019-02-15 17:30:00",4137,1178,5315
"2019-02-14 10:10:35","2019-02-15 18:00:00","2019-02-15 18:30:00",4396,1271,5667
"2019-02-14 10:10:35","2019-02-15 19:00:00","2019-02-15 19:30:00",4377,1216,5593
"2019-02-14 10:10:35","2019-02-15 20:00:00","2019-02-15 20:30:00",4194,1125,5319
"2019-02-14 10:10:35","2019-02-15 21:00:00","2019-02-15 21:30:00",3977,1030,5007
"2019-02-14 10:10:35","2019-02-15 22:00:00","2019-02-15 22:30:00",3613,931,4544
"2019-02-15 10:10:56","2019-02-15 23:00:00","2019-02-15 23:30:00",3299,792,4091
"2019-02-15 10:10:56","2019-02-16 00:00:00","2019-02-16 00:30:00",3422,703,4125
"2019-02-15 10:10:56","2019-02-16 01:00:00","2019-02-16 01:30:00",3175,649,3824
"2019-02-15 10:10:56","2019-02-16 02:00:00","2019-02-16 02:30:00",2974,649,3623
"2019-02-15 10:10:56","2019-02-16 03:00:00","2019-02-16 03:30:00",2828,625,3453
"2019-02-15 10:10:56","2019-02-16 04:00:00","2019-02-16 04:30:00",2765,613,3378
"2019-02-15 10:10:56","2019-02-16 05:00:00","2019-02-16 05:30:00",2750,593,3343
"2019-02-15 10:10:56","2019-02-16 06:00:00","2019-02-16 06:30:00",2811,621,3432
"2019-02-15 10:10:56","2019-02-16 07:00:00","2019-02-16 07:30:00",2965,723,3688
"2019-02-15 10:10:56","2019-02-16 08:00:00","2019-02-16 08:30:00",3228,834,4062
"2019-02-15 10:10:56","2019-02-16 09:00:00","2019-02-16 09:30:00",3552,971,4523
"2019-02-15 10:10:56","2019-02-16 10:00:00","2019-02-16 10:30:00",3773,1004,4777
"2019-02-15 10:10:56","2019-02-16 11:00:00","2019-02-16 11:30:00",3829,1029,4858
"2019-02-15 10:10:56","2019-02-16 12:00:00","2019-02-16 12:30:00",3825,1006,4831
"2019-02-15 10:10:56","2019-02-16 13:00:00","2019-02-16 13:30:00",3771,972,4743
"2019-02-15 10:10:56","2019-02-16 14:00:00","2019-02-16 14:30:00",3682,952,4634
"2019-02-15 10:10:56","2019-02-16 15:00:00","2019-02-16 15:30:00",3528,967,4495
"2019-02-15 10:10:56","2019-02-16 16:00:00","2019-02-16 16:30:00",3539,974,4513
"2019-02-15 10:10:56","2019-02-16 17:00:00","2019-02-16 17:30:00",3763,1115,4878
"2019-02-15 10:10:56","2019-02-16 18:00:00","2019-02-16 18:30:00",4178,1202,5380
"2019-02-15 10:10:56","2019-02-16 19:00:00","2019-02-16 19:30:00",4129,1152,5281
"2019-02-15 10:10:56","2019-02-16 20:00:00","2019-02-16 20:30:00",3863,1031,4894
"2019-02-15 10:10:56","2019-02-16 21:00:00","2019-02-16 21:30:00",3654,948,4602
"2019-02-15 10:10:56","2019-02-16 22:00:00","2019-02-16 22:30:00",3428,894,4322
"2019-02-16 10:10:40","2019-02-16 23:00:00","2019-02-16 23:30:00",3268,830,4098
"2019-02-16 10:10:40","2019-02-17 00:00:00","2019-02-17 00:30:00",3277,736,4013
"2019-02-16 10:10:40","2019-02-17 01:00:00","2019-02-17 01:30:00",3077,681,3758
"2019-02-16 10:10:40","2019-02-17 02:00:00","2019-02-17 02:30:00",2919,650,3569
"2019-02-16 10:10:40","2019-02-17 03:00:00","2019-02-17 03:30:00",2822,621,3443
"2019-02-16 10:10:40","2019-02-17 04:00:00","2019-02-17 04:30:00",2751,610,3361
"2019-02-16 10:10:40","2019-02-17 05:00:00","2019-02-17 05:30:00",2729,599,3328
"2019-02-16 10:10:40","2019-02-17 06:00:00","2019-02-17 06:30:00",2740,615,3355
"2019-02-16 10:10:40","2019-02-17 07:00:00","2019-02-17 07:30:00",2819,664,3483
"2019-02-16 10:10:40","2019-02-17 08:00:00","2019-02-17 08:30:00",2895,709,3604
"2019-02-16 10:10:40","2019-02-17 09:00:00","2019-02-17 09:30:00",3080,812,3892
"2019-02-16 10:10:40","2019-02-17 10:00:00","2019-02-17 10:30:00",3347,921,4268
"2019-02-16 10:10:40","2019-02-17 11:00:00","2019-02-17 11:30:00",3502,975,4477
"2019-02-16 10:10:40","2019-02-17 12:00:00","2019-02-17 12:30:00",3613,1028,4641
"2019-02-16 10:10:40","2019-02-17 13:00:00","2019-02-17 13:30:00",3706,1107,4813
"2019-02-16 10:10:40","2019-02-17 14:00:00","2019-02-17 14:30:00",3644,1047,4691
"2019-02-16 10:10:40","2019-02-17 15:00:00","2019-02-17 15:30:00",3549,1002,4551
"2019-02-16 10:10:40","2019-02-17 16:00:00","2019-02-17 16:30:00",3573,1010,4583
"2019-02-16 10:10:40","2019-02-17 17:00:00","2019-02-17 17:30:00",3724,1150,4874
"2019-02-16 10:10:40","2019-02-17 18:00:00","2019-02-17 18:30:00",4044,1240,5284
"2019-02-16 10:10:40","2019-02-17 19:00:00","2019-02-17 19:30:00",4049,1200,5249
"2019-02-16 10:10:40","2019-02-17 20:00:00","2019-02-17 20:30:00",3880,1109,4989
"2019-02-16 10:10:40","2019-02-17 21:00:00","2019-02-17 21:30:00",3688,1023,4711
"2019-02-16 10:10:40","2019-02-17 22:00:00","2019-02-17 22:30:00",3415,924,4339
"2019-02-17 10:10:21","2019-02-17 23:00:00","2019-02-17 23:30:00",3136,786,3922
"2019-02-17 10:10:21","2019-02-18 00:00:00","2019-02-18 00:30:00",3085,688,3773
"2019-02-17 10:10:21","2019-02-18 01:00:00","2019-02-18 01:30:00",2816,656,3472
"2019-02-17 10:10:21","2019-02-18 02:00:00","2019-02-18 02:30:00",2708,643,3351
"2019-02-17 10:10:21","2019-02-18 03:00:00","2019-02-18 03:30:00",2573,631,3204
"2019-02-17 10:10:21","2019-02-18 04:00:00","2019-02-18 04:30:00",2566,622,3188
"2019-02-17 10:10:21","2019-02-18 05:00:00","2019-02-18 05:30:00",2550,653,3203
"2019-02-17 10:10:21","2019-02-18 06:00:00","2019-02-18 06:30:00",2748,737,3485
"2019-02-17 10:10:21","2019-02-18 07:00:00","2019-02-18 07:30:00",3205,954,4159
"2019-02-17 10:10:21","2019-02-18 08:00:00","2019-02-18 08:30:00",3571,1160,4731
"2019-02-17 10:10:21","2019-02-18 09:00:00","2019-02-18 09:30:00",3938,1211,5149
"2019-02-17 10:10:21","2019-02-18 10:00:00","2019-02-18 10:30:00",4136,1229,5365
"2019-02-17 10:10:21","2019-02-18 11:00:00","2019-02-18 11:30:00",4144,1199,5343
"2019-02-17 10:10:21","2019-02-18 12:00:00","2019-02-18 12:30:00",4108,1188,5296
"2019-02-17 10:10:21","2019-02-18 13:00:00","2019-02-18 13:30:00",4151,1202,5353
"2019-02-17 10:10:21","2019-02-18 14:00:00","2019-02-18 14:30:00",4024,1170,5194
"2019-02-17 10:10:21","2019-02-18 15:00:00","2019-02-18 15:30:00",3961,1180,5141
"2019-02-17 10:10:21","2019-02-18 16:00:00","2019-02-18 16:30:00",4005,1189,5194
"2019-02-17 10:10:21","2019-02-18 17:00:00","2019-02-18 17:30:00",4157,1330,5487
"2019-02-17 10:10:21","2019-02-18 18:00:00","2019-02-18 18:30:00",4543,1466,6009
"2019-02-17 10:10:21","2019-02-18 19:00:00","2019-02-18 19:30:00",4567,1377,5944
"2019-02-17 10:10:21","2019-02-18 20:00:00","2019-02-18 20:30:00",4338,1274,5612
"2019-02-17 10:10:21","2019-02-18 21:00:00","2019-02-18 21:30:00",3989,1184,5173
"2019-02-17 10:10:21","2019-02-18 22:00:00","2019-02-18 22:30:00",3642,1038,4680
"2019-02-18 10:10:36","2019-02-18 23:00:00","2019-02-18 23:30:00",3264,904,4168
"2019-02-18 10:10:36","2019-02-19 00:00:00","2019-02-19 00:30:00",3263,729,3992
"2019-02-18 10:10:36","2019-02-19 01:00:00","2019-02-19 01:30:00",3001,673,3674
"2019-02-18 10:10:36","2019-02-19 02:00:00","2019-02-19 02:30:00",2802,682,3484
"2019-02-18 10:10:36","2019-02-19 03:00:00","2019-02-19 03:30:00",2700,646,3346
"2019-02-18 10:10:36","2019-02-19 04:00:00","2019-02-19 04:30:00",2777,640,3417
"2019-02-18 10:10:36","2019-02-19 05:00:00","2019-02-19 05:30:00",2753,663,3416
"2019-02-18 10:10:36","2019-02-19 06:00:00","2019-02-19 06:30:00",2888,742,3630
"2019-02-18 10:10:36","2019-02-19 07:00:00","2019-02-19 07:30:00",3326,962,4288
"2019-02-18 10:10:36","2019-02-19 08:00:00","2019-02-19 08:30:00",3807,1179,4986
"2019-02-18 10:10:36","2019-02-19 09:00:00","2019-02-19 09:30:00",3933,1197,5130
"2019-02-18 10:10:36","2019-02-19 10:00:00","2019-02-19 10:30:00",4070,1228,5298
"2019-02-18 10:10:36","2019-02-19 11:00:00","2019-02-19 11:30:00",4075,1221,5296
"2019-02-18 10:10:36","2019-02-19 12:00:00","2019-02-19 12:30:00",4045,1200,5245
"2019-02-18 10:10:36","2019-02-19 13:00:00","2019-02-19 13:30:00",4047,1199,5246
"2019-02-18 10:10:36","2019-02-19 14:00:00","2019-02-19 14:30:00",3931,1177,5108
"2019-02-18 10:10:36","2019-02-19 15:00:00","2019-02-19 15:30:00",3946,1178,5124
"2019-02-18 10:10:36","2019-02-19 16:00:00","2019-02-19 16:30:00",3985,1207,5192
"2019-02-18 10:10:36","2019-02-19 17:00:00","2019-02-19 17:30:00",4143,1309,5452
"2019-02-18 10:10:36","2019-02-19 18:00:00","2019-02-19 18:30:00",4545,1420,5965
"2019-02-18 10:10:36","2019-02-19 19:00:00","2019-02-19 19:30:00",4529,1330,5859
"2019-02-18 10:10:36","2019-02-19 20:00:00","2019-02-19 20:30:00",4296,1241,5537
"2019-02-18 10:10:36","2019-02-19 21:00:00","2019-02-19 21:30:00",4029,1146,5175
"2019-02-18 10:10:36","2019-02-19 22:00:00","2019-02-19 22:30:00",3737,980,4717
"2019-02-19 10:10:25","2019-02-19 23:00:00","2019-02-19 23:30:00",3407,943,4350
"2019-02-19 10:10:25","2019-02-20 00:00:00","2019-02-20 00:30:00",3211,691,3902
"2019-02-19 10:10:25","2019-02-20 01:00:00","2019-02-20 01:30:00",2995,631,3626
"2019-02-19 10:10:25","2019-02-20 02:00:00","2019-02-20 02:30:00",2865,633,3498
"2019-02-19 10:10:25","2019-02-20 03:00:00","2019-02-20 03:30:00",2756,600,3356
"2019-02-19 10:10:25","2019-02-20 04:00:00","2019-02-20 04:30:00",2723,592,3315
"2019-02-19 10:10:25","2019-02-20 05:00:00","2019-02-20 05:30:00",2701,615,3316
"2019-02-19 10:10:25","2019-02-20 06:00:00","2019-02-20 06:30:00",2870,800,3670
"2019-02-19 10:10:25","2019-02-20 07:00:00","2019-02-20 07:30:00",3381,1020,4401
"2019-02-19 10:10:25","2019-02-20 08:00:00","2019-02-20 08:30:00",3838,1210,5048
"2019-02-19 10:10:25","2019-02-20 09:00:00","2019-02-20 09:30:00",3837,1218,5055
"2019-02-19 10:10:25","2019-02-20 10:00:00","2019-02-20 10:30:00",3930,1215,5145
"2019-02-19 10:10:25","2019-02-20 11:00:00","2019-02-20 11:30:00",3967,1190,5157
"2019-02-19 10:10:25","2019-02-20 12:00:00","2019-02-20 12:30:00",3958,1140,5098
"2019-02-19 10:10:25","2019-02-20 13:00:00","2019-02-20 13:30:00",3962,1110,5072
"2019-02-19 10:10:25","2019-02-20 14:00:00","2019-02-20 14:30:00",3918,1088,5006
"2019-02-19 10:10:25","2019-02-20 15:00:00","2019-02-20 15:30:00",3939,1121,5060
"2019-02-19 10:10:25","2019-02-20 16:00:00","2019-02-20 16:30:00",3981,1179,5160
"2019-02-19 10:10:25","2019-02-20 17:00:00","2019-02-20 17:30:00",4121,1315,5436
"2019-02-19 10:10:25","2019-02-20 18:00:00","2019-02-20 18:30:00",4463,1405,5868
"2019-02-19 10:10:25","2019-02-20 19:00:00","2019-02-20 19:30:00",4426,1340,5766
"2019-02-19 10:10:25","2019-02-20 20:00:00","2019-02-20 20:30:00",4188,1250,5438
"2019-02-19 10:10:25","2019-02-20 21:00:00","2019-02-20 21:30:00",3979,1140,5119
"2019-02-19 10:10:25","2019-02-20 22:00:00","2019-02-20 22:30:00",3616,1000,4616
"2019-02-20 10:10:11","2019-02-20 23:00:00","2019-02-20 23:30:00",3417,849,4266
"2019-02-20 10:10:11","2019-02-21 00:00:00","2019-02-21 00:30:00",3027,671,3698
"2019-02-20 10:10:11","2019-02-21 01:00:00","2019-02-21 01:30:00",2806,622,3428
"2019-02-20 10:10:11","2019-02-21 02:00:00","2019-02-21 02:30:00",2677,617,3294
"2019-02-20 10:10:11","2019-02-21 03:00:00","2019-02-21 03:30:00",2597,590,3187
"2019-02-20 10:10:11","2019-02-21 04:00:00","2019-02-21 04:30:00",2586,586,3172
"2019-02-20 10:10:11","2019-02-21 05:00:00","2019-02-21 05:30:00",2609,598,3207
"2019-02-20 10:10:11","2019-02-21 06:00:00","2019-02-21 06:30:00",2785,669,3454
"2019-02-20 10:10:11","2019-02-21 07:00:00","2019-02-21 07:30:00",3249,833,4082
"2019-02-20 10:10:11","2019-02-21 08:00:00","2019-02-21 08:30:00",3669,998,4667
"2019-02-20 10:10:11","2019-02-21 09:00:00","2019-02-21 09:30:00",3817,1063,4880
"2019-02-20 10:10:11","2019-02-21 10:00:00","2019-02-21 10:30:00",3918,1078,4996
"2019-02-20 10:10:11","2019-02-21 11:00:00","2019-02-21 11:30:00",3969,1044,5013
"2019-02-20 10:10:11","2019-02-21 12:00:00","2019-02-21 12:30:00",4022,1069,5091
"2019-02-20 10:10:11","2019-02-21 13:00:00","2019-02-21 13:30:00",4044,1070,5114
"2019-02-20 10:10:11","2019-02-21 14:00:00","2019-02-21 14:30:00",3992,1055,5047
"2019-02-20 10:10:11","2019-02-21 15:00:00","2019-02-21 15:30:00",4013,1068,5081
"2019-02-20 10:10:11","2019-02-21 16:00:00","2019-02-21 16:30:00",4095,1113,5208
"2019-02-20 10:10:11","2019-02-21 17:00:00","2019-02-21 17:30:00",4255,1218,5473
"2019-02-20 10:10:11","2019-02-21 18:00:00","2019-02-21 18:30:00",4585,1322,5907
"2019-02-20 10:10:11","2019-02-21 19:00:00","2019-02-21 19:30:00",4523,1261,5784
"2019-02-20 10:10:11","2019-02-21 20:00:00","2019-02-21 20:30:00",4280,1196,5476
"2019-02-20 10:10:11","2019-02-21 21:00:00","2019-02-21 21:30:00",4068,1105,5173
"2019-02-20 10:10:11","2019-02-21 22:00:00","2019-02-21 22:30:00",3734,957,4691
"2019-02-21 10:10:16","2019-02-21 23:00:00","2019-02-21 23:30:00",3487,866,4353
"2019-02-21 10:10:16","2019-02-22 00:00:00","2019-02-22 00:30:00",3161,766,3927
"2019-02-21 10:10:16","2019-02-22 01:00:00","2019-02-22 01:30:00",2941,695,3636
"2019-02-21 10:10:16","2019-02-22 02:00:00","2019-02-22 02:30:00",2756,686,3442
"2019-02-21 10:10:16","2019-02-22 03:00:00","2019-02-22 03:30:00",2695,664,3359
"2019-02-21 10:10:16","2019-02-22 04:00:00","2019-02-22 04:30:00",2663,655,3318
"2019-02-21 10:10:16","2019-02-22 05:00:00","2019-02-22 05:30:00",2681,663,3344
"2019-02-21 10:10:16","2019-02-22 06:00:00","2019-02-22 06:30:00",2863,770,3633
"2019-02-21 10:10:16","2019-02-22 07:00:00","2019-02-22 07:30:00",3339,980,4319
"2019-02-21 10:10:16","2019-02-22 08:00:00","2019-02-22 08:30:00",3709,1120,4829
"2019-02-21 10:10:16","2019-02-22 09:00:00","2019-02-22 09:30:00",3764,1146,4910
"2019-02-21 10:10:16","2019-02-22 10:00:00","2019-02-22 10:30:00",3808,1143,4951
"2019-02-21 10:10:16","2019-02-22 11:00:00","2019-02-22 11:30:00",3907,1129,5036
"2019-02-21 10:10:16","2019-02-22 12:00:00","2019-02-22 12:30:00",3926,1132,5058
"2019-02-21 10:10:16","2019-02-22 13:00:00","2019-02-22 13:30:00",4032,1126,5158
"2019-02-21 10:10:16","2019-02-22 14:00:00","2019-02-22 14:30:00",3984,1075,5059
"2019-02-21 10:10:16","2019-02-22 15:00:00","2019-02-22 15:30:00",3982,1094,5076
"2019-02-21 10:10:16","2019-02-22 16:00:00","2019-02-22 16:30:00",4039,1086,5125
"2019-02-21 10:10:16","2019-02-22 17:00:00","2019-02-22 17:30:00",4160,1220,5380
"2019-02-21 10:10:16","2019-02-22 18:00:00","2019-02-22 18:30:00",4386,1320,5706
"2019-02-21 10:10:16","2019-02-22 19:00:00","2019-02-22 19:30:00",4349,1234,5583
"2019-02-21 10:10:16","2019-02-22 20:00:00","2019-02-22 20:30:00",4151,1150,5301
"2019-02-21 10:10:16","2019-02-22 21:00:00","2019-02-22 21:30:00",3922,1067,4989
"2019-02-21 10:10:16","2019-02-22 22:00:00","2019-02-22 22:30:00",3626,949,4575
"2019-02-22 10:10:31","2019-02-22 23:00:00","2019-02-22 23:30:00",3373,783,4156
"2019-02-22 10:10:31","2019-02-23 00:00:00","2019-02-23 00:30:00",3266,659,3925
"2019-02-22 10:10:31","2019-02-23 01:00:00","2019-02-23 01:30:00",3001,592,3593
"2019-02-22 10:10:31","2019-02-23 02:00:00","2019-02-23 02:30:00",2772,575,3347
"2019-02-22 10:10:31","2019-02-23 03:00:00","2019-02-23 03:30:00",2613,585,3198
"2019-02-22 10:10:31","2019-02-23 04:00:00","2019-02-23 04:30:00",2607,541,3148
"2019-02-22 10:10:31","2019-02-23 05:00:00","2019-02-23 05:30:00",2608,529,3137
"2019-02-22 10:10:31","2019-02-23 06:00:00","2019-02-23 06:30:00",2638,578,3216
"2019-02-22 10:10:31","2019-02-23 07:00:00","2019-02-23 07:30:00",2828,669,3497
"2019-02-22 10:10:31","2019-02-23 08:00:00","2019-02-23 08:30:00",2988,757,3745
"2019-02-22 10:10:31","2019-02-23 09:00:00","2019-02-23 09:30:00",3313,872,4185
"2019-02-22 10:10:31","2019-02-23 10:00:00","2019-02-23 10:30:00",3486,975,4461
"2019-02-22 10:10:31","2019-02-23 11:00:00","2019-02-23 11:30:00",3511,962,4473
"2019-02-22 10:10:31","2019-02-23 12:00:00","2019-02-23 12:30:00",3652,975,4627
"2019-02-22 10:10:31","2019-02-23 13:00:00","2019-02-23 13:30:00",3693,963,4656
"2019-02-22 10:10:31","2019-02-23 14:00:00","2019-02-23 14:30:00",3617,925,4542
"2019-02-22 10:10:31","2019-02-23 15:00:00","2019-02-23 15:30:00",3550,887,4437
"2019-02-22 10:10:31","2019-02-23 16:00:00","2019-02-23 16:30:00",3624,915,4539
"2019-02-22 10:10:31","2019-02-23 17:00:00","2019-02-23 17:30:00",3768,1035,4803
"2019-02-22 10:10:31","2019-02-23 18:00:00","2019-02-23 18:30:00",4165,1158,5323
"2019-02-22 10:10:31","2019-02-23 19:00:00","2019-02-23 19:30:00",4089,1121,5210
"2019-02-22 10:10:31","2019-02-23 20:00:00","2019-02-23 20:30:00",3933,1048,4981
"2019-02-22 10:10:31","2019-02-23 21:00:00","2019-02-23 21:30:00",3734,949,4683
"2019-02-22 10:10:31","2019-02-23 22:00:00","2019-02-23 22:30:00",3448,865,4313
"2019-02-23 10:10:16","2019-02-23 23:00:00","2019-02-23 23:30:00",3294,762,4056
"2019-02-23 10:10:16","2019-02-24 00:00:00","2019-02-24 00:30:00",3175,681,3856
"2019-02-23 10:10:16","2019-02-24 01:00:00","2019-02-24 01:30:00",2994,614,3608
"2019-02-23 10:10:16","2019-02-24 02:00:00","2019-02-24 02:30:00",2813,606,3419
"2019-02-23 10:10:16","2019-02-24 03:00:00","2019-02-24 03:30:00",2676,565,3241
"2019-02-23 10:10:16","2019-02-24 04:00:00","2019-02-24 04:30:00",2590,556,3146
"2019-02-23 10:10:16","2019-02-24 05:00:00","2019-02-24 05:30:00",2584,578,3162
"2019-02-23 10:10:16","2019-02-24 06:00:00","2019-02-24 06:30:00",2577,610,3187
"2019-02-23 10:10:16","2019-02-24 07:00:00","2019-02-24 07:30:00",2706,676,3382
"2019-02-23 10:10:16","2019-02-24 08:00:00","2019-02-24 08:30:00",2756,756,3512
"2019-02-23 10:10:16","2019-02-24 09:00:00","2019-02-24 09:30:00",2994,856,3850
"2019-02-23 10:10:16","2019-02-24 10:00:00","2019-02-24 10:30:00",3198,923,4121
"2019-02-23 10:10:16","2019-02-24 11:00:00","2019-02-24 11:30:00",3345,944,4289
"2019-02-23 10:10:16","2019-02-24 12:00:00","2019-02-24 12:30:00",3491,916,4407
"2019-02-23 10:10:16","2019-02-24 13:00:00","2019-02-24 13:30:00",3543,972,4515
"2019-02-23 10:10:16","2019-02-24 14:00:00","2019-02-24 14:30:00",3447,934,4381
"2019-02-23 10:10:16","2019-02-24 15:00:00","2019-02-24 15:30:00",3337,910,4247
"2019-02-23 10:10:16","2019-02-24 16:00:00","2019-02-24 16:30:00",3358,932,4290
"2019-02-23 10:10:16","2019-02-24 17:00:00","2019-02-24 17:30:00",3478,1010,4488
"2019-02-23 10:10:16","2019-02-24 18:00:00","2019-02-24 18:30:00",3827,1151,4978
"2019-02-23 10:10:16","2019-02-24 19:00:00","2019-02-24 19:30:00",3893,1103,4996
"2019-02-23 10:10:16","2019-02-24 20:00:00","2019-02-24 20:30:00",3707,1016,4723
"2019-02-23 10:10:16","2019-02-24 21:00:00","2019-02-24 21:30:00",3541,935,4476
"2019-02-23 10:10:16","2019-02-24 22:00:00","2019-02-24 22:30:00",3293,866,4159
"2019-02-24 10:10:30","2019-02-24 23:00:00","2019-02-24 23:30:00",3104,719,3823
"2019-02-24 10:10:30","2019-02-25 00:00:00","2019-02-25 00:30:00",3089,628,3717
"2019-02-24 10:10:30","2019-02-25 01:00:00","2019-02-25 01:30:00",2862,586,3448
"2019-02-24 10:10:30","2019-02-25 02:00:00","2019-02-25 02:30:00",2759,581,3340
"2019-02-24 10:10:30","2019-02-25 03:00:00","2019-02-25 03:30:00",2657,559,3216
"2019-02-24 10:10:30","2019-02-25 04:00:00","2019-02-25 04:30:00",2658,560,3218
"2019-02-24 10:10:30","2019-02-25 05:00:00","2019-02-25 05:30:00",2669,580,3249
"2019-02-24 10:10:30","2019-02-25 06:00:00","2019-02-25 06:30:00",2844,780,3624
"2019-02-24 10:10:30","2019-02-25 07:00:00","2019-02-25 07:30:00",3377,1000,4377
"2019-02-24 10:10:30","2019-02-25 08:00:00","2019-02-25 08:30:00",3886,1100,4986
"2019-02-24 10:10:30","2019-02-25 09:00:00","2019-02-25 09:30:00",3972,1180,5152
"2019-02-24 10:10:30","2019-02-25 10:00:00","2019-02-25 10:30:00",4056,1200,5256
"2019-02-24 10:10:30","2019-02-25 11:00:00","2019-02-25 11:30:00",4056,1205,5261
"2019-02-24 10:10:30","2019-02-25 12:00:00","2019-02-25 12:30:00",4035,1212,5247
"2019-02-24 10:10:30","2019-02-25 13:00:00","2019-02-25 13:30:00",4030,1150,5180
"2019-02-24 10:10:30","2019-02-25 14:00:00","2019-02-25 14:30:00",3931,1090,5021
"2019-02-24 10:10:30","2019-02-25 15:00:00","2019-02-25 15:30:00",3960,1085,5045
"2019-02-24 10:10:30","2019-02-25 16:00:00","2019-02-25 16:30:00",4025,1180,5205
"2019-02-24 10:10:30","2019-02-25 17:00:00","2019-02-25 17:30:00",4181,1290,5471
"2019-02-24 10:10:30","2019-02-25 18:00:00","2019-02-25 18:30:00",4550,1380,5930
"2019-02-24 10:10:30","2019-02-25 19:00:00","2019-02-25 19:30:00",4448,1330,5778
"2019-02-24 10:10:30","2019-02-25 20:00:00","2019-02-25 20:30:00",4270,1260,5530
"2019-02-24 10:10:30","2019-02-25 21:00:00","2019-02-25 21:30:00",4054,1180,5234
"2019-02-24 10:10:30","2019-02-25 22:00:00","2019-02-25 22:30:00",3636,1050,4686
"2019-02-25 10:10:16","2019-02-25 23:00:00","2019-02-25 23:30:00",3337,827,4164
"2019-02-25 10:10:16","2019-02-26 00:00:00","2019-02-26 00:30:00",3163,760,3923
"2019-02-25 10:10:16","2019-02-26 01:00:00","2019-02-26 01:30:00",3018,697,3715
"2019-02-25 10:10:16","2019-02-26 02:00:00","2019-02-26 02:30:00",2852,693,3545
"2019-02-25 10:10:16","2019-02-26 03:00:00","2019-02-26 03:30:00",2758,680,3438
"2019-02-25 10:10:16","2019-02-26 04:00:00","2019-02-26 04:30:00",2739,662,3401
"2019-02-25 10:10:16","2019-02-26 05:00:00","2019-02-26 05:30:00",2744,676,3420
"2019-02-25 10:10:16","2019-02-26 06:00:00","2019-02-26 06:30:00",2924,755,3679
"2019-02-25 10:10:16","2019-02-26 07:00:00","2019-02-26 07:30:00",3529,948,4477
"2019-02-25 10:10:16","2019-02-26 08:00:00","2019-02-26 08:30:00",4023,1121,5144
"2019-02-25 10:10:16","2019-02-26 09:00:00","2019-02-26 09:30:00",4008,1206,5214
"2019-02-25 10:10:16","2019-02-26 10:00:00","2019-02-26 10:30:00",4057,1215,5272
"2019-02-25 10:10:16","2019-02-26 11:00:00","2019-02-26 11:30:00",4046,1175,5221
"2019-02-25 10:10:16","2019-02-26 12:00:00","2019-02-26 12:30:00",4062,1167,5229
"2019-02-25 10:10:16","2019-02-26 13:00:00","2019-02-26 13:30:00",4045,1162,5207
"2019-02-25 10:10:16","2019-02-26 14:00:00","2019-02-26 14:30:00",3953,1101,5054
"2019-02-25 10:10:16","2019-02-26 15:00:00","2019-02-26 15:30:00",3975,1109,5084
"2019-02-25 10:10:16","2019-02-26 16:00:00","2019-02-26 16:30:00",4035,1117,5152
"2019-02-25 10:10:16","2019-02-26 17:00:00","2019-02-26 17:30:00",4245,1254,5499
"2019-02-25 10:10:16","2019-02-26 18:00:00","2019-02-26 18:30:00",4524,1388,5912
"2019-02-25 10:10:16","2019-02-26 19:00:00","2019-02-26 19:30:00",4503,1339,5842
"2019-02-25 10:10:16","2019-02-26 20:00:00","2019-02-26 20:30:00",4306,1303,5609
"2019-02-25 10:10:16","2019-02-26 21:00:00","2019-02-26 21:30:00",4072,1205,5277
"2019-02-25 10:10:16","2019-02-26 22:00:00","2019-02-26 22:30:00",3681,1071,4752
"2019-02-26 10:10:35","2019-02-26 23:00:00","2019-02-26 23:30:00",3300,895,4195
"2019-02-26 10:10:35","2019-02-27 00:00:00","2019-02-27 00:30:00",3179,778,3957
"2019-02-26 10:10:35","2019-02-27 01:00:00","2019-02-27 01:30:00",3035,720,3755
"2019-02-26 10:10:35","2019-02-27 02:00:00","2019-02-27 02:30:00",2871,715,3586
"2019-02-26 10:10:35","2019-02-27 03:00:00","2019-02-27 03:30:00",2777,698,3475
"2019-02-26 10:10:35","2019-02-27 04:00:00","2019-02-27 04:30:00",2759,672,3431
"2019-02-26 10:10:35","2019-02-27 05:00:00","2019-02-27 05:30:00",2764,692,3456
"2019-02-26 10:10:35","2019-02-27 06:00:00","2019-02-27 06:30:00",2942,770,3712
"2019-02-26 10:10:35","2019-02-27 07:00:00","2019-02-27 07:30:00",3540,976,4516
"2019-02-26 10:10:35","2019-02-27 08:00:00","2019-02-27 08:30:00",4029,1140,5169
"2019-02-26 10:10:35","2019-02-27 09:00:00","2019-02-27 09:30:00",4014,1227,5241
"2019-02-26 10:10:35","2019-02-27 10:00:00","2019-02-27 10:30:00",4063,1242,5305
"2019-02-26 10:10:35","2019-02-27 11:00:00","2019-02-27 11:30:00",4052,1213,5265
"2019-02-26 10:10:35","2019-02-27 12:00:00","2019-02-27 12:30:00",4067,1213,5280
"2019-02-26 10:10:35","2019-02-27 13:00:00","2019-02-27 13:30:00",4051,1208,5259
"2019-02-26 10:10:35","2019-02-27 14:00:00","2019-02-27 14:30:00",3959,1162,5121
"2019-02-26 10:10:35","2019-02-27 15:00:00","2019-02-27 15:30:00",3982,1166,5148
"2019-02-26 10:10:35","2019-02-27 16:00:00","2019-02-27 16:30:00",4040,1166,5206
"2019-02-26 10:10:35","2019-02-27 17:00:00","2019-02-27 17:30:00",4249,1308,5557
"2019-02-26 10:10:35","2019-02-27 18:00:00","2019-02-27 18:30:00",4524,1430,5954
"2019-02-26 10:10:35","2019-02-27 19:00:00","2019-02-27 19:30:00",4504,1356,5860
"2019-02-26 10:10:35","2019-02-27 20:00:00","2019-02-27 20:30:00",4309,1309,5618
"2019-02-26 10:10:35","2019-02-27 21:00:00","2019-02-27 21:30:00",4078,1209,5287
"2019-02-26 10:10:35","2019-02-27 22:00:00","2019-02-27 22:30:00",3691,1074,4765
"2019-02-27 10:10:20","2019-02-27 23:00:00","2019-02-27 23:30:00",3175,882,4057
"2019-02-27 10:10:20","2019-02-28 00:00:00","2019-02-28 00:30:00",3179,767,3946
"2019-02-27 10:10:20","2019-02-28 01:00:00","2019-02-28 01:30:00",3035,716,3751
"2019-02-27 10:10:20","2019-02-28 02:00:00","2019-02-28 02:30:00",2871,696,3567
"2019-02-27 10:10:20","2019-02-28 03:00:00","2019-02-28 03:30:00",2777,671,3448
"2019-02-27 10:10:20","2019-02-28 04:00:00","2019-02-28 04:30:00",2759,666,3425
"2019-02-27 10:10:20","2019-02-28 05:00:00","2019-02-28 05:30:00",2764,679,3443
"2019-02-27 10:10:20","2019-02-28 06:00:00","2019-02-28 06:30:00",2942,756,3698
"2019-02-27 10:10:20","2019-02-28 07:00:00","2019-02-28 07:30:00",3540,959,4499
"2019-02-27 10:10:20","2019-02-28 08:00:00","2019-02-28 08:30:00",4029,1139,5168
"2019-02-27 10:10:20","2019-02-28 09:00:00","2019-02-28 09:30:00",4014,1224,5238
"2019-02-27 10:10:20","2019-02-28 10:00:00","2019-02-28 10:30:00",4063,1255,5318
"2019-02-27 10:10:20","2019-02-28 11:00:00","2019-02-28 11:30:00",4052,1231,5283
"2019-02-27 10:10:20","2019-02-28 12:00:00","2019-02-28 12:30:00",4067,1226,5293
"2019-02-27 10:10:20","2019-02-28 13:00:00","2019-02-28 13:30:00",4051,1223,5274
"2019-02-27 10:10:20","2019-02-28 14:00:00","2019-02-28 14:30:00",3959,1181,5140
"2019-02-27 10:10:20","2019-02-28 15:00:00","2019-02-28 15:30:00",3982,1185,5167
"2019-02-27 10:10:20","2019-02-28 16:00:00","2019-02-28 16:30:00",4040,1205,5245
"2019-02-27 10:10:20","2019-02-28 17:00:00","2019-02-28 17:30:00",4249,1322,5571
"2019-02-27 10:10:20","2019-02-28 18:00:00","2019-02-28 18:30:00",4524,1401,5925
"2019-02-27 10:10:20","2019-02-28 19:00:00","2019-02-28 19:30:00",4504,1359,5863
"2019-02-27 10:10:20","2019-02-28 20:00:00","2019-02-28 20:30:00",4309,1277,5586
"2019-02-27 10:10:20","2019-02-28 21:00:00","2019-02-28 21:30:00",4078,1172,5250
"2019-02-27 10:10:20","2019-02-28 22:00:00","2019-02-28 22:30:00",3691,1031,4722
"2019-02-28 10:10:36","2019-02-28 23:00:00","2019-02-28 23:30:00",3356,868,4224
"2019-02-28 10:10:36","2019-03-01 00:00:00","2019-03-01 00:30:00",3232,746,3978
"2019-02-28 10:10:36","2019-03-01 01:00:00","2019-03-01 01:30:00",3036,687,3723
"2019-02-28 10:10:36","2019-03-01 02:00:00","2019-03-01 02:30:00",2850,653,3503
"2019-02-28 10:10:36","2019-03-01 03:00:00","2019-03-01 03:30:00",2782,630,3412
"2019-02-28 10:10:36","2019-03-01 04:00:00","2019-03-01 04:30:00",2770,627,3397
"2019-02-28 10:10:36","2019-03-01 05:00:00","2019-03-01 05:30:00",2795,663,3458
"2019-02-28 10:10:36","2019-03-01 06:00:00","2019-03-01 06:30:00",2989,722,3711
"2019-02-28 10:10:36","2019-03-01 07:00:00","2019-03-01 07:30:00",3483,938,4421
"2019-02-28 10:10:36","2019-03-01 08:00:00","2019-03-01 08:30:00",3892,1122,5014
"2019-02-28 10:10:36","2019-03-01 09:00:00","2019-03-01 09:30:00",3902,1214,5116
"2019-02-28 10:10:36","2019-03-01 10:00:00","2019-03-01 10:30:00",3950,1233,5183
"2019-02-28 10:10:36","2019-03-01 11:00:00","2019-03-01 11:30:00",3950,1217,5167
"2019-02-28 10:10:36","2019-03-01 12:00:00","2019-03-01 12:30:00",3950,1168,5118
"2019-02-28 10:10:36","2019-03-01 13:00:00","2019-03-01 13:30:00",3905,1153,5058
"2019-02-28 10:10:36","2019-03-01 14:00:00","2019-03-01 14:30:00",3869,1125,4994
"2019-02-28 10:10:36","2019-03-01 15:00:00","2019-03-01 15:30:00",3900,1110,5010
"2019-02-28 10:10:36","2019-03-01 16:00:00","2019-03-01 16:30:00",3946,1092,5038
"2019-02-28 10:10:36","2019-03-01 17:00:00","2019-03-01 17:30:00",4111,1215,5326
"2019-02-28 10:10:36","2019-03-01 18:00:00","2019-03-01 18:30:00",4369,1354,5723
"2019-02-28 10:10:36","2019-03-01 19:00:00","2019-03-01 19:30:00",4324,1315,5639
"2019-02-28 10:10:36","2019-03-01 20:00:00","2019-03-01 20:30:00",4086,1266,5352
"2019-02-28 10:10:36","2019-03-01 21:00:00","2019-03-01 21:30:00",3866,1170,5036
"2019-02-28 10:10:36","2019-03-01 22:00:00","2019-03-01 22:30:00",3600,1042,4642
"2019-03-01 10:10:25","2019-03-01 23:00:00","2019-03-01 23:30:00",3357,882,4239
"2019-03-01 10:10:25","2019-03-02 00:00:00","2019-03-02 00:30:00",3184,748,3932
"2019-03-01 10:10:25","2019-03-02 01:00:00","2019-03-02 01:30:00",2995,672,3667
"2019-03-01 10:10:25","2019-03-02 02:00:00","2019-03-02 02:30:00",2808,623,3431
"2019-03-01 10:10:25","2019-03-02 03:00:00","2019-03-02 03:30:00",2675,606,3281
"2019-03-01 10:10:25","2019-03-02 04:00:00","2019-03-02 04:30:00",2642,574,3216
"2019-03-01 10:10:25","2019-03-02 05:00:00","2019-03-02 05:30:00",2663,598,3261
"2019-03-01 10:10:25","2019-03-02 06:00:00","2019-03-02 06:30:00",2704,637,3341
"2019-03-01 10:10:25","2019-03-02 07:00:00","2019-03-02 07:30:00",2876,733,3609
"2019-03-01 10:10:25","2019-03-02 08:00:00","2019-03-02 08:30:00",3115,837,3952
"2019-03-01 10:10:25","2019-03-02 09:00:00","2019-03-02 09:30:00",3418,983,4401
"2019-03-01 10:10:25","2019-03-02 10:00:00","2019-03-02 10:30:00",3598,1065,4663
"2019-03-01 10:10:25","2019-03-02 11:00:00","2019-03-02 11:30:00",3648,1072,4720
"2019-03-01 10:10:25","2019-03-02 12:00:00","2019-03-02 12:30:00",3641,1075,4716
"2019-03-01 10:10:25","2019-03-02 13:00:00","2019-03-02 13:30:00",3677,1057,4734
"2019-03-01 10:10:25","2019-03-02 14:00:00","2019-03-02 14:30:00",3616,1000,4616
"2019-03-01 10:10:25","2019-03-02 15:00:00","2019-03-02 15:30:00",3525,984,4509
"2019-03-01 10:10:25","2019-03-02 16:00:00","2019-03-02 16:30:00",3513,975,4488
"2019-03-01 10:10:25","2019-03-02 17:00:00","2019-03-02 17:30:00",3733,1067,4800
"2019-03-01 10:10:25","2019-03-02 18:00:00","2019-03-02 18:30:00",4010,1150,5160
"2019-03-01 10:10:25","2019-03-02 19:00:00","2019-03-02 19:30:00",4190,1182,5372
"2019-03-01 10:10:25","2019-03-02 20:00:00","2019-03-02 20:30:00",3919,1081,5000
"2019-03-01 10:10:25","2019-03-02 21:00:00","2019-03-02 21:30:00",3697,981,4678
"2019-03-01 10:10:25","2019-03-02 22:00:00","2019-03-02 22:30:00",3371,916,4287
"2019-03-02 10:10:11","2019-03-02 23:00:00","2019-03-02 23:30:00",3095,803,3898
"2019-03-02 10:10:11","2019-03-03 00:00:00","2019-03-03 00:30:00",3060,715,3775
"2019-03-02 10:10:11","2019-03-03 01:00:00","2019-03-03 01:30:00",2811,646,3457
"2019-03-02 10:10:11","2019-03-03 02:00:00","2019-03-03 02:30:00",2693,620,3313
"2019-03-02 10:10:11","2019-03-03 03:00:00","2019-03-03 03:30:00",2501,592,3093
"2019-03-02 10:10:11","2019-03-03 04:00:00","2019-03-03 04:30:00",2441,589,3030
"2019-03-02 10:10:11","2019-03-03 05:00:00","2019-03-03 05:30:00",2440,582,3022
"2019-03-02 10:10:11","2019-03-03 06:00:00","2019-03-03 06:30:00",2493,613,3106
"2019-03-02 10:10:11","2019-03-03 07:00:00","2019-03-03 07:30:00",2621,663,3284
"2019-03-02 10:10:11","2019-03-03 08:00:00","2019-03-03 08:30:00",2756,720,3476
"2019-03-02 10:10:11","2019-03-03 09:00:00","2019-03-03 09:30:00",3056,836,3892
"2019-03-02 10:10:11","2019-03-03 10:00:00","2019-03-03 10:30:00",3394,933,4327
"2019-03-02 10:10:11","2019-03-03 11:00:00","2019-03-03 11:30:00",3499,989,4488
"2019-03-02 10:10:11","2019-03-03 12:00:00","2019-03-03 12:30:00",3589,1042,4631
"2019-03-02 10:10:11","2019-03-03 13:00:00","2019-03-03 13:30:00",3654,1110,4764
"2019-03-02 10:10:11","2019-03-03 14:00:00","2019-03-03 14:30:00",3586,1081,4667
"2019-03-02 10:10:11","2019-03-03 15:00:00","2019-03-03 15:30:00",3487,1064,4551
"2019-03-02 10:10:11","2019-03-03 16:00:00","2019-03-03 16:30:00",3447,1082,4529
"2019-03-02 10:10:11","2019-03-03 17:00:00","2019-03-03 17:30:00",3653,1186,4839
"2019-03-02 10:10:11","2019-03-03 18:00:00","2019-03-03 18:30:00",3990,1269,5259
"2019-03-02 10:10:11","2019-03-03 19:00:00","2019-03-03 19:30:00",4064,1251,5315
"2019-03-02 10:10:11","2019-03-03 20:00:00","2019-03-03 20:30:00",3867,1173,5040
"2019-03-02 10:10:11","2019-03-03 21:00:00","2019-03-03 21:30:00",3650,1091,4741
"2019-03-02 10:10:11","2019-03-03 22:00:00","2019-03-03 22:30:00",3326,999,4325
"2019-03-03 10:10:26","2019-03-03 23:00:00","2019-03-03 23:30:00",3241,834,4075
"2019-03-03 10:10:26","2019-03-04 00:00:00","2019-03-04 00:30:00",2939,711,3650
"2019-03-03 10:10:26","2019-03-04 01:00:00","2019-03-04 01:30:00",2757,664,3421
"2019-03-03 10:10:26","2019-03-04 02:00:00","2019-03-04 02:30:00",2597,667,3264
"2019-03-03 10:10:26","2019-03-04 03:00:00","2019-03-04 03:30:00",2551,658,3209
"2019-03-03 10:10:26","2019-03-04 04:00:00","2019-03-04 04:30:00",2551,667,3218
"2019-03-03 10:10:26","2019-03-04 05:00:00","2019-03-04 05:30:00",2561,659,3220
"2019-03-03 10:10:26","2019-03-04 06:00:00","2019-03-04 06:30:00",2786,733,3519
"2019-03-03 10:10:26","2019-03-04 07:00:00","2019-03-04 07:30:00",3320,935,4255
"2019-03-03 10:10:26","2019-03-04 08:00:00","2019-03-04 08:30:00",3807,1098,4905
"2019-03-03 10:10:26","2019-03-04 09:00:00","2019-03-04 09:30:00",3897,1177,5074
"2019-03-03 10:10:26","2019-03-04 10:00:00","2019-03-04 10:30:00",3914,1237,5151
"2019-03-03 10:10:26","2019-03-04 11:00:00","2019-03-04 11:30:00",3902,1187,5089
"2019-03-03 10:10:26","2019-03-04 12:00:00","2019-03-04 12:30:00",3856,1232,5088
"2019-03-03 10:10:26","2019-03-04 13:00:00","2019-03-04 13:30:00",3857,1240,5097
"2019-03-03 10:10:26","2019-03-04 14:00:00","2019-03-04 14:30:00",3774,1210,4984
"2019-03-03 10:10:26","2019-03-04 15:00:00","2019-03-04 15:30:00",3785,1175,4960
"2019-03-03 10:10:26","2019-03-04 16:00:00","2019-03-04 16:30:00",3820,1203,5023
"2019-03-03 10:10:26","2019-03-04 17:00:00","2019-03-04 17:30:00",3975,1302,5277
"2019-03-03 10:10:26","2019-03-04 18:00:00","2019-03-04 18:30:00",4177,1383,5560
"2019-03-03 10:10:26","2019-03-04 19:00:00","2019-03-04 19:30:00",4389,1331,5720
"2019-03-03 10:10:26","2019-03-04 20:00:00","2019-03-04 20:30:00",4162,1226,5388
"2019-03-03 10:10:26","2019-03-04 21:00:00","2019-03-04 21:30:00",3930,1148,5078
"2019-03-03 10:10:26","2019-03-04 22:00:00","2019-03-04 22:30:00",3554,991,4545
"2019-03-04 10:10:11","2019-03-04 23:00:00","2019-03-04 23:30:00",3262,946,4208
"2019-03-04 10:10:11","2019-03-05 00:00:00","2019-03-05 00:30:00",3067,726,3793
"2019-03-04 10:10:11","2019-03-05 01:00:00","2019-03-05 01:30:00",2840,672,3512
"2019-03-04 10:10:11","2019-03-05 02:00:00","2019-03-05 02:30:00",2658,688,3346
"2019-03-04 10:10:11","2019-03-05 03:00:00","2019-03-05 03:30:00",2594,655,3249
"2019-03-04 10:10:11","2019-03-05 04:00:00","2019-03-05 04:30:00",2580,659,3239
"2019-03-04 10:10:11","2019-03-05 05:00:00","2019-03-05 05:30:00",2615,672,3287
"2019-03-04 10:10:11","2019-03-05 06:00:00","2019-03-05 06:30:00",2836,729,3565
"2019-03-04 10:10:11","2019-03-05 07:00:00","2019-03-05 07:30:00",3403,926,4329
"2019-03-04 10:10:11","2019-03-05 08:00:00","2019-03-05 08:30:00",3855,1095,4950
"2019-03-04 10:10:11","2019-03-05 09:00:00","2019-03-05 09:30:00",3946,1156,5102
"2019-03-04 10:10:11","2019-03-05 10:00:00","2019-03-05 10:30:00",3971,1171,5142
"2019-03-04 10:10:11","2019-03-05 11:00:00","2019-03-05 11:30:00",3967,1144,5111
"2019-03-04 10:10:11","2019-03-05 12:00:00","2019-03-05 12:30:00",3973,1127,5100
"2019-03-04 10:10:11","2019-03-05 13:00:00","2019-03-05 13:30:00",3991,1118,5109
"2019-03-04 10:10:11","2019-03-05 14:00:00","2019-03-05 14:30:00",3906,1075,4981
"2019-03-04 10:10:11","2019-03-05 15:00:00","2019-03-05 15:30:00",3901,1083,4984
"2019-03-04 10:10:11","2019-03-05 16:00:00","2019-03-05 16:30:00",3960,1129,5089
"2019-03-04 10:10:11","2019-03-05 17:00:00","2019-03-05 17:30:00",4090,1257,5347
"2019-03-04 10:10:11","2019-03-05 18:00:00","2019-03-05 18:30:00",4270,1341,5611
"2019-03-04 10:10:11","2019-03-05 19:00:00","2019-03-05 19:30:00",4460,1328,5788
"2019-03-04 10:10:11","2019-03-05 20:00:00","2019-03-05 20:30:00",4253,1252,5505
"2019-03-04 10:10:11","2019-03-05 21:00:00","2019-03-05 21:30:00",4014,1166,5180
"2019-03-04 10:10:11","2019-03-05 22:00:00","2019-03-05 22:30:00",3630,1017,4647
"2019-03-05 10:10:31","2019-03-05 23:00:00","2019-03-05 23:30:00",3447,971,4418
"2019-03-05 10:10:31","2019-03-06 00:00:00","2019-03-06 00:30:00",3067,737,3804
"2019-03-05 10:10:31","2019-03-06 01:00:00","2019-03-06 01:30:00",2840,685,3525
"2019-03-05 10:10:31","2019-03-06 02:00:00","2019-03-06 02:30:00",2658,689,3347
"2019-03-05 10:10:31","2019-03-06 03:00:00","2019-03-06 03:30:00",2594,658,3252
"2019-03-05 10:10:31","2019-03-06 04:00:00","2019-03-06 04:30:00",2580,663,3243
"2019-03-05 10:10:31","2019-03-06 05:00:00","2019-03-06 05:30:00",2615,682,3297
"2019-03-05 10:10:31","2019-03-06 06:00:00","2019-03-06 06:30:00",2836,749,3585
"2019-03-05 10:10:31","2019-03-06 07:00:00","2019-03-06 07:30:00",3403,960,4363
"2019-03-05 10:10:31","2019-03-06 08:00:00","2019-03-06 08:30:00",3855,1127,4982
"2019-03-05 10:10:31","2019-03-06 09:00:00","2019-03-06 09:30:00",3946,1194,5140
"2019-03-05 10:10:31","2019-03-06 10:00:00","2019-03-06 10:30:00",3971,1227,5198
"2019-03-05 10:10:31","2019-03-06 11:00:00","2019-03-06 11:30:00",3967,1235,5202
"2019-03-05 10:10:31","2019-03-06 12:00:00","2019-03-06 12:30:00",3973,1224,5197
"2019-03-05 10:10:31","2019-03-06 13:00:00","2019-03-06 13:30:00",3991,1200,5191
"2019-03-05 10:10:31","2019-03-06 14:00:00","2019-03-06 14:30:00",3906,1161,5067
"2019-03-05 10:10:31","2019-03-06 15:00:00","2019-03-06 15:30:00",3901,1139,5040
"2019-03-05 10:10:31","2019-03-06 16:00:00","2019-03-06 16:30:00",3960,1189,5149
"2019-03-05 10:10:31","2019-03-06 17:00:00","2019-03-06 17:30:00",4090,1275,5365
"2019-03-05 10:10:31","2019-03-06 18:00:00","2019-03-06 18:30:00",4270,1357,5627
"2019-03-05 10:10:31","2019-03-06 19:00:00","2019-03-06 19:30:00",4460,1350,5810
"2019-03-05 10:10:31","2019-03-06 20:00:00","2019-03-06 20:30:00",4253,1279,5532
"2019-03-05 10:10:31","2019-03-06 21:00:00","2019-03-06 21:30:00",4014,1177,5191
"2019-03-05 10:10:31","2019-03-06 22:00:00","2019-03-06 22:30:00",3630,1037,4667
"2019-03-06 10:10:16","2019-03-06 23:00:00","2019-03-06 23:30:00",3317,900,4217
"2019-03-06 10:10:16","2019-03-07 00:00:00","2019-03-07 00:30:00",3172,732,3904
"2019-03-06 10:10:16","2019-03-07 01:00:00","2019-03-07 01:30:00",2942,680,3622
"2019-03-06 10:10:16","2019-03-07 02:00:00","2019-03-07 02:30:00",2784,673,3457
"2019-03-06 10:10:16","2019-03-07 03:00:00","2019-03-07 03:30:00",2703,642,3345
"2019-03-06 10:10:16","2019-03-07 04:00:00","2019-03-07 04:30:00",2695,645,3340
"2019-03-06 10:10:16","2019-03-07 05:00:00","2019-03-07 05:30:00",2719,649,3368
"2019-03-06 10:10:16","2019-03-07 06:00:00","2019-03-07 06:30:00",2904,728,3632
"2019-03-06 10:10:16","2019-03-07 07:00:00","2019-03-07 07:30:00",3408,941,4349
"2019-03-06 10:10:16","2019-03-07 08:00:00","2019-03-07 08:30:00",3885,1113,4998
"2019-03-06 10:10:16","2019-03-07 09:00:00","2019-03-07 09:30:00",3948,1179,5127
"2019-03-06 10:10:16","2019-03-07 10:00:00","2019-03-07 10:30:00",3997,1200,5197
"2019-03-06 10:10:16","2019-03-07 11:00:00","2019-03-07 11:30:00",3976,1185,5161
"2019-03-06 10:10:16","2019-03-07 12:00:00","2019-03-07 12:30:00",3986,1153,5139
"2019-03-06 10:10:16","2019-03-07 13:00:00","2019-03-07 13:30:00",4020,1139,5159
"2019-03-06 10:10:16","2019-03-07 14:00:00","2019-03-07 14:30:00",3959,1096,5055
"2019-03-06 10:10:16","2019-03-07 15:00:00","2019-03-07 15:30:00",3985,1112,5097
"2019-03-06 10:10:16","2019-03-07 16:00:00","2019-03-07 16:30:00",4112,1164,5276
"2019-03-06 10:10:16","2019-03-07 17:00:00","2019-03-07 17:30:00",4336,1290,5626
"2019-03-06 10:10:16","2019-03-07 18:00:00","2019-03-07 18:30:00",4527,1362,5889
"2019-03-06 10:10:16","2019-03-07 19:00:00","2019-03-07 19:30:00",4622,1378,6000
"2019-03-06 10:10:16","2019-03-07 20:00:00","2019-03-07 20:30:00",4435,1312,5747
"2019-03-06 10:10:16","2019-03-07 21:00:00","2019-03-07 21:30:00",4237,1202,5439
"2019-03-06 10:10:16","2019-03-07 22:00:00","2019-03-07 22:30:00",3832,1075,4907
"2019-03-08 10:10:20","2019-03-07 23:00:00","2019-03-07 23:30:00",3423,839,4262
"2019-03-08 10:10:20","2019-03-08 00:00:00","2019-03-08 00:30:00",3285,780,4065
"2019-03-08 10:10:20","2019-03-08 01:00:00","2019-03-08 01:30:00",3068,706,3774
"2019-03-08 10:10:20","2019-03-08 02:00:00","2019-03-08 02:30:00",2917,689,3606
"2019-03-08 10:10:20","2019-03-08 03:00:00","2019-03-08 03:30:00",2843,671,3514
"2019-03-08 10:10:20","2019-03-08 04:00:00","2019-03-08 04:30:00",2808,671,3479
"2019-03-08 10:10:20","2019-03-08 05:00:00","2019-03-08 05:30:00",2800,679,3479
"2019-03-08 10:10:20","2019-03-08 06:00:00","2019-03-08 06:30:00",2837,759,3596
"2019-03-08 10:10:20","2019-03-08 07:00:00","2019-03-08 07:30:00",3417,939,4356
"2019-03-08 10:10:20","2019-03-08 08:00:00","2019-03-08 08:30:00",3925,1138,5063
"2019-03-08 10:10:20","2019-03-08 09:00:00","2019-03-08 09:30:00",4019,1193,5212
"2019-03-08 10:10:20","2019-03-08 10:00:00","2019-03-08 10:30:00",4083,1205,5288
"2019-03-08 10:10:20","2019-03-08 11:00:00","2019-03-08 11:30:00",4140,1188,5328
"2019-03-08 10:10:20","2019-03-08 12:00:00","2019-03-08 12:30:00",4100,1172,5272
"2019-03-08 10:10:20","2019-03-08 13:00:00","2019-03-08 13:30:00",4120,1149,5269
"2019-03-08 10:10:20","2019-03-08 14:00:00","2019-03-08 14:30:00",4000,1105,5105
"2019-03-08 10:10:20","2019-03-08 15:00:00","2019-03-08 15:30:00",3976,1089,5065
"2019-03-08 10:10:20","2019-03-08 16:00:00","2019-03-08 16:30:00",3985,1135,5120
"2019-03-08 10:10:20","2019-03-08 17:00:00","2019-03-08 17:30:00",4127,1245,5372
"2019-03-08 10:10:20","2019-03-08 18:00:00","2019-03-08 18:30:00",4290,1305,5595
"2019-03-08 10:10:20","2019-03-08 19:00:00","2019-03-08 19:30:00",4430,1311,5741
"2019-03-08 10:10:20","2019-03-08 20:00:00","2019-03-08 20:30:00",4216,1224,5440
"2019-03-08 10:10:20","2019-03-08 21:00:00","2019-03-08 21:30:00",3984,1133,5117
"2019-03-08 10:10:20","2019-03-08 22:00:00","2019-03-08 22:30:00",3666,1016,4682
"2019-03-08 10:10:20","2019-03-08 23:00:00","2019-03-08 23:30:00",3416,893,4309
"2019-03-08 10:10:20","2019-03-09 00:00:00","2019-03-09 00:30:00",3267,769,4036
"2019-03-08 10:10:20","2019-03-09 01:00:00","2019-03-09 01:30:00",3033,705,3738
"2019-03-08 10:10:20","2019-03-09 02:00:00","2019-03-09 02:30:00",2827,688,3515
"2019-03-08 10:10:20","2019-03-09 03:00:00","2019-03-09 03:30:00",2712,655,3367
"2019-03-08 10:10:20","2019-03-09 04:00:00","2019-03-09 04:30:00",2674,639,3313
"2019-03-08 10:10:20","2019-03-09 05:00:00","2019-03-09 05:30:00",2659,650,3309
"2019-03-08 10:10:20","2019-03-09 06:00:00","2019-03-09 06:30:00",2749,705,3454
"2019-03-08 10:10:20","2019-03-09 07:00:00","2019-03-09 07:30:00",2964,800,3764
"2019-03-08 10:10:20","2019-03-09 08:00:00","2019-03-09 08:30:00",3201,935,4136
"2019-03-08 10:10:20","2019-03-09 09:00:00","2019-03-09 09:30:00",3526,1045,4571
"2019-03-08 10:10:20","2019-03-09 10:00:00","2019-03-09 10:30:00",3824,1070,4894
"2019-03-08 10:10:20","2019-03-09 11:00:00","2019-03-09 11:30:00",3915,1090,5005
"2019-03-08 10:10:20","2019-03-09 12:00:00","2019-03-09 12:30:00",3958,1075,5033
"2019-03-08 10:10:20","2019-03-09 13:00:00","2019-03-09 13:30:00",3989,1063,5052
"2019-03-08 10:10:20","2019-03-09 14:00:00","2019-03-09 14:30:00",3904,1003,4907
"2019-03-08 10:10:20","2019-03-09 15:00:00","2019-03-09 15:30:00",3766,981,4747
"2019-03-08 10:10:20","2019-03-09 16:00:00","2019-03-09 16:30:00",3799,980,4779
"2019-03-08 10:10:20","2019-03-09 17:00:00","2019-03-09 17:30:00",3748,1075,4823
"2019-03-08 10:10:20","2019-03-09 18:00:00","2019-03-09 18:30:00",4025,1145,5170
"2019-03-08 10:10:20","2019-03-09 19:00:00","2019-03-09 19:30:00",4282,1205,5487
"2019-03-08 10:10:20","2019-03-09 20:00:00","2019-03-09 20:30:00",3928,1132,5060
"2019-03-08 10:10:20","2019-03-09 21:00:00","2019-03-09 21:30:00",3709,1038,4747
"2019-03-08 10:10:20","2019-03-09 22:00:00","2019-03-09 22:30:00",3430,957,4387
"2019-03-09 10:10:40","2019-03-09 23:00:00","2019-03-09 23:30:00",3229,868,4097
"2019-03-09 10:10:40","2019-03-10 00:00:00","2019-03-10 00:30:00",3138,681,3819
"2019-03-09 10:10:40","2019-03-10 01:00:00","2019-03-10 01:30:00",2877,616,3493
"2019-03-09 10:10:40","2019-03-10 02:00:00","2019-03-10 02:30:00",2716,618,3334
"2019-03-09 10:10:40","2019-03-10 03:00:00","2019-03-10 03:30:00",2608,586,3194
"2019-03-09 10:10:40","2019-03-10 04:00:00","2019-03-10 04:30:00",2600,562,3162
"2019-03-09 10:10:40","2019-03-10 05:00:00","2019-03-10 05:30:00",2601,576,3177
"2019-03-09 10:10:40","2019-03-10 06:00:00","2019-03-10 06:30:00",2668,621,3289
"2019-03-09 10:10:40","2019-03-10 07:00:00","2019-03-10 07:30:00",2767,680,3447
"2019-03-09 10:10:40","2019-03-10 08:00:00","2019-03-10 08:30:00",2921,735,3656
"2019-03-09 10:10:40","2019-03-10 09:00:00","2019-03-10 09:30:00",3198,872,4070
"2019-03-09 10:10:40","2019-03-10 10:00:00","2019-03-10 10:30:00",3493,938,4431
"2019-03-09 10:10:40","2019-03-10 11:00:00","2019-03-10 11:30:00",3627,1005,4632
"2019-03-09 10:10:40","2019-03-10 12:00:00","2019-03-10 12:30:00",3740,1061,4801
"2019-03-09 10:10:40","2019-03-10 13:00:00","2019-03-10 13:30:00",3849,1083,4932
"2019-03-09 10:10:40","2019-03-10 14:00:00","2019-03-10 14:30:00",3846,1031,4877
"2019-03-09 10:10:40","2019-03-10 15:00:00","2019-03-10 15:30:00",3780,998,4778
"2019-03-09 10:10:40","2019-03-10 16:00:00","2019-03-10 16:30:00",3761,1042,4803
"2019-03-09 10:10:40","2019-03-10 17:00:00","2019-03-10 17:30:00",3864,1145,5009
"2019-03-09 10:10:40","2019-03-10 18:00:00","2019-03-10 18:30:00",4028,1168,5196
"2019-03-09 10:10:40","2019-03-10 19:00:00","2019-03-10 19:30:00",4129,1163,5292
"2019-03-09 10:10:40","2019-03-10 20:00:00","2019-03-10 20:30:00",3968,1118,5086
"2019-03-09 10:10:40","2019-03-10 21:00:00","2019-03-10 21:30:00",3777,1019,4796
"2019-03-09 10:10:40","2019-03-10 22:00:00","2019-03-10 22:30:00",3449,914,4363
"2019-03-10 10:10:26","2019-03-10 23:00:00","2019-03-10 23:30:00",3235,778,4013
"2019-03-10 10:10:26","2019-03-11 00:00:00","2019-03-11 00:30:00",3048,691,3739
"2019-03-10 10:10:26","2019-03-11 01:00:00","2019-03-11 01:30:00",2836,640,3476
"2019-03-10 10:10:26","2019-03-11 02:00:00","2019-03-11 02:30:00",2729,645,3374
"2019-03-10 10:10:26","2019-03-11 03:00:00","2019-03-11 03:30:00",2623,620,3243
"2019-03-10 10:10:26","2019-03-11 04:00:00","2019-03-11 04:30:00",2616,617,3233
"2019-03-10 10:10:26","2019-03-11 05:00:00","2019-03-11 05:30:00",2611,624,3235
"2019-03-10 10:10:26","2019-03-11 06:00:00","2019-03-11 06:30:00",2801,708,3509
"2019-03-10 10:10:26","2019-03-11 07:00:00","2019-03-11 07:30:00",3412,904,4316
"2019-03-10 10:10:26","2019-03-11 08:00:00","2019-03-11 08:30:00",3871,1079,4950
"2019-03-10 10:10:26","2019-03-11 09:00:00","2019-03-11 09:30:00",4034,1167,5201
"2019-03-10 10:10:26","2019-03-11 10:00:00","2019-03-11 10:30:00",4143,1190,5333
"2019-03-10 10:10:26","2019-03-11 11:00:00","2019-03-11 11:30:00",4194,1161,5355
"2019-03-10 10:10:26","2019-03-11 12:00:00","2019-03-11 12:30:00",4176,1186,5362
"2019-03-10 10:10:26","2019-03-11 13:00:00","2019-03-11 13:30:00",4206,1185,5391
"2019-03-10 10:10:26","2019-03-11 14:00:00","2019-03-11 14:30:00",4078,1154,5232
"2019-03-10 10:10:26","2019-03-11 15:00:00","2019-03-11 15:30:00",4077,1107,5184
"2019-03-10 10:10:26","2019-03-11 16:00:00","2019-03-11 16:30:00",4064,1132,5196
"2019-03-10 10:10:26","2019-03-11 17:00:00","2019-03-11 17:30:00",4237,1229,5466
"2019-03-10 10:10:26","2019-03-11 18:00:00","2019-03-11 18:30:00",4414,1254,5668
"2019-03-10 10:10:26","2019-03-11 19:00:00","2019-03-11 19:30:00",4600,1273,5873
"2019-03-10 10:10:26","2019-03-11 20:00:00","2019-03-11 20:30:00",4393,1188,5581
"2019-03-10 10:10:26","2019-03-11 21:00:00","2019-03-11 21:30:00",4196,1097,5293
"2019-03-10 10:10:26","2019-03-11 22:00:00","2019-03-11 22:30:00",3819,962,4781
"2019-03-11 10:10:35","2019-03-11 23:00:00","2019-03-11 23:30:00",3470,922,4392
"2019-03-11 10:10:35","2019-03-12 00:00:00","2019-03-12 00:30:00",3119,676,3795
"2019-03-11 10:10:35","2019-03-12 01:00:00","2019-03-12 01:30:00",2932,643,3575
"2019-03-11 10:10:35","2019-03-12 02:00:00","2019-03-12 02:30:00",2820,620,3440
"2019-03-11 10:10:35","2019-03-12 03:00:00","2019-03-12 03:30:00",2728,609,3337
"2019-03-11 10:10:35","2019-03-12 04:00:00","2019-03-12 04:30:00",2702,612,3314
"2019-03-11 10:10:35","2019-03-12 05:00:00","2019-03-12 05:30:00",2737,621,3358
"2019-03-11 10:10:35","2019-03-12 06:00:00","2019-03-12 06:30:00",2951,711,3662
"2019-03-11 10:10:35","2019-03-12 07:00:00","2019-03-12 07:30:00",3551,926,4477
"2019-03-11 10:10:35","2019-03-12 08:00:00","2019-03-12 08:30:00",3984,1122,5106
"2019-03-11 10:10:35","2019-03-12 09:00:00","2019-03-12 09:30:00",4036,1187,5223
"2019-03-11 10:10:35","2019-03-12 10:00:00","2019-03-12 10:30:00",4088,1199,5287
"2019-03-11 10:10:35","2019-03-12 11:00:00","2019-03-12 11:30:00",4076,1163,5239
"2019-03-11 10:10:35","2019-03-12 12:00:00","2019-03-12 12:30:00",4034,1141,5175
"2019-03-11 10:10:35","2019-03-12 13:00:00","2019-03-12 13:30:00",4123,1129,5252
"2019-03-11 10:10:35","2019-03-12 14:00:00","2019-03-12 14:30:00",4051,1080,5131
"2019-03-11 10:10:35","2019-03-12 15:00:00","2019-03-12 15:30:00",4058,1077,5135
"2019-03-11 10:10:35","2019-03-12 16:00:00","2019-03-12 16:30:00",4086,1138,5224
"2019-03-11 10:10:35","2019-03-12 17:00:00","2019-03-12 17:30:00",4249,1228,5477
"2019-03-11 10:10:35","2019-03-12 18:00:00","2019-03-12 18:30:00",4395,1242,5637
"2019-03-11 10:10:35","2019-03-12 19:00:00","2019-03-12 19:30:00",4600,1244,5844
"2019-03-11 10:10:35","2019-03-12 20:00:00","2019-03-12 20:30:00",4446,1188,5634
"2019-03-11 10:10:35","2019-03-12 21:00:00","2019-03-12 21:30:00",4246,1097,5343
"2019-03-11 10:10:35","2019-03-12 22:00:00","2019-03-12 22:30:00",3842,929,4771
"2019-03-13 10:10:35","2019-03-12 23:00:00","2019-03-12 23:30:00",3525,815,4340
"2019-03-13 10:10:35","2019-03-13 00:00:00","2019-03-13 00:30:00",3246,680,3926
"2019-03-13 10:10:35","2019-03-13 01:00:00","2019-03-13 01:30:00",3058,631,3689
"2019-03-13 10:10:35","2019-03-13 02:00:00","2019-03-13 02:30:00",2890,617,3507
"2019-03-13 10:10:35","2019-03-13 03:00:00","2019-03-13 03:30:00",2797,590,3387
"2019-03-13 10:10:35","2019-03-13 04:00:00","2019-03-13 04:30:00",2777,603,3380
"2019-03-13 10:10:35","2019-03-13 05:00:00","2019-03-13 05:30:00",2762,608,3370
"2019-03-13 10:10:35","2019-03-13 06:00:00","2019-03-13 06:30:00",2927,696,3623
"2019-03-13 10:10:35","2019-03-13 07:00:00","2019-03-13 07:30:00",3431,888,4319
"2019-03-13 10:10:35","2019-03-13 08:00:00","2019-03-13 08:30:00",3914,1068,4982
"2019-03-13 10:10:35","2019-03-13 09:00:00","2019-03-13 09:30:00",3983,1114,5097
"2019-03-13 10:10:35","2019-03-13 10:00:00","2019-03-13 10:30:00",4095,1118,5213
"2019-03-13 10:10:35","2019-03-13 11:00:00","2019-03-13 11:30:00",4089,1118,5207
"2019-03-13 10:10:35","2019-03-13 12:00:00","2019-03-13 12:30:00",4109,1121,5230
"2019-03-13 10:10:35","2019-03-13 13:00:00","2019-03-13 13:30:00",4144,1097,5241
"2019-03-13 10:10:35","2019-03-13 14:00:00","2019-03-13 14:30:00",3999,1058,5057
"2019-03-13 10:10:35","2019-03-13 15:00:00","2019-03-13 15:30:00",4064,1085,5149
"2019-03-13 10:10:35","2019-03-13 16:00:00","2019-03-13 16:30:00",4093,1160,5253
"2019-03-13 10:10:35","2019-03-13 17:00:00","2019-03-13 17:30:00",4251,1296,5547
"2019-03-13 10:10:35","2019-03-13 18:00:00","2019-03-13 18:30:00",4418,1337,5755
"2019-03-13 10:10:35","2019-03-13 19:00:00","2019-03-13 19:30:00",4622,1355,5977
"2019-03-13 10:10:35","2019-03-13 20:00:00","2019-03-13 20:30:00",4458,1283,5741
"2019-03-13 10:10:35","2019-03-13 21:00:00","2019-03-13 21:30:00",4201,1176,5377
"2019-03-13 10:10:35","2019-03-13 22:00:00","2019-03-13 22:30:00",3848,1037,4885
"2019-03-13 10:10:35","2019-03-13 23:00:00","2019-03-13 23:30:00",3467,855,4322
"2019-03-13 10:10:35","2019-03-14 00:00:00","2019-03-14 00:30:00",3246,705,3951
"2019-03-13 10:10:35","2019-03-14 01:00:00","2019-03-14 01:30:00",3058,652,3710
"2019-03-13 10:10:35","2019-03-14 02:00:00","2019-03-14 02:30:00",2890,628,3518
"2019-03-13 10:10:35","2019-03-14 03:00:00","2019-03-14 03:30:00",2797,605,3402
"2019-03-13 10:10:35","2019-03-14 04:00:00","2019-03-14 04:30:00",2777,612,3389
"2019-03-13 10:10:35","2019-03-14 05:00:00","2019-03-14 05:30:00",2762,616,3378
"2019-03-13 10:10:35","2019-03-14 06:00:00","2019-03-14 06:30:00",2927,701,3628
"2019-03-13 10:10:35","2019-03-14 07:00:00","2019-03-14 07:30:00",3431,891,4322
"2019-03-13 10:10:35","2019-03-14 08:00:00","2019-03-14 08:30:00",3914,1064,4978
"2019-03-13 10:10:35","2019-03-14 09:00:00","2019-03-14 09:30:00",3983,1131,5114
"2019-03-13 10:10:35","2019-03-14 10:00:00","2019-03-14 10:30:00",4095,1133,5228
"2019-03-13 10:10:35","2019-03-14 11:00:00","2019-03-14 11:30:00",4089,1118,5207
"2019-03-13 10:10:35","2019-03-14 12:00:00","2019-03-14 12:30:00",4109,1119,5228
"2019-03-13 10:10:35","2019-03-14 13:00:00","2019-03-14 13:30:00",4144,1096,5240
"2019-03-13 10:10:35","2019-03-14 14:00:00","2019-03-14 14:30:00",3999,1064,5063
"2019-03-13 10:10:35","2019-03-14 15:00:00","2019-03-14 15:30:00",4064,1087,5151
"2019-03-13 10:10:35","2019-03-14 16:00:00","2019-03-14 16:30:00",4093,1151,5244
"2019-03-13 10:10:35","2019-03-14 17:00:00","2019-03-14 17:30:00",4251,1252,5503
"2019-03-13 10:10:35","2019-03-14 18:00:00","2019-03-14 18:30:00",4418,1291,5709
"2019-03-13 10:10:35","2019-03-14 19:00:00","2019-03-14 19:30:00",4622,1331,5953
"2019-03-13 10:10:35","2019-03-14 20:00:00","2019-03-14 20:30:00",4458,1283,5741
"2019-03-13 10:10:35","2019-03-14 21:00:00","2019-03-14 21:30:00",4201,1186,5387
"2019-03-13 10:10:35","2019-03-14 22:00:00","2019-03-14 22:30:00",3848,1057,4905
"2019-03-15 10:10:11","2019-03-14 23:00:00","2019-03-14 23:30:00",3467,839,4306
"2019-03-15 10:10:11","2019-03-15 00:00:00","2019-03-15 00:30:00",3253,734,3987
"2019-03-15 10:10:11","2019-03-15 01:00:00","2019-03-15 01:30:00",3015,686,3701
"2019-03-15 10:10:11","2019-03-15 02:00:00","2019-03-15 02:30:00",2829,636,3465
"2019-03-15 10:10:11","2019-03-15 03:00:00","2019-03-15 03:30:00",2746,611,3357
"2019-03-15 10:10:11","2019-03-15 04:00:00","2019-03-15 04:30:00",2719,601,3320
"2019-03-15 10:10:11","2019-03-15 05:00:00","2019-03-15 05:30:00",2720,602,3322
"2019-03-15 10:10:11","2019-03-15 06:00:00","2019-03-15 06:30:00",2916,680,3596
"2019-03-15 10:10:11","2019-03-15 07:00:00","2019-03-15 07:30:00",3429,862,4291
"2019-03-15 10:10:11","2019-03-15 08:00:00","2019-03-15 08:30:00",3935,1073,5008
"2019-03-15 10:10:11","2019-03-15 09:00:00","2019-03-15 09:30:00",4056,1120,5176
"2019-03-15 10:10:11","2019-03-15 10:00:00","2019-03-15 10:30:00",4105,1146,5251
"2019-03-15 10:10:11","2019-03-15 11:00:00","2019-03-15 11:30:00",4107,1132,5239
"2019-03-15 10:10:11","2019-03-15 12:00:00","2019-03-15 12:30:00",4123,1149,5272
"2019-03-15 10:10:11","2019-03-15 13:00:00","2019-03-15 13:30:00",4130,1148,5278
"2019-03-15 10:10:11","2019-03-15 14:00:00","2019-03-15 14:30:00",3969,1080,5049
"2019-03-15 10:10:11","2019-03-15 15:00:00","2019-03-15 15:30:00",3971,1074,5045
"2019-03-15 10:10:11","2019-03-15 16:00:00","2019-03-15 16:30:00",3968,1116,5084
"2019-03-15 10:10:11","2019-03-15 17:00:00","2019-03-15 17:30:00",4047,1207,5254
"2019-03-15 10:10:11","2019-03-15 18:00:00","2019-03-15 18:30:00",4175,1300,5475
"2019-03-15 10:10:11","2019-03-15 19:00:00","2019-03-15 19:30:00",4400,1330,5730
"2019-03-15 10:10:11","2019-03-15 20:00:00","2019-03-15 20:30:00",4256,1220,5476
"2019-03-15 10:10:11","2019-03-15 21:00:00","2019-03-15 21:30:00",4009,1105,5114
"2019-03-15 10:10:11","2019-03-15 22:00:00","2019-03-15 22:30:00",3695,1003,4698
"2019-03-15 10:10:11","2019-03-15 23:00:00","2019-03-15 23:30:00",3447,867,4314
"2019-03-15 10:10:11","2019-03-16 00:00:00","2019-03-16 00:30:00",3289,758,4047
"2019-03-15 10:10:11","2019-03-16 01:00:00","2019-03-16 01:30:00",2968,689,3657
"2019-03-15 10:10:11","2019-03-16 02:00:00","2019-03-16 02:30:00",2814,680,3494
"2019-03-15 10:10:11","2019-03-16 03:00:00","2019-03-16 03:30:00",2666,683,3349
"2019-03-15 10:10:11","2019-03-16 04:00:00","2019-03-16 04:30:00",2615,666,3281
"2019-03-15 10:10:11","2019-03-16 05:00:00","2019-03-16 05:30:00",2588,661,3249
"2019-03-15 10:10:11","2019-03-16 06:00:00","2019-03-16 06:30:00",2652,683,3335
"2019-03-15 10:10:11","2019-03-16 07:00:00","2019-03-16 07:30:00",2739,743,3482
"2019-03-15 10:10:11","2019-03-16 08:00:00","2019-03-16 08:30:00",3018,866,3884
"2019-03-15 10:10:11","2019-03-16 09:00:00","2019-03-16 09:30:00",3382,985,4367
"2019-03-15 10:10:11","2019-03-16 10:00:00","2019-03-16 10:30:00",3540,1037,4577
"2019-03-15 10:10:11","2019-03-16 11:00:00","2019-03-16 11:30:00",3663,1045,4708
"2019-03-15 10:10:11","2019-03-16 12:00:00","2019-03-16 12:30:00",3752,1049,4801
"2019-03-15 10:10:11","2019-03-16 13:00:00","2019-03-16 13:30:00",3743,1055,4798
"2019-03-15 10:10:11","2019-03-16 14:00:00","2019-03-16 14:30:00",3604,1023,4627
"2019-03-15 10:10:11","2019-03-16 15:00:00","2019-03-16 15:30:00",3623,986,4609
"2019-03-15 10:10:11","2019-03-16 16:00:00","2019-03-16 16:30:00",3682,993,4675
"2019-03-15 10:10:11","2019-03-16 17:00:00","2019-03-16 17:30:00",3877,1085,4962
"2019-03-15 10:10:11","2019-03-16 18:00:00","2019-03-16 18:30:00",4161,1183,5344
"2019-03-15 10:10:11","2019-03-16 19:00:00","2019-03-16 19:30:00",4356,1234,5590
"2019-03-15 10:10:11","2019-03-16 20:00:00","2019-03-16 20:30:00",4119,1126,5245
"2019-03-15 10:10:11","2019-03-16 21:00:00","2019-03-16 21:30:00",3882,1031,4913
"2019-03-15 10:10:11","2019-03-16 22:00:00","2019-03-16 22:30:00",3568,959,4527
"2019-03-16 10:10:31","2019-03-16 23:00:00","2019-03-16 23:30:00",3380,892,4272
"2019-03-16 10:10:31","2019-03-17 00:00:00","2019-03-17 00:30:00",3268,728,3996
"2019-03-16 10:10:31","2019-03-17 01:00:00","2019-03-17 01:30:00",3088,665,3753
"2019-03-16 10:10:31","2019-03-17 02:00:00","2019-03-17 02:30:00",2900,644,3544
"2019-03-16 10:10:31","2019-03-17 03:00:00","2019-03-17 03:30:00",2732,614,3346
"2019-03-16 10:10:31","2019-03-17 04:00:00","2019-03-17 04:30:00",2642,608,3250
"2019-03-16 10:10:31","2019-03-17 05:00:00","2019-03-17 05:30:00",2600,607,3207
"2019-03-16 10:10:31","2019-03-17 06:00:00","2019-03-17 06:30:00",2685,614,3299
"2019-03-16 10:10:31","2019-03-17 07:00:00","2019-03-17 07:30:00",2739,653,3392
"2019-03-16 10:10:31","2019-03-17 08:00:00","2019-03-17 08:30:00",2893,716,3609
"2019-03-16 10:10:31","2019-03-17 09:00:00","2019-03-17 09:30:00",3138,823,3961
"2019-03-16 10:10:31","2019-03-17 10:00:00","2019-03-17 10:30:00",3412,901,4313
"2019-03-16 10:10:31","2019-03-17 11:00:00","2019-03-17 11:30:00",3574,969,4543
"2019-03-16 10:10:31","2019-03-17 12:00:00","2019-03-17 12:30:00",3600,1032,4632
"2019-03-16 10:10:31","2019-03-17 13:00:00","2019-03-17 13:30:00",3758,1039,4797
"2019-03-16 10:10:31","2019-03-17 14:00:00","2019-03-17 14:30:00",3597,930,4527
"2019-03-16 10:10:31","2019-03-17 15:00:00","2019-03-17 15:30:00",3553,949,4502
"2019-03-16 10:10:31","2019-03-17 16:00:00","2019-03-17 16:30:00",3536,973,4509
"2019-03-16 10:10:31","2019-03-17 17:00:00","2019-03-17 17:30:00",3585,1058,4643
"2019-03-16 10:10:31","2019-03-17 18:00:00","2019-03-17 18:30:00",3772,1097,4869
"2019-03-16 10:10:31","2019-03-17 19:00:00","2019-03-17 19:30:00",4034,1120,5154
"2019-03-16 10:10:31","2019-03-17 20:00:00","2019-03-17 20:30:00",3904,1087,4991
"2019-03-16 10:10:31","2019-03-17 21:00:00","2019-03-17 21:30:00",3723,1025,4748
"2019-03-16 10:10:31","2019-03-17 22:00:00","2019-03-17 22:30:00",3429,916,4345
"2019-03-17 10:10:16","2019-03-17 23:00:00","2019-03-17 23:30:00",3133,850,3983
"2019-03-17 10:10:16","2019-03-18 00:00:00","2019-03-18 00:30:00",3230,697,3927
"2019-03-17 10:10:16","2019-03-18 01:00:00","2019-03-18 01:30:00",2900,653,3553
"2019-03-17 10:10:16","2019-03-18 02:00:00","2019-03-18 02:30:00",2756,679,3435
"2019-03-17 10:10:16","2019-03-18 03:00:00","2019-03-18 03:30:00",2594,632,3226
"2019-03-17 10:10:16","2019-03-18 04:00:00","2019-03-18 04:30:00",2550,633,3183
"2019-03-17 10:10:16","2019-03-18 05:00:00","2019-03-18 05:30:00",2558,647,3205
"2019-03-17 10:10:16","2019-03-18 06:00:00","2019-03-18 06:30:00",2615,727,3342
"2019-03-17 10:10:16","2019-03-18 07:00:00","2019-03-18 07:30:00",2732,921,3653
"2019-03-17 10:10:16","2019-03-18 08:00:00","2019-03-18 08:30:00",3035,1095,4130
"2019-03-17 10:10:16","2019-03-18 09:00:00","2019-03-18 09:30:00",3411,1174,4585
"2019-03-17 10:10:16","2019-03-18 10:00:00","2019-03-18 10:30:00",3588,1198,4786
"2019-03-17 10:10:16","2019-03-18 11:00:00","2019-03-18 11:30:00",3666,1166,4832
"2019-03-17 10:10:16","2019-03-18 12:00:00","2019-03-18 12:30:00",3738,1189,4927
"2019-03-17 10:10:16","2019-03-18 13:00:00","2019-03-18 13:30:00",3725,1206,4931
"2019-03-17 10:10:16","2019-03-18 14:00:00","2019-03-18 14:30:00",3595,1171,4766
"2019-03-17 10:10:16","2019-03-18 15:00:00","2019-03-18 15:30:00",3531,1177,4708
"2019-03-17 10:10:16","2019-03-18 16:00:00","2019-03-18 16:30:00",3534,1238,4772
"2019-03-17 10:10:16","2019-03-18 17:00:00","2019-03-18 17:30:00",3722,1353,5075
"2019-03-17 10:10:16","2019-03-18 18:00:00","2019-03-18 18:30:00",3979,1371,5350
"2019-03-17 10:10:16","2019-03-18 19:00:00","2019-03-18 19:30:00",4170,1350,5520
"2019-03-17 10:10:16","2019-03-18 20:00:00","2019-03-18 20:30:00",3922,1273,5195
"2019-03-17 10:10:16","2019-03-18 21:00:00","2019-03-18 21:30:00",3695,1180,4875
"2019-03-17 10:10:16","2019-03-18 22:00:00","2019-03-18 22:30:00",3418,1041,4459
"2019-03-18 10:10:36","2019-03-18 23:00:00","2019-03-18 23:30:00",3231,910,4141
"2019-03-18 10:10:36","2019-03-19 00:00:00","2019-03-19 00:30:00",2921,725,3646
"2019-03-18 10:10:36","2019-03-19 01:00:00","2019-03-19 01:30:00",2820,674,3494
"2019-03-18 10:10:36","2019-03-19 02:00:00","2019-03-19 02:30:00",2673,639,3312
"2019-03-18 10:10:36","2019-03-19 03:00:00","2019-03-19 03:30:00",2572,622,3194
"2019-03-18 10:10:36","2019-03-19 04:00:00","2019-03-19 04:30:00",2554,618,3172
"2019-03-18 10:10:36","2019-03-19 05:00:00","2019-03-19 05:30:00",2527,659,3186
"2019-03-18 10:10:36","2019-03-19 06:00:00","2019-03-19 06:30:00",2747,758,3505
"2019-03-18 10:10:36","2019-03-19 07:00:00","2019-03-19 07:30:00",3192,941,4133
"2019-03-18 10:10:36","2019-03-19 08:00:00","2019-03-19 08:30:00",3698,1125,4823
"2019-03-18 10:10:36","2019-03-19 09:00:00","2019-03-19 09:30:00",3813,1173,4986
"2019-03-18 10:10:36","2019-03-19 10:00:00","2019-03-19 10:30:00",3957,1185,5142
"2019-03-18 10:10:36","2019-03-19 11:00:00","2019-03-19 11:30:00",3881,1145,5026
"2019-03-18 10:10:36","2019-03-19 12:00:00","2019-03-19 12:30:00",3855,1123,4978
"2019-03-18 10:10:36","2019-03-19 13:00:00","2019-03-19 13:30:00",3977,1092,5069
"2019-03-18 10:10:36","2019-03-19 14:00:00","2019-03-19 14:30:00",3864,1049,4913
"2019-03-18 10:10:36","2019-03-19 15:00:00","2019-03-19 15:30:00",3912,1041,4953
"2019-03-18 10:10:36","2019-03-19 16:00:00","2019-03-19 16:30:00",3997,1109,5106
"2019-03-18 10:10:36","2019-03-19 17:00:00","2019-03-19 17:30:00",4216,1244,5460
"2019-03-18 10:10:36","2019-03-19 18:00:00","2019-03-19 18:30:00",4373,1225,5598
"2019-03-18 10:10:36","2019-03-19 19:00:00","2019-03-19 19:30:00",4453,1264,5717
"2019-03-18 10:10:36","2019-03-19 20:00:00","2019-03-19 20:30:00",4287,1237,5524
"2019-03-18 10:10:36","2019-03-19 21:00:00","2019-03-19 21:30:00",4086,1161,5247
"2019-03-18 10:10:36","2019-03-19 22:00:00","2019-03-19 22:30:00",3742,991,4733
"2019-03-19 10:10:21","2019-03-19 23:00:00","2019-03-19 23:30:00",3436,880,4316
"2019-03-19 10:10:21","2019-03-20 00:00:00","2019-03-20 00:30:00",3246,696,3942
"2019-03-19 10:10:21","2019-03-20 01:00:00","2019-03-20 01:30:00",3058,648,3706
"2019-03-19 10:10:21","2019-03-20 02:00:00","2019-03-20 02:30:00",2890,636,3526
"2019-03-19 10:10:21","2019-03-20 03:00:00","2019-03-20 03:30:00",2797,617,3414
"2019-03-19 10:10:21","2019-03-20 04:00:00","2019-03-20 04:30:00",2777,617,3394
"2019-03-19 10:10:21","2019-03-20 05:00:00","2019-03-20 05:30:00",2762,631,3393
"2019-03-19 10:10:21","2019-03-20 06:00:00","2019-03-20 06:30:00",2927,711,3638
"2019-03-19 10:10:21","2019-03-20 07:00:00","2019-03-20 07:30:00",3431,895,4326
"2019-03-19 10:10:21","2019-03-20 08:00:00","2019-03-20 08:30:00",3914,1075,4989
"2019-03-19 10:10:21","2019-03-20 09:00:00","2019-03-20 09:30:00",3983,1121,5104
"2019-03-19 10:10:21","2019-03-20 10:00:00","2019-03-20 10:30:00",4095,1116,5211
"2019-03-19 10:10:21","2019-03-20 11:00:00","2019-03-20 11:30:00",4089,1107,5196
"2019-03-19 10:10:21","2019-03-20 12:00:00","2019-03-20 12:30:00",4109,1089,5198
"2019-03-19 10:10:21","2019-03-20 13:00:00","2019-03-20 13:30:00",4144,1054,5198
"2019-03-19 10:10:21","2019-03-20 14:00:00","2019-03-20 14:30:00",3999,1030,5029
"2019-03-19 10:10:21","2019-03-20 15:00:00","2019-03-20 15:30:00",4064,1036,5100
"2019-03-19 10:10:21","2019-03-20 16:00:00","2019-03-20 16:30:00",4093,1096,5189
"2019-03-19 10:10:21","2019-03-20 17:00:00","2019-03-20 17:30:00",4251,1185,5436
"2019-03-19 10:10:21","2019-03-20 18:00:00","2019-03-20 18:30:00",4418,1200,5618
"2019-03-19 10:10:21","2019-03-20 19:00:00","2019-03-20 19:30:00",4622,1208,5830
"2019-03-19 10:10:21","2019-03-20 20:00:00","2019-03-20 20:30:00",4458,1171,5629
"2019-03-19 10:10:21","2019-03-20 21:00:00","2019-03-20 21:30:00",4201,1100,5301
"2019-03-19 10:10:21","2019-03-20 22:00:00","2019-03-20 22:30:00",3848,939,4787
"2019-03-20 10:10:40","2019-03-20 23:00:00","2019-03-20 23:30:00",3297,884,4181
"2019-03-20 10:10:40","2019-03-21 00:00:00","2019-03-21 00:30:00",3172,697,3869
"2019-03-20 10:10:40","2019-03-21 01:00:00","2019-03-21 01:30:00",2950,660,3610
"2019-03-20 10:10:40","2019-03-21 02:00:00","2019-03-21 02:30:00",2801,639,3440
"2019-03-20 10:10:40","2019-03-21 03:00:00","2019-03-21 03:30:00",2704,626,3330
"2019-03-20 10:10:40","2019-03-21 04:00:00","2019-03-21 04:30:00",2686,627,3313
"2019-03-20 10:10:40","2019-03-21 05:00:00","2019-03-21 05:30:00",2731,625,3356
"2019-03-20 10:10:40","2019-03-21 06:00:00","2019-03-21 06:30:00",2939,720,3659
"2019-03-20 10:10:40","2019-03-21 07:00:00","2019-03-21 07:30:00",3451,887,4338
"2019-03-20 10:10:40","2019-03-21 08:00:00","2019-03-21 08:30:00",3974,1071,5045
"2019-03-20 10:10:40","2019-03-21 09:00:00","2019-03-21 09:30:00",4047,1118,5165
"2019-03-20 10:10:40","2019-03-21 10:00:00","2019-03-21 10:30:00",4094,1124,5218
"2019-03-20 10:10:40","2019-03-21 11:00:00","2019-03-21 11:30:00",4064,1125,5189
"2019-03-20 10:10:40","2019-03-21 12:00:00","2019-03-21 12:30:00",4052,1122,5174
"2019-03-20 10:10:40","2019-03-21 13:00:00","2019-03-21 13:30:00",4062,1109,5171
"2019-03-20 10:10:40","2019-03-21 14:00:00","2019-03-21 14:30:00",3935,1075,5010
"2019-03-20 10:10:40","2019-03-21 15:00:00","2019-03-21 15:30:00",3953,1084,5037
"2019-03-20 10:10:40","2019-03-21 16:00:00","2019-03-21 16:30:00",3963,1139,5102
"2019-03-20 10:10:40","2019-03-21 17:00:00","2019-03-21 17:30:00",4131,1231,5362
"2019-03-20 10:10:40","2019-03-21 18:00:00","2019-03-21 18:30:00",4300,1233,5533
"2019-03-20 10:10:40","2019-03-21 19:00:00","2019-03-21 19:30:00",4500,1270,5770
"2019-03-20 10:10:40","2019-03-21 20:00:00","2019-03-21 20:30:00",4350,1197,5547
"2019-03-20 10:10:40","2019-03-21 21:00:00","2019-03-21 21:30:00",4068,1146,5214
"2019-03-20 10:10:40","2019-03-21 22:00:00","2019-03-21 22:30:00",3674,995,4669
"2019-03-21 10:10:10","2019-03-21 23:00:00","2019-03-21 23:30:00",3400,848,4248
"2019-03-21 10:10:10","2019-03-22 00:00:00","2019-03-22 00:30:00",3162,704,3866
"2019-03-21 10:10:10","2019-03-22 01:00:00","2019-03-22 01:30:00",2970,626,3596
"2019-03-21 10:10:10","2019-03-22 02:00:00","2019-03-22 02:30:00",2800,630,3430
"2019-03-21 10:10:10","2019-03-22 03:00:00","2019-03-22 03:30:00",2708,606,3314
"2019-03-21 10:10:10","2019-03-22 04:00:00","2019-03-22 04:30:00",2680,595,3275
"2019-03-21 10:10:10","2019-03-22 05:00:00","2019-03-22 05:30:00",2692,593,3285
"2019-03-21 10:10:10","2019-03-22 06:00:00","2019-03-22 06:30:00",2921,671,3592
"2019-03-21 10:10:10","2019-03-22 07:00:00","2019-03-22 07:30:00",3352,844,4196
"2019-03-21 10:10:10","2019-03-22 08:00:00","2019-03-22 08:30:00",3850,1056,4906
"2019-03-21 10:10:10","2019-03-22 09:00:00","2019-03-22 09:30:00",3999,1083,5082
"2019-03-21 10:10:10","2019-03-22 10:00:00","2019-03-22 10:30:00",4027,1113,5140
"2019-03-21 10:10:10","2019-03-22 11:00:00","2019-03-22 11:30:00",3989,1120,5109
"2019-03-21 10:10:10","2019-03-22 12:00:00","2019-03-22 12:30:00",3992,1132,5124
"2019-03-21 10:10:10","2019-03-22 13:00:00","2019-03-22 13:30:00",3934,1108,5042
"2019-03-21 10:10:10","2019-03-22 14:00:00","2019-03-22 14:30:00",3850,1025,4875
"2019-03-21 10:10:10","2019-03-22 15:00:00","2019-03-22 15:30:00",3797,1027,4824
"2019-03-21 10:10:10","2019-03-22 16:00:00","2019-03-22 16:30:00",3875,1035,4910
"2019-03-21 10:10:10","2019-03-22 17:00:00","2019-03-22 17:30:00",3952,1113,5065
"2019-03-21 10:10:10","2019-03-22 18:00:00","2019-03-22 18:30:00",4123,1170,5293
"2019-03-21 10:10:10","2019-03-22 19:00:00","2019-03-22 19:30:00",4340,1255,5595
"2019-03-21 10:10:10","2019-03-22 20:00:00","2019-03-22 20:30:00",4188,1171,5359
"2019-03-21 10:10:10","2019-03-22 21:00:00","2019-03-22 21:30:00",3940,1081,5021
"2019-03-21 10:10:10","2019-03-22 22:00:00","2019-03-22 22:30:00",3572,954,4526
"2019-03-22 10:10:26","2019-03-22 23:00:00","2019-03-22 23:30:00",3340,838,4178
"2019-03-22 10:10:26","2019-03-23 00:00:00","2019-03-23 00:30:00",3255,742,3997
"2019-03-22 10:10:26","2019-03-23 01:00:00","2019-03-23 01:30:00",3006,683,3689
"2019-03-22 10:10:26","2019-03-23 02:00:00","2019-03-23 02:30:00",2835,665,3500
"2019-03-22 10:10:26","2019-03-23 03:00:00","2019-03-23 03:30:00",2699,634,3333
"2019-03-22 10:10:26","2019-03-23 04:00:00","2019-03-23 04:30:00",2608,630,3238
"2019-03-22 10:10:26","2019-03-23 05:00:00","2019-03-23 05:30:00",2583,642,3225
"2019-03-22 10:10:26","2019-03-23 06:00:00","2019-03-23 06:30:00",2655,678,3333
"2019-03-22 10:10:26","2019-03-23 07:00:00","2019-03-23 07:30:00",2786,749,3535
"2019-03-22 10:10:26","2019-03-23 08:00:00","2019-03-23 08:30:00",3055,880,3935
"2019-03-22 10:10:26","2019-03-23 09:00:00","2019-03-23 09:30:00",3392,1017,4409
"2019-03-22 10:10:26","2019-03-23 10:00:00","2019-03-23 10:30:00",3578,1059,4637
"2019-03-22 10:10:26","2019-03-23 11:00:00","2019-03-23 11:30:00",3698,1042,4740
"2019-03-22 10:10:26","2019-03-23 12:00:00","2019-03-23 12:30:00",3733,1065,4798
"2019-03-22 10:10:26","2019-03-23 13:00:00","2019-03-23 13:30:00",3682,989,4671
"2019-03-22 10:10:26","2019-03-23 14:00:00","2019-03-23 14:30:00",3602,950,4552
"2019-03-22 10:10:26","2019-03-23 15:00:00","2019-03-23 15:30:00",3534,908,4442
"2019-03-22 10:10:26","2019-03-23 16:00:00","2019-03-23 16:30:00",3510,955,4465
"2019-03-22 10:10:26","2019-03-23 17:00:00","2019-03-23 17:30:00",3624,1030,4654
"2019-03-22 10:10:26","2019-03-23 18:00:00","2019-03-23 18:30:00",3736,1066,4802
"2019-03-22 10:10:26","2019-03-23 19:00:00","2019-03-23 19:30:00",3920,1146,5066
"2019-03-22 10:10:26","2019-03-23 20:00:00","2019-03-23 20:30:00",3767,1070,4837
"2019-03-22 10:10:26","2019-03-23 21:00:00","2019-03-23 21:30:00",3618,972,4590
"2019-03-22 10:10:26","2019-03-23 22:00:00","2019-03-23 22:30:00",3336,900,4236
"2019-03-23 10:10:15","2019-03-23 23:00:00","2019-03-23 23:30:00",3180,778,3958
"2019-03-23 10:10:15","2019-03-24 00:00:00","2019-03-24 00:30:00",3049,688,3737
"2019-03-23 10:10:15","2019-03-24 01:00:00","2019-03-24 01:30:00",2875,647,3522
"2019-03-23 10:10:15","2019-03-24 02:00:00","2019-03-24 02:30:00",2720,620,3340
"2019-03-23 10:10:15","2019-03-24 03:00:00","2019-03-24 03:30:00",2563,602,3165
"2019-03-23 10:10:15","2019-03-24 04:00:00","2019-03-24 04:30:00",2531,591,3122
"2019-03-23 10:10:15","2019-03-24 05:00:00","2019-03-24 05:30:00",2493,590,3083
"2019-03-23 10:10:15","2019-03-24 06:00:00","2019-03-24 06:30:00",2516,589,3105
"2019-03-23 10:10:15","2019-03-24 07:00:00","2019-03-24 07:30:00",2585,617,3202
"2019-03-23 10:10:15","2019-03-24 08:00:00","2019-03-24 08:30:00",2798,691,3489
"2019-03-23 10:10:15","2019-03-24 09:00:00","2019-03-24 09:30:00",3062,799,3861
"2019-03-23 10:10:15","2019-03-24 10:00:00","2019-03-24 10:30:00",3356,888,4244
"2019-03-23 10:10:15","2019-03-24 11:00:00","2019-03-24 11:30:00",3390,925,4315
"2019-03-23 10:10:15","2019-03-24 12:00:00","2019-03-24 12:30:00",3425,948,4373
"2019-03-23 10:10:15","2019-03-24 13:00:00","2019-03-24 13:30:00",3383,970,4353
"2019-03-23 10:10:15","2019-03-24 14:00:00","2019-03-24 14:30:00",3340,884,4224
"2019-03-23 10:10:15","2019-03-24 15:00:00","2019-03-24 15:30:00",3262,870,4132
"2019-03-23 10:10:15","2019-03-24 16:00:00","2019-03-24 16:30:00",3230,860,4090
"2019-03-23 10:10:15","2019-03-24 17:00:00","2019-03-24 17:30:00",3291,961,4252
"2019-03-23 10:10:15","2019-03-24 18:00:00","2019-03-24 18:30:00",3381,1003,4384
"2019-03-23 10:10:15","2019-03-24 19:00:00","2019-03-24 19:30:00",3553,1054,4607
"2019-03-23 10:10:15","2019-03-24 20:00:00","2019-03-24 20:30:00",3460,1024,4484
"2019-03-23 10:10:15","2019-03-24 21:00:00","2019-03-24 21:30:00",3287,973,4260
"2019-03-23 10:10:15","2019-03-24 22:00:00","2019-03-24 22:30:00",3067,874,3941
"2019-03-24 10:10:26","2019-03-24 23:00:00","2019-03-24 23:30:00",3092,797,3889
"2019-03-24 10:10:26","2019-03-25 00:00:00","2019-03-25 00:30:00",3020,691,3711
"2019-03-24 10:10:26","2019-03-25 01:00:00","2019-03-25 01:30:00",2812,647,3459
"2019-03-24 10:10:26","2019-03-25 02:00:00","2019-03-25 02:30:00",2693,631,3324
"2019-03-24 10:10:26","2019-03-25 03:00:00","2019-03-25 03:30:00",2620,632,3252
"2019-03-24 10:10:26","2019-03-25 04:00:00","2019-03-25 04:30:00",2590,630,3220
"2019-03-24 10:10:26","2019-03-25 05:00:00","2019-03-25 05:30:00",2634,647,3281
"2019-03-24 10:10:26","2019-03-25 06:00:00","2019-03-25 06:30:00",2821,668,3489
"2019-03-24 10:10:26","2019-03-25 07:00:00","2019-03-25 07:30:00",3266,774,4040
"2019-03-24 10:10:26","2019-03-25 08:00:00","2019-03-25 08:30:00",3739,909,4648
"2019-03-24 10:10:26","2019-03-25 09:00:00","2019-03-25 09:30:00",3882,974,4856
"2019-03-24 10:10:26","2019-03-25 10:00:00","2019-03-25 10:30:00",4013,1087,5100
"2019-03-24 10:10:26","2019-03-25 11:00:00","2019-03-25 11:30:00",4000,1116,5116
"2019-03-24 10:10:26","2019-03-25 12:00:00","2019-03-25 12:30:00",3998,1109,5107
"2019-03-24 10:10:26","2019-03-25 13:00:00","2019-03-25 13:30:00",4012,1132,5144
"2019-03-24 10:10:26","2019-03-25 14:00:00","2019-03-25 14:30:00",3909,1099,5008
"2019-03-24 10:10:26","2019-03-25 15:00:00","2019-03-25 15:30:00",3921,1044,4965
"2019-03-24 10:10:26","2019-03-25 16:00:00","2019-03-25 16:30:00",3993,1112,5105
"2019-03-24 10:10:26","2019-03-25 17:00:00","2019-03-25 17:30:00",4102,1195,5297
"2019-03-24 10:10:26","2019-03-25 18:00:00","2019-03-25 18:30:00",4161,1228,5389
"2019-03-24 10:10:26","2019-03-25 19:00:00","2019-03-25 19:30:00",4385,1255,5640
"2019-03-24 10:10:26","2019-03-25 20:00:00","2019-03-25 20:30:00",4306,1242,5548
"2019-03-24 10:10:26","2019-03-25 21:00:00","2019-03-25 21:30:00",4072,1133,5205
"2019-03-24 10:10:26","2019-03-25 22:00:00","2019-03-25 22:30:00",3701,1003,4704
"2019-03-25 10:10:11","2019-03-25 23:00:00","2019-03-25 23:30:00",3388,930,4318
"2019-03-25 10:10:11","2019-03-26 00:00:00","2019-03-26 00:30:00",3124,757,3881
"2019-03-25 10:10:11","2019-03-26 01:00:00","2019-03-26 01:30:00",2941,686,3627
"2019-03-25 10:10:11","2019-03-26 02:00:00","2019-03-26 02:30:00",2768,692,3460
"2019-03-25 10:10:11","2019-03-26 03:00:00","2019-03-26 03:30:00",2691,657,3348
"2019-03-25 10:10:11","2019-03-26 04:00:00","2019-03-26 04:30:00",2670,656,3326
"2019-03-25 10:10:11","2019-03-26 05:00:00","2019-03-26 05:30:00",2710,655,3365
"2019-03-25 10:10:11","2019-03-26 06:00:00","2019-03-26 06:30:00",2924,750,3674
"2019-03-25 10:10:11","2019-03-26 07:00:00","2019-03-26 07:30:00",3373,926,4299
"2019-03-25 10:10:11","2019-03-26 08:00:00","2019-03-26 08:30:00",3868,1094,4962
"2019-03-25 10:10:11","2019-03-26 09:00:00","2019-03-26 09:30:00",3942,1155,5097
"2019-03-25 10:10:11","2019-03-26 10:00:00","2019-03-26 10:30:00",3971,1134,5105
"2019-03-25 10:10:11","2019-03-26 11:00:00","2019-03-26 11:30:00",3943,1149,5092
"2019-03-25 10:10:11","2019-03-26 12:00:00","2019-03-26 12:30:00",3917,1128,5045
"2019-03-25 10:10:11","2019-03-26 13:00:00","2019-03-26 13:30:00",3963,1101,5064
"2019-03-25 10:10:11","2019-03-26 14:00:00","2019-03-26 14:30:00",3876,1096,4972
"2019-03-25 10:10:11","2019-03-26 15:00:00","2019-03-26 15:30:00",3890,1094,4984
"2019-03-25 10:10:11","2019-03-26 16:00:00","2019-03-26 16:30:00",3935,1112,5047
"2019-03-25 10:10:11","2019-03-26 17:00:00","2019-03-26 17:30:00",4072,1222,5294
"2019-03-25 10:10:11","2019-03-26 18:00:00","2019-03-26 18:30:00",4261,1233,5494
"2019-03-25 10:10:11","2019-03-26 19:00:00","2019-03-26 19:30:00",4400,1275,5675
"2019-03-25 10:10:11","2019-03-26 20:00:00","2019-03-26 20:30:00",4323,1224,5547
"2019-03-25 10:10:11","2019-03-26 21:00:00","2019-03-26 21:30:00",4088,1162,5250
"2019-03-25 10:10:11","2019-03-26 22:00:00","2019-03-26 22:30:00",3698,1024,4722
"2019-03-26 10:10:36","2019-03-26 23:00:00","2019-03-26 23:30:00",3368,868,4236
"2019-03-26 10:10:36","2019-03-27 00:00:00","2019-03-27 00:30:00",3123,764,3887
"2019-03-26 10:10:36","2019-03-27 01:00:00","2019-03-27 01:30:00",2945,680,3625
"2019-03-26 10:10:36","2019-03-27 02:00:00","2019-03-27 02:30:00",2776,680,3456
"2019-03-26 10:10:36","2019-03-27 03:00:00","2019-03-27 03:30:00",2700,647,3347
"2019-03-26 10:10:36","2019-03-27 04:00:00","2019-03-27 04:30:00",2680,660,3340
"2019-03-26 10:10:36","2019-03-27 05:00:00","2019-03-27 05:30:00",2719,658,3377
"2019-03-26 10:10:36","2019-03-27 06:00:00","2019-03-27 06:30:00",2929,743,3672
"2019-03-26 10:10:36","2019-03-27 07:00:00","2019-03-27 07:30:00",3367,918,4285
"2019-03-26 10:10:36","2019-03-27 08:00:00","2019-03-27 08:30:00",3851,1104,4955
"2019-03-26 10:10:36","2019-03-27 09:00:00","2019-03-27 09:30:00",3923,1154,5077
"2019-03-26 10:10:36","2019-03-27 10:00:00","2019-03-27 10:30:00",3951,1155,5106
"2019-03-26 10:10:36","2019-03-27 11:00:00","2019-03-27 11:30:00",3924,1152,5076
"2019-03-26 10:10:36","2019-03-27 12:00:00","2019-03-27 12:30:00",3898,1132,5030
"2019-03-26 10:10:36","2019-03-27 13:00:00","2019-03-27 13:30:00",3943,1106,5049
"2019-03-26 10:10:36","2019-03-27 14:00:00","2019-03-27 14:30:00",3858,1099,4957
"2019-03-26 10:10:36","2019-03-27 15:00:00","2019-03-27 15:30:00",3872,1098,4970
"2019-03-26 10:10:36","2019-03-27 16:00:00","2019-03-27 16:30:00",3915,1146,5061
"2019-03-26 10:10:36","2019-03-27 17:00:00","2019-03-27 17:30:00",4049,1246,5295
"2019-03-26 10:10:36","2019-03-27 18:00:00","2019-03-27 18:30:00",4235,1262,5497
"2019-03-26 10:10:36","2019-03-27 19:00:00","2019-03-27 19:30:00",4370,1313,5683
"2019-03-26 10:10:36","2019-03-27 20:00:00","2019-03-27 20:30:00",4295,1243,5538
"2019-03-26 10:10:36","2019-03-27 21:00:00","2019-03-27 21:30:00",4065,1196,5261
"2019-03-26 10:10:36","2019-03-27 22:00:00","2019-03-27 22:30:00",3684,1056,4740
"2019-03-27 10:10:16","2019-03-27 23:00:00","2019-03-27 23:30:00",3368,868,4236
"2019-03-27 10:10:16","2019-03-28 00:00:00","2019-03-28 00:30:00",3146,748,3894
"2019-03-27 10:10:16","2019-03-28 01:00:00","2019-03-28 01:30:00",2966,683,3649
"2019-03-27 10:10:16","2019-03-28 02:00:00","2019-03-28 02:30:00",2796,676,3472
"2019-03-27 10:10:16","2019-03-28 03:00:00","2019-03-28 03:30:00",2721,646,3367
"2019-03-27 10:10:16","2019-03-28 04:00:00","2019-03-28 04:30:00",2700,652,3352
"2019-03-27 10:10:16","2019-03-28 05:00:00","2019-03-28 05:30:00",2739,657,3396
"2019-03-27 10:10:16","2019-03-28 06:00:00","2019-03-28 06:30:00",2950,745,3695
"2019-03-27 10:10:16","2019-03-28 07:00:00","2019-03-28 07:30:00",3391,900,4291
"2019-03-27 10:10:16","2019-03-28 08:00:00","2019-03-28 08:30:00",3877,1086,4963
"2019-03-27 10:10:16","2019-03-28 09:00:00","2019-03-28 09:30:00",3950,1140,5090
"2019-03-27 10:10:16","2019-03-28 10:00:00","2019-03-28 10:30:00",3979,1147,5126
"2019-03-27 10:10:16","2019-03-28 11:00:00","2019-03-28 11:30:00",3951,1148,5099
"2019-03-27 10:10:16","2019-03-28 12:00:00","2019-03-28 12:30:00",3925,1125,5050
"2019-03-27 10:10:16","2019-03-28 13:00:00","2019-03-28 13:30:00",3971,1104,5075
"2019-03-27 10:10:16","2019-03-28 14:00:00","2019-03-28 14:30:00",3885,1062,4947
"2019-03-27 10:10:16","2019-03-28 15:00:00","2019-03-28 15:30:00",3899,1087,4986
"2019-03-27 10:10:16","2019-03-28 16:00:00","2019-03-28 16:30:00",3943,1117,5060
"2019-03-27 10:10:16","2019-03-28 17:00:00","2019-03-28 17:30:00",4077,1213,5290
"2019-03-27 10:10:16","2019-03-28 18:00:00","2019-03-28 18:30:00",4264,1210,5474
"2019-03-27 10:10:16","2019-03-28 19:00:00","2019-03-28 19:30:00",4400,1241,5641
"2019-03-27 10:10:16","2019-03-28 20:00:00","2019-03-28 20:30:00",4324,1201,5525
"2019-03-27 10:10:16","2019-03-28 21:00:00","2019-03-28 21:30:00",4093,1128,5221
"2019-03-27 10:10:16","2019-03-28 22:00:00","2019-03-28 22:30:00",3710,1022,4732
"2019-03-28 10:10:20","2019-03-28 23:00:00","2019-03-28 23:30:00",3392,882,4274
"2019-03-28 10:10:20","2019-03-29 00:00:00","2019-03-29 00:30:00",3134,736,3870
"2019-03-28 10:10:20","2019-03-29 01:00:00","2019-03-29 01:30:00",2890,653,3543
"2019-03-28 10:10:20","2019-03-29 02:00:00","2019-03-29 02:30:00",2749,659,3408
"2019-03-28 10:10:20","2019-03-29 03:00:00","2019-03-29 03:30:00",2644,619,3263
"2019-03-28 10:10:20","2019-03-29 04:00:00","2019-03-29 04:30:00",2621,609,3230
"2019-03-28 10:10:20","2019-03-29 05:00:00","2019-03-29 05:30:00",2637,627,3264
"2019-03-28 10:10:20","2019-03-29 06:00:00","2019-03-29 06:30:00",2831,707,3538
"2019-03-28 10:10:20","2019-03-29 07:00:00","2019-03-29 07:30:00",3277,887,4164
"2019-03-28 10:10:20","2019-03-29 08:00:00","2019-03-29 08:30:00",3784,1103,4887
"2019-03-28 10:10:20","2019-03-29 09:00:00","2019-03-29 09:30:00",3876,1136,5012
"2019-03-28 10:10:20","2019-03-29 10:00:00","2019-03-29 10:30:00",3951,1132,5083
"2019-03-28 10:10:20","2019-03-29 11:00:00","2019-03-29 11:30:00",3911,1120,5031
"2019-03-28 10:10:20","2019-03-29 12:00:00","2019-03-29 12:30:00",3913,1111,5024
"2019-03-28 10:10:20","2019-03-29 13:00:00","2019-03-29 13:30:00",3913,1109,5022
"2019-03-28 10:10:20","2019-03-29 14:00:00","2019-03-29 14:30:00",3846,1048,4894
"2019-03-28 10:10:20","2019-03-29 15:00:00","2019-03-29 15:30:00",3793,992,4785
"2019-03-28 10:10:20","2019-03-29 16:00:00","2019-03-29 16:30:00",3821,1044,4865
"2019-03-28 10:10:20","2019-03-29 17:00:00","2019-03-29 17:30:00",3902,1108,5010
"2019-03-28 10:10:20","2019-03-29 18:00:00","2019-03-29 18:30:00",4014,1155,5169
"2019-03-28 10:10:20","2019-03-29 19:00:00","2019-03-29 19:30:00",4151,1222,5373
"2019-03-28 10:10:20","2019-03-29 20:00:00","2019-03-29 20:30:00",4101,1187,5288
"2019-03-28 10:10:20","2019-03-29 21:00:00","2019-03-29 21:30:00",3878,1098,4976
"2019-03-28 10:10:20","2019-03-29 22:00:00","2019-03-29 22:30:00",3549,986,4535
"2019-03-29 10:10:35","2019-03-29 23:00:00","2019-03-29 23:30:00",3206,908,4114
"2019-03-29 10:10:35","2019-03-30 00:00:00","2019-03-30 00:30:00",3118,714,3832
"2019-03-29 10:10:35","2019-03-30 01:00:00","2019-03-30 01:30:00",2900,660,3560
"2019-03-29 10:10:35","2019-03-30 02:00:00","2019-03-30 02:30:00",2731,630,3361
"2019-03-29 10:10:35","2019-03-30 03:00:00","2019-03-30 03:30:00",2640,614,3254
"2019-03-29 10:10:35","2019-03-30 04:00:00","2019-03-30 04:30:00",2614,597,3211
"2019-03-29 10:10:35","2019-03-30 05:00:00","2019-03-30 05:30:00",2615,607,3222
"2019-03-29 10:10:35","2019-03-30 06:00:00","2019-03-30 06:30:00",2686,641,3327
"2019-03-29 10:10:35","2019-03-30 07:00:00","2019-03-30 07:30:00",2827,706,3533
"2019-03-29 10:10:35","2019-03-30 08:00:00","2019-03-30 08:30:00",3139,847,3986
"2019-03-29 10:10:35","2019-03-30 09:00:00","2019-03-30 09:30:00",3426,979,4405
"2019-03-29 10:10:35","2019-03-30 10:00:00","2019-03-30 10:30:00",3573,1012,4585
"2019-03-29 10:10:35","2019-03-30 11:00:00","2019-03-30 11:30:00",3593,1001,4594
"2019-03-29 10:10:35","2019-03-30 12:00:00","2019-03-30 12:30:00",3574,1028,4602
"2019-03-29 10:10:35","2019-03-30 13:00:00","2019-03-30 13:30:00",3571,978,4549
"2019-03-29 10:10:35","2019-03-30 14:00:00","2019-03-30 14:30:00",3463,924,4387
"2019-03-29 10:10:35","2019-03-30 15:00:00","2019-03-30 15:30:00",3404,876,4280
"2019-03-29 10:10:35","2019-03-30 16:00:00","2019-03-30 16:30:00",3420,912,4332
"2019-03-29 10:10:35","2019-03-30 17:00:00","2019-03-30 17:30:00",3561,960,4521
"2019-03-29 10:10:35","2019-03-30 18:00:00","2019-03-30 18:30:00",3760,1051,4811
"2019-03-29 10:10:35","2019-03-30 19:00:00","2019-03-30 19:30:00",3885,1132,5017
"2019-03-29 10:10:35","2019-03-30 20:00:00","2019-03-30 20:30:00",3800,1092,4892
"2019-03-29 10:10:35","2019-03-30 21:00:00","2019-03-30 21:30:00",3573,1009,4582
"2019-03-29 10:10:35","2019-03-30 22:00:00","2019-03-30 22:30:00",3318,933,4251
"2019-03-30 10:10:26","2019-03-30 23:00:00","2019-03-30 23:30:00",3122,815,3937
"2019-03-30 10:10:26","2019-03-31 00:00:00","2019-03-31 00:30:00",3113,730,3843
"2019-03-30 10:10:26","2019-03-31 01:00:00","2019-03-31 01:30:00",2901,660,3561
"2019-03-30 10:10:26","2019-03-31 02:00:00","2019-03-31 02:30:00",2741,630,3371
"2019-03-30 10:10:26","2019-03-31 03:00:00","2019-03-31 03:30:00",2617,605,3222
"2019-03-30 10:10:26","2019-03-31 04:00:00","2019-03-31 04:30:00",2570,590,3160
"2019-03-30 10:10:26","2019-03-31 05:00:00","2019-03-31 05:30:00",2562,610,3172
"2019-03-30 10:10:26","2019-03-31 06:00:00","2019-03-31 06:30:00",2655,635,3290
"2019-03-30 10:10:26","2019-03-31 07:00:00","2019-03-31 07:30:00",2787,720,3507
"2019-03-30 10:10:26","2019-03-31 08:00:00","2019-03-31 08:30:00",3030,800,3830
"2019-03-30 10:10:26","2019-03-31 09:00:00","2019-03-31 09:30:00",3211,880,4091
"2019-03-30 10:10:26","2019-03-31 10:00:00","2019-03-31 10:30:00",3347,920,4267
"2019-03-30 10:10:26","2019-03-31 11:00:00","2019-03-31 11:30:00",3434,931,4365
"2019-03-30 10:10:26","2019-03-31 12:00:00","2019-03-31 12:30:00",3505,938,4443
"2019-03-30 10:10:26","2019-03-31 13:00:00","2019-03-31 13:30:00",3424,866,4290
"2019-03-30 10:10:26","2019-03-31 14:00:00","2019-03-31 14:30:00",3322,810,4132
"2019-03-30 10:10:26","2019-03-31 15:00:00","2019-03-31 15:30:00",3280,800,4080
"2019-03-30 10:10:26","2019-03-31 16:00:00","2019-03-31 16:30:00",3336,848,4184
"2019-03-30 10:10:26","2019-03-31 17:00:00","2019-03-31 17:30:00",3499,904,4403
"2019-03-30 10:10:26","2019-03-31 18:00:00","2019-03-31 18:30:00",3479,910,4389
"2019-03-30 10:10:26","2019-03-31 19:00:00","2019-03-31 19:30:00",3560,1009,4569
"2019-03-30 10:10:26","2019-03-31 20:00:00","2019-03-31 20:30:00",3660,1049,4709
"2019-03-30 10:10:26","2019-03-31 21:00:00","2019-03-31 21:30:00",3400,960,4360
"2019-03-30 10:10:26","2019-03-31 22:00:00","2019-03-31 22:30:00",3089,812,3901
"2019-03-31 10:10:10","2019-03-31 23:00:00","2019-03-31 23:30:00",2851,685,3536
"2019-03-31 10:10:10","2019-04-01 00:00:00","2019-04-01 00:30:00",2813,618,3431
"2019-03-31 10:10:10","2019-04-01 01:00:00","2019-04-01 01:30:00",2692,597,3289
"2019-03-31 10:10:10","2019-04-01 02:00:00","2019-04-01 02:30:00",2610,604,3214
"2019-03-31 10:10:10","2019-04-01 03:00:00","2019-04-01 03:30:00",2560,601,3161
"2019-03-31 10:10:10","2019-04-01 04:00:00","2019-04-01 04:30:00",2586,616,3202
"2019-03-31 10:10:10","2019-04-01 05:00:00","2019-04-01 05:30:00",2726,688,3414
"2019-03-31 10:10:10","2019-04-01 06:00:00","2019-04-01 06:30:00",3140,866,4006
"2019-03-31 10:10:10","2019-04-01 07:00:00","2019-04-01 07:30:00",3563,1049,4612
"2019-03-31 10:10:10","2019-04-01 08:00:00","2019-04-01 08:30:00",3878,1122,5000
"2019-03-31 10:10:10","2019-04-01 09:00:00","2019-04-01 09:30:00",3936,1139,5075
"2019-03-31 10:10:10","2019-04-01 10:00:00","2019-04-01 10:30:00",3963,1129,5092
"2019-03-31 10:10:10","2019-04-01 11:00:00","2019-04-01 11:30:00",3988,1113,5101
"2019-03-31 10:10:10","2019-04-01 12:00:00","2019-04-01 12:30:00",4023,1069,5092
"2019-03-31 10:10:10","2019-04-01 13:00:00","2019-04-01 13:30:00",3908,1016,4924
"2019-03-31 10:10:10","2019-04-01 14:00:00","2019-04-01 14:30:00",3881,1005,4886
"2019-03-31 10:10:10","2019-04-01 15:00:00","2019-04-01 15:30:00",3927,1045,4972
"2019-03-31 10:10:10","2019-04-01 16:00:00","2019-04-01 16:30:00",4016,1140,5156
"2019-03-31 10:10:10","2019-04-01 17:00:00","2019-04-01 17:30:00",4100,1141,5241
"2019-03-31 10:10:10","2019-04-01 18:00:00","2019-04-01 18:30:00",4043,1082,5125
"2019-03-31 10:10:10","2019-04-01 19:00:00","2019-04-01 19:30:00",4127,1112,5239
"2019-03-31 10:10:10","2019-04-01 20:00:00","2019-04-01 20:30:00",4047,1185,5232
"2019-03-31 10:10:10","2019-04-01 21:00:00","2019-04-01 21:30:00",3667,1055,4722
"2019-03-31 10:10:10","2019-04-01 22:00:00","2019-04-01 22:30:00",3248,883,4131
"2019-04-01 10:10:26","2019-04-01 23:00:00","2019-04-01 23:30:00",3265,883,4148
"2019-04-01 10:10:26","2019-04-02 00:00:00","2019-04-02 00:30:00",2936,756,3692
"2019-04-01 10:10:26","2019-04-02 01:00:00","2019-04-02 01:30:00",2879,710,3589
"2019-04-01 10:10:26","2019-04-02 02:00:00","2019-04-02 02:30:00",2728,695,3423
"2019-04-01 10:10:26","2019-04-02 03:00:00","2019-04-02 03:30:00",2645,658,3303
"2019-04-01 10:10:26","2019-04-02 04:00:00","2019-04-02 04:30:00",2600,659,3259
"2019-04-01 10:10:26","2019-04-02 05:00:00","2019-04-02 05:30:00",2644,673,3317
"2019-04-01 10:10:26","2019-04-02 06:00:00","2019-04-02 06:30:00",2798,750,3548
"2019-04-01 10:10:26","2019-04-02 07:00:00","2019-04-02 07:30:00",3332,931,4263
"2019-04-01 10:10:26","2019-04-02 08:00:00","2019-04-02 08:30:00",3907,1103,5010
"2019-04-01 10:10:26","2019-04-02 09:00:00","2019-04-02 09:30:00",4013,1143,5156
"2019-04-01 10:10:26","2019-04-02 10:00:00","2019-04-02 10:30:00",4017,1152,5169
"2019-04-01 10:10:26","2019-04-02 11:00:00","2019-04-02 11:30:00",3984,1147,5131
"2019-04-01 10:10:26","2019-04-02 12:00:00","2019-04-02 12:30:00",3934,1149,5083
"2019-04-01 10:10:26","2019-04-02 13:00:00","2019-04-02 13:30:00",3935,1171,5106
"2019-04-01 10:10:26","2019-04-02 14:00:00","2019-04-02 14:30:00",3855,1137,4992
"2019-04-01 10:10:26","2019-04-02 15:00:00","2019-04-02 15:30:00",3883,1129,5012
"2019-04-01 10:10:26","2019-04-02 16:00:00","2019-04-02 16:30:00",3945,1153,5098
"2019-04-01 10:10:26","2019-04-02 17:00:00","2019-04-02 17:30:00",4025,1230,5255
"2019-04-01 10:10:26","2019-04-02 18:00:00","2019-04-02 18:30:00",4077,1249,5326
"2019-04-01 10:10:26","2019-04-02 19:00:00","2019-04-02 19:30:00",3972,1140,5112
"2019-04-01 10:10:26","2019-04-02 20:00:00","2019-04-02 20:30:00",4070,1180,5250
"2019-04-01 10:10:26","2019-04-02 21:00:00","2019-04-02 21:30:00",4125,1210,5335
"2019-04-01 10:10:26","2019-04-02 22:00:00","2019-04-02 22:30:00",3770,1051,4821
"2019-04-02 10:10:15","2019-04-02 23:00:00","2019-04-02 23:30:00",3315,877,4192
"2019-04-02 10:10:15","2019-04-03 00:00:00","2019-04-03 00:30:00",2947,769,3716
"2019-04-02 10:10:15","2019-04-03 01:00:00","2019-04-03 01:30:00",2888,692,3580
"2019-04-02 10:10:15","2019-04-03 02:00:00","2019-04-03 02:30:00",2732,668,3400
"2019-04-02 10:10:15","2019-04-03 03:00:00","2019-04-03 03:30:00",2646,639,3285
"2019-04-02 10:10:15","2019-04-03 04:00:00","2019-04-03 04:30:00",2600,642,3242
"2019-04-02 10:10:15","2019-04-03 05:00:00","2019-04-03 05:30:00",2646,657,3303
"2019-04-02 10:10:15","2019-04-03 06:00:00","2019-04-03 06:30:00",2804,750,3554
"2019-04-02 10:10:15","2019-04-03 07:00:00","2019-04-03 07:30:00",3356,930,4286
"2019-04-02 10:10:15","2019-04-03 08:00:00","2019-04-03 08:30:00",3949,1130,5079
"2019-04-02 10:10:15","2019-04-03 09:00:00","2019-04-03 09:30:00",4058,1180,5238
"2019-04-02 10:10:15","2019-04-03 10:00:00","2019-04-03 10:30:00",4062,1205,5267
"2019-04-02 10:10:15","2019-04-03 11:00:00","2019-04-03 11:30:00",4029,1220,5249
"2019-04-02 10:10:15","2019-04-03 12:00:00","2019-04-03 12:30:00",3977,1230,5207
"2019-04-02 10:10:15","2019-04-03 13:00:00","2019-04-03 13:30:00",3978,1210,5188
"2019-04-02 10:10:15","2019-04-03 14:00:00","2019-04-03 14:30:00",3895,1171,5066
"2019-04-02 10:10:15","2019-04-03 15:00:00","2019-04-03 15:30:00",3925,1155,5080
"2019-04-02 10:10:15","2019-04-03 16:00:00","2019-04-03 16:30:00",3988,1171,5159
"2019-04-02 10:10:15","2019-04-03 17:00:00","2019-04-03 17:30:00",4071,1230,5301
"2019-04-02 10:10:15","2019-04-03 18:00:00","2019-04-03 18:30:00",4125,1266,5391
"2019-04-02 10:10:15","2019-04-03 19:00:00","2019-04-03 19:30:00",4016,1140,5156
"2019-04-02 10:10:15","2019-04-03 20:00:00","2019-04-03 20:30:00",4118,1180,5298
"2019-04-02 10:10:15","2019-04-03 21:00:00","2019-04-03 21:30:00",4174,1210,5384
"2019-04-02 10:10:15","2019-04-03 22:00:00","2019-04-03 22:30:00",3808,1059,4867
"2019-04-03 10:10:30","2019-04-03 23:00:00","2019-04-03 23:30:00",3338,875,4213
"2019-04-03 10:10:30","2019-04-04 00:00:00","2019-04-04 00:30:00",2947,738,3685
"2019-04-03 10:10:30","2019-04-04 01:00:00","2019-04-04 01:30:00",2888,681,3569
"2019-04-03 10:10:30","2019-04-04 02:00:00","2019-04-04 02:30:00",2732,660,3392
"2019-04-03 10:10:30","2019-04-04 03:00:00","2019-04-04 03:30:00",2646,651,3297
"2019-04-03 10:10:30","2019-04-04 04:00:00","2019-04-04 04:30:00",2640,648,3288
"2019-04-03 10:10:30","2019-04-04 05:00:00","2019-04-04 05:30:00",2646,648,3294
"2019-04-03 10:10:30","2019-04-04 06:00:00","2019-04-04 06:30:00",2804,742,3546
"2019-04-03 10:10:30","2019-04-04 07:00:00","2019-04-04 07:30:00",3356,904,4260
"2019-04-03 10:10:30","2019-04-04 08:00:00","2019-04-04 08:30:00",3949,1082,5031
"2019-04-03 10:10:30","2019-04-04 09:00:00","2019-04-04 09:30:00",4058,1126,5184
"2019-04-03 10:10:30","2019-04-04 10:00:00","2019-04-04 10:30:00",4062,1141,5203
"2019-04-03 10:10:30","2019-04-04 11:00:00","2019-04-04 11:30:00",4029,1164,5193
"2019-04-03 10:10:30","2019-04-04 12:00:00","2019-04-04 12:30:00",3977,1127,5104
"2019-04-03 10:10:30","2019-04-04 13:00:00","2019-04-04 13:30:00",3978,1119,5097
"2019-04-03 10:10:30","2019-04-04 14:00:00","2019-04-04 14:30:00",3895,1076,4971
"2019-04-03 10:10:30","2019-04-04 15:00:00","2019-04-04 15:30:00",3925,1053,4978
"2019-04-03 10:10:30","2019-04-04 16:00:00","2019-04-04 16:30:00",3988,1113,5101
"2019-04-03 10:10:30","2019-04-04 17:00:00","2019-04-04 17:30:00",4071,1196,5267
"2019-04-03 10:10:30","2019-04-04 18:00:00","2019-04-04 18:30:00",4125,1196,5321
"2019-04-03 10:10:30","2019-04-04 19:00:00","2019-04-04 19:30:00",4016,1149,5165
"2019-04-03 10:10:30","2019-04-04 20:00:00","2019-04-04 20:30:00",4118,1180,5298
"2019-04-03 10:10:30","2019-04-04 21:00:00","2019-04-04 21:30:00",4120,1147,5267
"2019-04-03 10:10:30","2019-04-04 22:00:00","2019-04-04 22:30:00",3808,1002,4810
"2019-04-04 10:10:21","2019-04-04 23:00:00","2019-04-04 23:30:00",3386,970,4356
"2019-04-04 10:10:21","2019-04-05 00:00:00","2019-04-05 00:30:00",3022,742,3764
"2019-04-04 10:10:21","2019-04-05 01:00:00","2019-04-05 01:30:00",2959,673,3632
"2019-04-04 10:10:21","2019-04-05 02:00:00","2019-04-05 02:30:00",2822,643,3465
"2019-04-04 10:10:21","2019-04-05 03:00:00","2019-04-05 03:30:00",2666,627,3293
"2019-04-04 10:10:21","2019-04-05 04:00:00","2019-04-05 04:30:00",2610,630,3240
"2019-04-04 10:10:21","2019-04-05 05:00:00","2019-04-05 05:30:00",2647,624,3271
"2019-04-04 10:10:21","2019-04-05 06:00:00","2019-04-05 06:30:00",2768,760,3528
"2019-04-04 10:10:21","2019-04-05 07:00:00","2019-04-05 07:30:00",3261,930,4191
"2019-04-04 10:10:21","2019-04-05 08:00:00","2019-04-05 08:30:00",3798,1151,4949
"2019-04-04 10:10:21","2019-04-05 09:00:00","2019-04-05 09:30:00",3901,1178,5079
"2019-04-04 10:10:21","2019-04-05 10:00:00","2019-04-05 10:30:00",3956,1190,5146
"2019-04-04 10:10:21","2019-04-05 11:00:00","2019-04-05 11:30:00",3969,1182,5151
"2019-04-04 10:10:21","2019-04-05 12:00:00","2019-04-05 12:30:00",3935,1179,5114
"2019-04-04 10:10:21","2019-04-05 13:00:00","2019-04-05 13:30:00",3952,1170,5122
"2019-04-04 10:10:21","2019-04-05 14:00:00","2019-04-05 14:30:00",3817,1135,4952
"2019-04-04 10:10:21","2019-04-05 15:00:00","2019-04-05 15:30:00",3808,1105,4913
"2019-04-04 10:10:21","2019-04-05 16:00:00","2019-04-05 16:30:00",3827,1110,4937
"2019-04-04 10:10:21","2019-04-05 17:00:00","2019-04-05 17:30:00",3901,1170,5071
"2019-04-04 10:10:21","2019-04-05 18:00:00","2019-04-05 18:30:00",3967,1181,5148
"2019-04-04 10:10:21","2019-04-05 19:00:00","2019-04-05 19:30:00",3867,1187,5054
"2019-04-04 10:10:21","2019-04-05 20:00:00","2019-04-05 20:30:00",3855,1190,5045
"2019-04-04 10:10:21","2019-04-05 21:00:00","2019-04-05 21:30:00",3981,1095,5076
"2019-04-04 10:10:21","2019-04-05 22:00:00","2019-04-05 22:30:00",3661,975,4636
"2019-04-05 10:10:35","2019-04-05 23:00:00","2019-04-05 23:30:00",3323,900,4223
"2019-04-05 10:10:35","2019-04-06 00:00:00","2019-04-06 00:30:00",3077,714,3791
"2019-04-05 10:10:35","2019-04-06 01:00:00","2019-04-06 01:30:00",2991,665,3656
"2019-04-05 10:10:35","2019-04-06 02:00:00","2019-04-06 02:30:00",2807,620,3427
"2019-04-05 10:10:35","2019-04-06 03:00:00","2019-04-06 03:30:00",2660,589,3249
"2019-04-05 10:10:35","2019-04-06 04:00:00","2019-04-06 04:30:00",2609,589,3198
"2019-04-05 10:10:35","2019-04-06 05:00:00","2019-04-06 05:30:00",2601,589,3190
"2019-04-05 10:10:35","2019-04-06 06:00:00","2019-04-06 06:30:00",2670,613,3283
"2019-04-05 10:10:35","2019-04-06 07:00:00","2019-04-06 07:30:00",2827,688,3515
"2019-04-05 10:10:35","2019-04-06 08:00:00","2019-04-06 08:30:00",3098,818,3916
"2019-04-05 10:10:35","2019-04-06 09:00:00","2019-04-06 09:30:00",3437,915,4352
"2019-04-05 10:10:35","2019-04-06 10:00:00","2019-04-06 10:30:00",3608,972,4580
"2019-04-05 10:10:35","2019-04-06 11:00:00","2019-04-06 11:30:00",3678,973,4651
"2019-04-05 10:10:35","2019-04-06 12:00:00","2019-04-06 12:30:00",3694,957,4651
"2019-04-05 10:10:35","2019-04-06 13:00:00","2019-04-06 13:30:00",3696,924,4620
"2019-04-05 10:10:35","2019-04-06 14:00:00","2019-04-06 14:30:00",3582,894,4476
"2019-04-05 10:10:35","2019-04-06 15:00:00","2019-04-06 15:30:00",3527,828,4355
"2019-04-05 10:10:35","2019-04-06 16:00:00","2019-04-06 16:30:00",3525,845,4370
"2019-04-05 10:10:35","2019-04-06 17:00:00","2019-04-06 17:30:00",3604,928,4532
"2019-04-05 10:10:35","2019-04-06 18:00:00","2019-04-06 18:30:00",3735,1008,4743
"2019-04-05 10:10:35","2019-04-06 19:00:00","2019-04-06 19:30:00",3669,1023,4692
"2019-04-05 10:10:35","2019-04-06 20:00:00","2019-04-06 20:30:00",3605,1042,4647
"2019-04-05 10:10:35","2019-04-06 21:00:00","2019-04-06 21:30:00",3701,962,4663
"2019-04-05 10:10:35","2019-04-06 22:00:00","2019-04-06 22:30:00",3476,860,4336
"2019-04-06 10:10:20","2019-04-06 23:00:00","2019-04-06 23:30:00",3190,873,4063
"2019-04-06 10:10:20","2019-04-07 00:00:00","2019-04-07 00:30:00",3069,694,3763
"2019-04-06 10:10:20","2019-04-07 01:00:00","2019-04-07 01:30:00",2995,636,3631
"2019-04-06 10:10:20","2019-04-07 02:00:00","2019-04-07 02:30:00",2822,634,3456
"2019-04-06 10:10:20","2019-04-07 03:00:00","2019-04-07 03:30:00",2710,605,3315
"2019-04-06 10:10:20","2019-04-07 04:00:00","2019-04-07 04:30:00",2622,583,3205
"2019-04-06 10:10:20","2019-04-07 05:00:00","2019-04-07 05:30:00",2600,575,3175
"2019-04-06 10:10:20","2019-04-07 06:00:00","2019-04-07 06:30:00",2614,620,3234
"2019-04-06 10:10:20","2019-04-07 07:00:00","2019-04-07 07:30:00",2661,660,3321
"2019-04-06 10:10:20","2019-04-07 08:00:00","2019-04-07 08:30:00",2879,750,3629
"2019-04-06 10:10:20","2019-04-07 09:00:00","2019-04-07 09:30:00",3155,840,3995
"2019-04-06 10:10:20","2019-04-07 10:00:00","2019-04-07 10:30:00",3346,895,4241
"2019-04-06 10:10:20","2019-04-07 11:00:00","2019-04-07 11:30:00",3514,930,4444
"2019-04-06 10:10:20","2019-04-07 12:00:00","2019-04-07 12:30:00",3582,960,4542
"2019-04-06 10:10:20","2019-04-07 13:00:00","2019-04-07 13:30:00",3650,990,4640
"2019-04-06 10:10:20","2019-04-07 14:00:00","2019-04-07 14:30:00",3544,930,4474
"2019-04-06 10:10:20","2019-04-07 15:00:00","2019-04-07 15:30:00",3404,910,4314
"2019-04-06 10:10:20","2019-04-07 16:00:00","2019-04-07 16:30:00",3350,940,4290
"2019-04-06 10:10:20","2019-04-07 17:00:00","2019-04-07 17:30:00",3355,1015,4370
"2019-04-06 10:10:20","2019-04-07 18:00:00","2019-04-07 18:30:00",3397,1020,4417
"2019-04-06 10:10:20","2019-04-07 19:00:00","2019-04-07 19:30:00",3371,980,4351
"2019-04-06 10:10:20","2019-04-07 20:00:00","2019-04-07 20:30:00",3429,1001,4430
"2019-04-06 10:10:20","2019-04-07 21:00:00","2019-04-07 21:30:00",3492,1035,4527
"2019-04-06 10:10:20","2019-04-07 22:00:00","2019-04-07 22:30:00",3323,970,4293
"2019-04-07 10:10:35","2019-04-07 23:00:00","2019-04-07 23:30:00",3029,849,3878
"2019-04-07 10:10:35","2019-04-08 00:00:00","2019-04-08 00:30:00",2865,687,3552
"2019-04-07 10:10:35","2019-04-08 01:00:00","2019-04-08 01:30:00",2790,614,3404
"2019-04-07 10:10:35","2019-04-08 02:00:00","2019-04-08 02:30:00",2673,609,3282
"2019-04-07 10:10:35","2019-04-08 03:00:00","2019-04-08 03:30:00",2590,627,3217
"2019-04-07 10:10:35","2019-04-08 04:00:00","2019-04-08 04:30:00",2550,603,3153
"2019-04-07 10:10:35","2019-04-08 05:00:00","2019-04-08 05:30:00",2595,650,3245
"2019-04-07 10:10:35","2019-04-08 06:00:00","2019-04-08 06:30:00",2807,760,3567
"2019-04-07 10:10:35","2019-04-08 07:00:00","2019-04-08 07:30:00",3270,980,4250
"2019-04-07 10:10:35","2019-04-08 08:00:00","2019-04-08 08:30:00",3844,1130,4974
"2019-04-07 10:10:35","2019-04-08 09:00:00","2019-04-08 09:30:00",4013,1185,5198
"2019-04-07 10:10:35","2019-04-08 10:00:00","2019-04-08 10:30:00",4020,1193,5213
"2019-04-07 10:10:35","2019-04-08 11:00:00","2019-04-08 11:30:00",4019,1195,5214
"2019-04-07 10:10:35","2019-04-08 12:00:00","2019-04-08 12:30:00",4028,1190,5218
"2019-04-07 10:10:35","2019-04-08 13:00:00","2019-04-08 13:30:00",4045,1160,5205
"2019-04-07 10:10:35","2019-04-08 14:00:00","2019-04-08 14:30:00",3938,1100,5038
"2019-04-07 10:10:35","2019-04-08 15:00:00","2019-04-08 15:30:00",3962,1060,5022
"2019-04-07 10:10:35","2019-04-08 16:00:00","2019-04-08 16:30:00",4016,1145,5161
"2019-04-07 10:10:35","2019-04-08 17:00:00","2019-04-08 17:30:00",4128,1218,5346
"2019-04-07 10:10:35","2019-04-08 18:00:00","2019-04-08 18:30:00",4227,1180,5407
"2019-04-07 10:10:35","2019-04-08 19:00:00","2019-04-08 19:30:00",4085,1100,5185
"2019-04-07 10:10:35","2019-04-08 20:00:00","2019-04-08 20:30:00",4128,1120,5248
"2019-04-07 10:10:35","2019-04-08 21:00:00","2019-04-08 21:30:00",4124,1150,5274
"2019-04-07 10:10:35","2019-04-08 22:00:00","2019-04-08 22:30:00",3708,1000,4708
"2019-04-08 10:10:21","2019-04-08 23:00:00","2019-04-08 23:30:00",3289,875,4164
"2019-04-08 10:10:21","2019-04-09 00:00:00","2019-04-09 00:30:00",3033,682,3715
"2019-04-08 10:10:21","2019-04-09 01:00:00","2019-04-09 01:30:00",2950,626,3576
"2019-04-08 10:10:21","2019-04-09 02:00:00","2019-04-09 02:30:00",2815,601,3416
"2019-04-08 10:10:21","2019-04-09 03:00:00","2019-04-09 03:30:00",2712,618,3330
"2019-04-08 10:10:21","2019-04-09 04:00:00","2019-04-09 04:30:00",2664,604,3268
"2019-04-08 10:10:21","2019-04-09 05:00:00","2019-04-09 05:30:00",2674,618,3292
"2019-04-08 10:10:21","2019-04-09 06:00:00","2019-04-09 06:30:00",2875,693,3568
"2019-04-08 10:10:21","2019-04-09 07:00:00","2019-04-09 07:30:00",3380,868,4248
"2019-04-08 10:10:21","2019-04-09 08:00:00","2019-04-09 08:30:00",3989,1036,5025
"2019-04-08 10:10:21","2019-04-09 09:00:00","2019-04-09 09:30:00",4087,1074,5161
"2019-04-08 10:10:21","2019-04-09 10:00:00","2019-04-09 10:30:00",4078,1072,5150
"2019-04-08 10:10:21","2019-04-09 11:00:00","2019-04-09 11:30:00",4022,1055,5077
"2019-04-08 10:10:21","2019-04-09 12:00:00","2019-04-09 12:30:00",4007,1049,5056
"2019-04-08 10:10:21","2019-04-09 13:00:00","2019-04-09 13:30:00",3997,1053,5050
"2019-04-08 10:10:21","2019-04-09 14:00:00","2019-04-09 14:30:00",3921,1005,4926
"2019-04-08 10:10:21","2019-04-09 15:00:00","2019-04-09 15:30:00",3929,999,4928
"2019-04-08 10:10:21","2019-04-09 16:00:00","2019-04-09 16:30:00",4017,1063,5080
"2019-04-08 10:10:21","2019-04-09 17:00:00","2019-04-09 17:30:00",4179,1153,5332
"2019-04-08 10:10:21","2019-04-09 18:00:00","2019-04-09 18:30:00",4280,1154,5434
"2019-04-08 10:10:21","2019-04-09 19:00:00","2019-04-09 19:30:00",4170,1146,5316
"2019-04-08 10:10:21","2019-04-09 20:00:00","2019-04-09 20:30:00",4087,1149,5236
"2019-04-08 10:10:21","2019-04-09 21:00:00","2019-04-09 21:30:00",4169,1120,5289
"2019-04-08 10:10:21","2019-04-09 22:00:00","2019-04-09 22:30:00",3820,1005,4825
"2019-04-09 10:10:41","2019-04-09 23:00:00","2019-04-09 23:30:00",3165,868,4033
"2019-04-09 10:10:41","2019-04-10 00:00:00","2019-04-10 00:30:00",2929,713,3642
"2019-04-09 10:10:41","2019-04-10 01:00:00","2019-04-10 01:30:00",2851,655,3506
"2019-04-09 10:10:41","2019-04-10 02:00:00","2019-04-10 02:30:00",2759,636,3395
"2019-04-09 10:10:41","2019-04-10 03:00:00","2019-04-10 03:30:00",2667,653,3320
"2019-04-09 10:10:41","2019-04-10 04:00:00","2019-04-10 04:30:00",2600,647,3247
"2019-04-09 10:10:41","2019-04-10 05:00:00","2019-04-10 05:30:00",2622,665,3287
"2019-04-09 10:10:41","2019-04-10 06:00:00","2019-04-10 06:30:00",2871,746,3617
"2019-04-09 10:10:41","2019-04-10 07:00:00","2019-04-10 07:30:00",3331,935,4266
"2019-04-09 10:10:41","2019-04-10 08:00:00","2019-04-10 08:30:00",3863,1109,4972
"2019-04-09 10:10:41","2019-04-10 09:00:00","2019-04-10 09:30:00",3987,1150,5137
"2019-04-09 10:10:41","2019-04-10 10:00:00","2019-04-10 10:30:00",3953,1135,5088
"2019-04-09 10:10:41","2019-04-10 11:00:00","2019-04-10 11:30:00",3981,1136,5117
"2019-04-09 10:10:41","2019-04-10 12:00:00","2019-04-10 12:30:00",4015,1130,5145
"2019-04-09 10:10:41","2019-04-10 13:00:00","2019-04-10 13:30:00",4002,1125,5127
"2019-04-09 10:10:41","2019-04-10 14:00:00","2019-04-10 14:30:00",3907,1075,4982
"2019-04-09 10:10:41","2019-04-10 15:00:00","2019-04-10 15:30:00",3939,1060,4999
"2019-04-09 10:10:41","2019-04-10 16:00:00","2019-04-10 16:30:00",3952,1130,5082
"2019-04-09 10:10:41","2019-04-10 17:00:00","2019-04-10 17:30:00",4144,1194,5338
"2019-04-09 10:10:41","2019-04-10 18:00:00","2019-04-10 18:30:00",4165,1172,5337
"2019-04-09 10:10:41","2019-04-10 19:00:00","2019-04-10 19:30:00",4042,1162,5204
"2019-04-09 10:10:41","2019-04-10 20:00:00","2019-04-10 20:30:00",4018,1169,5187
"2019-04-09 10:10:41","2019-04-10 21:00:00","2019-04-10 21:30:00",4079,1157,5236
"2019-04-09 10:10:41","2019-04-10 22:00:00","2019-04-10 22:30:00",3795,1034,4829
"2019-04-10 10:10:31","2019-04-10 23:00:00","2019-04-10 23:30:00",3228,853,4081
"2019-04-10 10:10:31","2019-04-11 00:00:00","2019-04-11 00:30:00",2929,731,3660
"2019-04-10 10:10:31","2019-04-11 01:00:00","2019-04-11 01:30:00",2851,674,3525
"2019-04-10 10:10:31","2019-04-11 02:00:00","2019-04-11 02:30:00",2759,647,3406
"2019-04-10 10:10:31","2019-04-11 03:00:00","2019-04-11 03:30:00",2667,658,3325
"2019-04-10 10:10:31","2019-04-11 04:00:00","2019-04-11 04:30:00",2600,640,3240
"2019-04-10 10:10:31","2019-04-11 05:00:00","2019-04-11 05:30:00",2622,650,3272
"2019-04-10 10:10:31","2019-04-11 06:00:00","2019-04-11 06:30:00",2871,747,3618
"2019-04-10 10:10:31","2019-04-11 07:00:00","2019-04-11 07:30:00",3331,911,4242
"2019-04-10 10:10:31","2019-04-11 08:00:00","2019-04-11 08:30:00",3863,1103,4966
"2019-04-10 10:10:31","2019-04-11 09:00:00","2019-04-11 09:30:00",3987,1115,5102
"2019-04-10 10:10:31","2019-04-11 10:00:00","2019-04-11 10:30:00",3953,1075,5028
"2019-04-10 10:10:31","2019-04-11 11:00:00","2019-04-11 11:30:00",3981,1079,5060
"2019-04-10 10:10:31","2019-04-11 12:00:00","2019-04-11 12:30:00",4015,1109,5124
"2019-04-10 10:10:31","2019-04-11 13:00:00","2019-04-11 13:30:00",4002,1087,5089
"2019-04-10 10:10:31","2019-04-11 14:00:00","2019-04-11 14:30:00",3907,1052,4959
"2019-04-10 10:10:31","2019-04-11 15:00:00","2019-04-11 15:30:00",3939,1022,4961
"2019-04-10 10:10:31","2019-04-11 16:00:00","2019-04-11 16:30:00",3952,1087,5039
"2019-04-10 10:10:31","2019-04-11 17:00:00","2019-04-11 17:30:00",4144,1185,5329
"2019-04-10 10:10:31","2019-04-11 18:00:00","2019-04-11 18:30:00",4200,1165,5365
"2019-04-10 10:10:31","2019-04-11 19:00:00","2019-04-11 19:30:00",4087,1158,5245
"2019-04-10 10:10:31","2019-04-11 20:00:00","2019-04-11 20:30:00",4063,1170,5233
"2019-04-10 10:10:31","2019-04-11 21:00:00","2019-04-11 21:30:00",4124,1181,5305
"2019-04-10 10:10:31","2019-04-11 22:00:00","2019-04-11 22:30:00",3840,1077,4917
"2019-04-11 10:10:15","2019-04-11 23:00:00","2019-04-11 23:30:00",3199,920,4119
"2019-04-11 10:10:15","2019-04-12 00:00:00","2019-04-12 00:30:00",3035,758,3793
"2019-04-11 10:10:15","2019-04-12 01:00:00","2019-04-12 01:30:00",3026,686,3712
"2019-04-11 10:10:15","2019-04-12 02:00:00","2019-04-12 02:30:00",2902,673,3575
"2019-04-11 10:10:15","2019-04-12 03:00:00","2019-04-12 03:30:00",2803,673,3476
"2019-04-11 10:10:15","2019-04-12 04:00:00","2019-04-12 04:30:00",2771,656,3427
"2019-04-11 10:10:15","2019-04-12 05:00:00","2019-04-12 05:30:00",2801,672,3473
"2019-04-11 10:10:15","2019-04-12 06:00:00","2019-04-12 06:30:00",2931,744,3675
"2019-04-11 10:10:15","2019-04-12 07:00:00","2019-04-12 07:30:00",3394,901,4295
"2019-04-11 10:10:15","2019-04-12 08:00:00","2019-04-12 08:30:00",3917,1105,5022
"2019-04-11 10:10:15","2019-04-12 09:00:00","2019-04-12 09:30:00",3959,1158,5117
"2019-04-11 10:10:15","2019-04-12 10:00:00","2019-04-12 10:30:00",3933,1176,5109
"2019-04-11 10:10:15","2019-04-12 11:00:00","2019-04-12 11:30:00",3882,1155,5037
"2019-04-11 10:10:15","2019-04-12 12:00:00","2019-04-12 12:30:00",3841,1142,4983
"2019-04-11 10:10:15","2019-04-12 13:00:00","2019-04-12 13:30:00",3866,1149,5015
"2019-04-11 10:10:15","2019-04-12 14:00:00","2019-04-12 14:30:00",3778,1096,4874
"2019-04-11 10:10:15","2019-04-12 15:00:00","2019-04-12 15:30:00",3748,1090,4838
"2019-04-11 10:10:15","2019-04-12 16:00:00","2019-04-12 16:30:00",3759,1135,4894
"2019-04-11 10:10:15","2019-04-12 17:00:00","2019-04-12 17:30:00",3867,1181,5048
"2019-04-11 10:10:15","2019-04-12 18:00:00","2019-04-12 18:30:00",3927,1188,5115
"2019-04-11 10:10:15","2019-04-12 19:00:00","2019-04-12 19:30:00",3860,1130,4990
"2019-04-11 10:10:15","2019-04-12 20:00:00","2019-04-12 20:30:00",3863,1119,4982
"2019-04-11 10:10:15","2019-04-12 21:00:00","2019-04-12 21:30:00",3930,1107,5037
"2019-04-11 10:10:15","2019-04-12 22:00:00","2019-04-12 22:30:00",3609,1001,4610
"2019-04-12 10:10:31","2019-04-12 23:00:00","2019-04-12 23:30:00",3274,886,4160
"2019-04-12 10:10:31","2019-04-13 00:00:00","2019-04-13 00:30:00",2979,757,3736
"2019-04-12 10:10:31","2019-04-13 01:00:00","2019-04-13 01:30:00",2886,662,3548
"2019-04-12 10:10:31","2019-04-13 02:00:00","2019-04-13 02:30:00",2707,608,3315
"2019-04-12 10:10:31","2019-04-13 03:00:00","2019-04-13 03:30:00",2591,612,3203
"2019-04-12 10:10:31","2019-04-13 04:00:00","2019-04-13 04:30:00",2546,615,3161
"2019-04-12 10:10:31","2019-04-13 05:00:00","2019-04-13 05:30:00",2561,595,3156
"2019-04-12 10:10:31","2019-04-13 06:00:00","2019-04-13 06:30:00",2624,622,3246
"2019-04-12 10:10:31","2019-04-13 07:00:00","2019-04-13 07:30:00",2733,689,3422
"2019-04-12 10:10:31","2019-04-13 08:00:00","2019-04-13 08:30:00",3035,811,3846
"2019-04-12 10:10:31","2019-04-13 09:00:00","2019-04-13 09:30:00",3339,933,4272
"2019-04-12 10:10:31","2019-04-13 10:00:00","2019-04-13 10:30:00",3454,986,4440
"2019-04-12 10:10:31","2019-04-13 11:00:00","2019-04-13 11:30:00",3519,980,4499
"2019-04-12 10:10:31","2019-04-13 12:00:00","2019-04-13 12:30:00",3600,974,4574
"2019-04-12 10:10:31","2019-04-13 13:00:00","2019-04-13 13:30:00",3600,923,4523
"2019-04-12 10:10:31","2019-04-13 14:00:00","2019-04-13 14:30:00",3476,864,4340
"2019-04-12 10:10:31","2019-04-13 15:00:00","2019-04-13 15:30:00",3436,845,4281
"2019-04-12 10:10:31","2019-04-13 16:00:00","2019-04-13 16:30:00",3413,845,4258
"2019-04-12 10:10:31","2019-04-13 17:00:00","2019-04-13 17:30:00",3525,901,4426
"2019-04-12 10:10:31","2019-04-13 18:00:00","2019-04-13 18:30:00",3584,946,4530
"2019-04-12 10:10:31","2019-04-13 19:00:00","2019-04-13 19:30:00",3577,919,4496
"2019-04-12 10:10:31","2019-04-13 20:00:00","2019-04-13 20:30:00",3527,944,4471
"2019-04-12 10:10:31","2019-04-13 21:00:00","2019-04-13 21:30:00",3571,948,4519
"2019-04-12 10:10:31","2019-04-13 22:00:00","2019-04-13 22:30:00",3381,862,4243
"2019-04-13 10:10:20","2019-04-13 23:00:00","2019-04-13 23:30:00",3151,789,3940
"2019-04-13 10:10:20","2019-04-14 00:00:00","2019-04-14 00:30:00",2956,673,3629
"2019-04-13 10:10:20","2019-04-14 01:00:00","2019-04-14 01:30:00",2887,616,3503
"2019-04-13 10:10:20","2019-04-14 02:00:00","2019-04-14 02:30:00",2757,596,3353
"2019-04-13 10:10:20","2019-04-14 03:00:00","2019-04-14 03:30:00",2662,582,3244
"2019-04-13 10:10:20","2019-04-14 04:00:00","2019-04-14 04:30:00",2581,581,3162
"2019-04-13 10:10:20","2019-04-14 05:00:00","2019-04-14 05:30:00",2595,567,3162
"2019-04-13 10:10:20","2019-04-14 06:00:00","2019-04-14 06:30:00",2632,588,3220
"2019-04-13 10:10:20","2019-04-14 07:00:00","2019-04-14 07:30:00",2673,635,3308
"2019-04-13 10:10:20","2019-04-14 08:00:00","2019-04-14 08:30:00",2919,721,3640
"2019-04-13 10:10:20","2019-04-14 09:00:00","2019-04-14 09:30:00",3197,833,4030
"2019-04-13 10:10:20","2019-04-14 10:00:00","2019-04-14 10:30:00",3371,908,4279
"2019-04-13 10:10:20","2019-04-14 11:00:00","2019-04-14 11:30:00",3480,936,4416
"2019-04-13 10:10:20","2019-04-14 12:00:00","2019-04-14 12:30:00",3483,973,4456
"2019-04-13 10:10:20","2019-04-14 13:00:00","2019-04-14 13:30:00",3538,1015,4553
"2019-04-13 10:10:20","2019-04-14 14:00:00","2019-04-14 14:30:00",3427,963,4390
"2019-04-13 10:10:20","2019-04-14 15:00:00","2019-04-14 15:30:00",3331,917,4248
"2019-04-13 10:10:20","2019-04-14 16:00:00","2019-04-14 16:30:00",3316,954,4270
"2019-04-13 10:10:20","2019-04-14 17:00:00","2019-04-14 17:30:00",3448,1007,4455
"2019-04-13 10:10:20","2019-04-14 18:00:00","2019-04-14 18:30:00",3547,1033,4580
"2019-04-13 10:10:20","2019-04-14 19:00:00","2019-04-14 19:30:00",3570,998,4568
"2019-04-13 10:10:20","2019-04-14 20:00:00","2019-04-14 20:30:00",3588,996,4584
"2019-04-13 10:10:20","2019-04-14 21:00:00","2019-04-14 21:30:00",3719,1021,4740
"2019-04-13 10:10:20","2019-04-14 22:00:00","2019-04-14 22:30:00",3387,925,4312
"2019-04-14 10:10:35","2019-04-14 23:00:00","2019-04-14 23:30:00",3028,714,3742
"2019-04-14 10:10:35","2019-04-15 00:00:00","2019-04-15 00:30:00",2832,662,3494
"2019-04-14 10:10:35","2019-04-15 01:00:00","2019-04-15 01:30:00",2770,606,3376
"2019-04-14 10:10:35","2019-04-15 02:00:00","2019-04-15 02:30:00",2673,581,3254
"2019-04-14 10:10:35","2019-04-15 03:00:00","2019-04-15 03:30:00",2614,589,3203
"2019-04-14 10:10:35","2019-04-15 04:00:00","2019-04-15 04:30:00",2554,571,3125
"2019-04-14 10:10:35","2019-04-15 05:00:00","2019-04-15 05:30:00",2619,594,3213
"2019-04-14 10:10:35","2019-04-15 06:00:00","2019-04-15 06:30:00",2841,666,3507
"2019-04-14 10:10:35","2019-04-15 07:00:00","2019-04-15 07:30:00",3122,832,3954
"2019-04-14 10:10:35","2019-04-15 08:00:00","2019-04-15 08:30:00",3547,1054,4601
"2019-04-14 10:10:35","2019-04-15 09:00:00","2019-04-15 09:30:00",3864,1138,5002
"2019-04-14 10:10:35","2019-04-15 10:00:00","2019-04-15 10:30:00",3925,1108,5033
"2019-04-14 10:10:35","2019-04-15 11:00:00","2019-04-15 11:30:00",3982,1100,5082
"2019-04-14 10:10:35","2019-04-15 12:00:00","2019-04-15 12:30:00",4024,1074,5098
"2019-04-14 10:10:35","2019-04-15 13:00:00","2019-04-15 13:30:00",4043,1026,5069
"2019-04-14 10:10:35","2019-04-15 14:00:00","2019-04-15 14:30:00",3951,958,4909
"2019-04-14 10:10:35","2019-04-15 15:00:00","2019-04-15 15:30:00",3958,1003,4961
"2019-04-14 10:10:35","2019-04-15 16:00:00","2019-04-15 16:30:00",3963,1007,4970
"2019-04-14 10:10:35","2019-04-15 17:00:00","2019-04-15 17:30:00",4054,1083,5137
"2019-04-14 10:10:35","2019-04-15 18:00:00","2019-04-15 18:30:00",4092,1054,5146
"2019-04-14 10:10:35","2019-04-15 19:00:00","2019-04-15 19:30:00",3953,966,4919
"2019-04-14 10:10:35","2019-04-15 20:00:00","2019-04-15 20:30:00",3893,996,4889
"2019-04-14 10:10:35","2019-04-15 21:00:00","2019-04-15 21:30:00",3970,1105,5075
"2019-04-14 10:10:35","2019-04-15 22:00:00","2019-04-15 22:30:00",3601,987,4588
"2019-04-15 10:10:21","2019-04-15 23:00:00","2019-04-15 23:30:00",3446,833,4279
"2019-04-15 10:10:21","2019-04-16 00:00:00","2019-04-16 00:30:00",2949,707,3656
"2019-04-15 10:10:21","2019-04-16 01:00:00","2019-04-16 01:30:00",2895,632,3527
"2019-04-15 10:10:21","2019-04-16 02:00:00","2019-04-16 02:30:00",2769,627,3396
"2019-04-15 10:10:21","2019-04-16 03:00:00","2019-04-16 03:30:00",2670,628,3298
"2019-04-15 10:10:21","2019-04-16 04:00:00","2019-04-16 04:30:00",2650,623,3273
"2019-04-15 10:10:21","2019-04-16 05:00:00","2019-04-16 05:30:00",2693,648,3341
"2019-04-15 10:10:21","2019-04-16 06:00:00","2019-04-16 06:30:00",2817,716,3533
"2019-04-15 10:10:21","2019-04-16 07:00:00","2019-04-16 07:30:00",3288,878,4166
"2019-04-15 10:10:21","2019-04-16 08:00:00","2019-04-16 08:30:00",3660,1085,4745
"2019-04-15 10:10:21","2019-04-16 09:00:00","2019-04-16 09:30:00",3937,1124,5061
"2019-04-15 10:10:21","2019-04-16 10:00:00","2019-04-16 10:30:00",3986,1126,5112
"2019-04-15 10:10:21","2019-04-16 11:00:00","2019-04-16 11:30:00",3944,1123,5067
"2019-04-15 10:10:21","2019-04-16 12:00:00","2019-04-16 12:30:00",3947,1120,5067
"2019-04-15 10:10:21","2019-04-16 13:00:00","2019-04-16 13:30:00",3944,1130,5074
"2019-04-15 10:10:21","2019-04-16 14:00:00","2019-04-16 14:30:00",3837,1086,4923
"2019-04-15 10:10:21","2019-04-16 15:00:00","2019-04-16 15:30:00",3839,1089,4928
"2019-04-15 10:10:21","2019-04-16 16:00:00","2019-04-16 16:30:00",3880,1102,4982
"2019-04-15 10:10:21","2019-04-16 17:00:00","2019-04-16 17:30:00",3951,1181,5132
"2019-04-15 10:10:21","2019-04-16 18:00:00","2019-04-16 18:30:00",4024,1195,5219
"2019-04-15 10:10:21","2019-04-16 19:00:00","2019-04-16 19:30:00",3941,1119,5060
"2019-04-15 10:10:21","2019-04-16 20:00:00","2019-04-16 20:30:00",3844,1102,4946
"2019-04-15 10:10:21","2019-04-16 21:00:00","2019-04-16 21:30:00",4013,1156,5169
"2019-04-15 10:10:21","2019-04-16 22:00:00","2019-04-16 22:30:00",3670,1017,4687
"2019-04-16 10:10:35","2019-04-16 23:00:00","2019-04-16 23:30:00",3292,946,4238
"2019-04-16 10:10:35","2019-04-17 00:00:00","2019-04-17 00:30:00",3071,724,3795
"2019-04-16 10:10:35","2019-04-17 01:00:00","2019-04-17 01:30:00",2971,649,3620
"2019-04-16 10:10:35","2019-04-17 02:00:00","2019-04-17 02:30:00",2830,634,3464
"2019-04-16 10:10:35","2019-04-17 03:00:00","2019-04-17 03:30:00",2751,630,3381
"2019-04-16 10:10:35","2019-04-17 04:00:00","2019-04-17 04:30:00",2669,615,3284
"2019-04-16 10:10:35","2019-04-17 05:00:00","2019-04-17 05:30:00",2720,634,3354
"2019-04-16 10:10:35","2019-04-17 06:00:00","2019-04-17 06:30:00",2908,695,3603
"2019-04-16 10:10:35","2019-04-17 07:00:00","2019-04-17 07:30:00",3295,850,4145
"2019-04-16 10:10:35","2019-04-17 08:00:00","2019-04-17 08:30:00",3835,1050,4885
"2019-04-16 10:10:35","2019-04-17 09:00:00","2019-04-17 09:30:00",4174,1068,5242
"2019-04-16 10:10:35","2019-04-17 10:00:00","2019-04-17 10:30:00",4180,1067,5247
"2019-04-16 10:10:35","2019-04-17 11:00:00","2019-04-17 11:30:00",4209,1059,5268
"2019-04-16 10:10:35","2019-04-17 12:00:00","2019-04-17 12:30:00",4211,1053,5264
"2019-04-16 10:10:35","2019-04-17 13:00:00","2019-04-17 13:30:00",4279,1049,5328
"2019-04-16 10:10:35","2019-04-17 14:00:00","2019-04-17 14:30:00",4100,1000,5100
"2019-04-16 10:10:35","2019-04-17 15:00:00","2019-04-17 15:30:00",4050,991,5041
"2019-04-16 10:10:35","2019-04-17 16:00:00","2019-04-17 16:30:00",4092,998,5090
"2019-04-16 10:10:35","2019-04-17 17:00:00","2019-04-17 17:30:00",4187,1047,5234
"2019-04-16 10:10:35","2019-04-17 18:00:00","2019-04-17 18:30:00",4300,1080,5380
"2019-04-16 10:10:35","2019-04-17 19:00:00","2019-04-17 19:30:00",4173,1020,5193
"2019-04-16 10:10:35","2019-04-17 20:00:00","2019-04-17 20:30:00",4039,1037,5076
"2019-04-16 10:10:35","2019-04-17 21:00:00","2019-04-17 21:30:00",4188,1103,5291
"2019-04-16 10:10:35","2019-04-17 22:00:00","2019-04-17 22:30:00",3872,956,4828
"2019-04-17 10:10:21","2019-04-17 23:00:00","2019-04-17 23:30:00",3273,896,4169
"2019-04-17 10:10:21","2019-04-18 00:00:00","2019-04-18 00:30:00",3004,661,3665
"2019-04-17 10:10:21","2019-04-18 01:00:00","2019-04-18 01:30:00",2889,604,3493
"2019-04-17 10:10:21","2019-04-18 02:00:00","2019-04-18 02:30:00",2775,605,3380
"2019-04-17 10:10:21","2019-04-18 03:00:00","2019-04-18 03:30:00",2697,618,3315
"2019-04-17 10:10:21","2019-04-18 04:00:00","2019-04-18 04:30:00",2670,610,3280
"2019-04-17 10:10:21","2019-04-18 05:00:00","2019-04-18 05:30:00",2696,631,3327
"2019-04-17 10:10:21","2019-04-18 06:00:00","2019-04-18 06:30:00",2860,712,3572
"2019-04-17 10:10:21","2019-04-18 07:00:00","2019-04-18 07:30:00",3225,842,4067
"2019-04-17 10:10:21","2019-04-18 08:00:00","2019-04-18 08:30:00",3711,1040,4751
"2019-04-17 10:10:21","2019-04-18 09:00:00","2019-04-18 09:30:00",4019,1102,5121
"2019-04-17 10:10:21","2019-04-18 10:00:00","2019-04-18 10:30:00",4037,1088,5125
"2019-04-17 10:10:21","2019-04-18 11:00:00","2019-04-18 11:30:00",4050,1067,5117
"2019-04-17 10:10:21","2019-04-18 12:00:00","2019-04-18 12:30:00",4013,1063,5076
"2019-04-17 10:10:21","2019-04-18 13:00:00","2019-04-18 13:30:00",4014,1027,5041
"2019-04-17 10:10:21","2019-04-18 14:00:00","2019-04-18 14:30:00",3915,986,4901
"2019-04-17 10:10:21","2019-04-18 15:00:00","2019-04-18 15:30:00",3880,996,4876
"2019-04-17 10:10:21","2019-04-18 16:00:00","2019-04-18 16:30:00",3871,1020,4891
"2019-04-17 10:10:21","2019-04-18 17:00:00","2019-04-18 17:30:00",3924,1084,5008
"2019-04-17 10:10:21","2019-04-18 18:00:00","2019-04-18 18:30:00",3963,1070,5033
"2019-04-17 10:10:21","2019-04-18 19:00:00","2019-04-18 19:30:00",3850,1020,4870
"2019-04-17 10:10:21","2019-04-18 20:00:00","2019-04-18 20:30:00",3737,989,4726
"2019-04-17 10:10:21","2019-04-18 21:00:00","2019-04-18 21:30:00",3903,1057,4960
"2019-04-17 10:10:21","2019-04-18 22:00:00","2019-04-18 22:30:00",3654,952,4606
"2019-04-18 10:10:36","2019-04-18 23:00:00","2019-04-18 23:30:00",3289,881,4170
"2019-04-18 10:10:36","2019-04-19 00:00:00","2019-04-19 00:30:00",3080,680,3760
"2019-04-18 10:10:36","2019-04-19 01:00:00","2019-04-19 01:30:00",2968,614,3582
"2019-04-18 10:10:36","2019-04-19 02:00:00","2019-04-19 02:30:00",2824,604,3428
"2019-04-18 10:10:36","2019-04-19 03:00:00","2019-04-19 03:30:00",2707,623,3330
"2019-04-18 10:10:36","2019-04-19 04:00:00","2019-04-19 04:30:00",2650,599,3249
"2019-04-18 10:10:36","2019-04-19 05:00:00","2019-04-19 05:30:00",2689,607,3296
"2019-04-18 10:10:36","2019-04-19 06:00:00","2019-04-19 06:30:00",2811,674,3485
"2019-04-18 10:10:36","2019-04-19 07:00:00","2019-04-19 07:30:00",3027,793,3820
"2019-04-18 10:10:36","2019-04-19 08:00:00","2019-04-19 08:30:00",3390,940,4330
"2019-04-18 10:10:36","2019-04-19 09:00:00","2019-04-19 09:30:00",3708,1016,4724
"2019-04-18 10:10:36","2019-04-19 10:00:00","2019-04-19 10:30:00",3816,1005,4821
"2019-04-18 10:10:36","2019-04-19 11:00:00","2019-04-19 11:30:00",3840,948,4788
"2019-04-18 10:10:36","2019-04-19 12:00:00","2019-04-19 12:30:00",3866,935,4801
"2019-04-18 10:10:36","2019-04-19 13:00:00","2019-04-19 13:30:00",3896,934,4830
"2019-04-18 10:10:36","2019-04-19 14:00:00","2019-04-19 14:30:00",3793,871,4664
"2019-04-18 10:10:36","2019-04-19 15:00:00","2019-04-19 15:30:00",3656,822,4478
"2019-04-18 10:10:36","2019-04-19 16:00:00","2019-04-19 16:30:00",3635,834,4469
"2019-04-18 10:10:36","2019-04-19 17:00:00","2019-04-19 17:30:00",3796,919,4715
"2019-04-18 10:10:36","2019-04-19 18:00:00","2019-04-19 18:30:00",3898,968,4866
"2019-04-18 10:10:36","2019-04-19 19:00:00","2019-04-19 19:30:00",3797,912,4709
"2019-04-18 10:10:36","2019-04-19 20:00:00","2019-04-19 20:30:00",3684,929,4613
"2019-04-18 10:10:36","2019-04-19 21:00:00","2019-04-19 21:30:00",3822,926,4748
"2019-04-18 10:10:36","2019-04-19 22:00:00","2019-04-19 22:30:00",3573,898,4471
"2019-04-19 10:10:21","2019-04-19 23:00:00","2019-04-19 23:30:00",3158,860,4018
"2019-04-19 10:10:21","2019-04-20 00:00:00","2019-04-20 00:30:00",3022,794,3816
"2019-04-19 10:10:21","2019-04-20 01:00:00","2019-04-20 01:30:00",2865,705,3570
"2019-04-19 10:10:21","2019-04-20 02:00:00","2019-04-20 02:30:00",2712,665,3377
"2019-04-19 10:10:21","2019-04-20 03:00:00","2019-04-20 03:30:00",2619,663,3282
"2019-04-19 10:10:21","2019-04-20 04:00:00","2019-04-20 04:30:00",2517,643,3160
"2019-04-19 10:10:21","2019-04-20 05:00:00","2019-04-20 05:30:00",2518,645,3163
"2019-04-19 10:10:21","2019-04-20 06:00:00","2019-04-20 06:30:00",2613,680,3293
"2019-04-19 10:10:21","2019-04-20 07:00:00","2019-04-20 07:30:00",2695,764,3459
"2019-04-19 10:10:21","2019-04-20 08:00:00","2019-04-20 08:30:00",3004,891,3895
"2019-04-19 10:10:21","2019-04-20 09:00:00","2019-04-20 09:30:00",3320,1011,4331
"2019-04-19 10:10:21","2019-04-20 10:00:00","2019-04-20 10:30:00",3487,1016,4503
"2019-04-19 10:10:21","2019-04-20 11:00:00","2019-04-20 11:30:00",3539,1025,4564
"2019-04-19 10:10:21","2019-04-20 12:00:00","2019-04-20 12:30:00",3539,996,4535
"2019-04-19 10:10:21","2019-04-20 13:00:00","2019-04-20 13:30:00",3514,966,4480
"2019-04-19 10:10:21","2019-04-20 14:00:00","2019-04-20 14:30:00",3388,914,4302
"2019-04-19 10:10:21","2019-04-20 15:00:00","2019-04-20 15:30:00",3320,888,4208
"2019-04-19 10:10:21","2019-04-20 16:00:00","2019-04-20 16:30:00",3291,898,4189
"2019-04-19 10:10:21","2019-04-20 17:00:00","2019-04-20 17:30:00",3383,948,4331
"2019-04-19 10:10:21","2019-04-20 18:00:00","2019-04-20 18:30:00",3550,977,4527
"2019-04-19 10:10:21","2019-04-20 19:00:00","2019-04-20 19:30:00",3491,949,4440
"2019-04-19 10:10:21","2019-04-20 20:00:00","2019-04-20 20:30:00",3374,932,4306
"2019-04-19 10:10:21","2019-04-20 21:00:00","2019-04-20 21:30:00",3477,979,4456
"2019-04-19 10:10:21","2019-04-20 22:00:00","2019-04-20 22:30:00",3303,929,4232
"2019-04-20 10:10:11","2019-04-20 23:00:00","2019-04-20 23:30:00",3061,752,3813
"2019-04-20 10:10:11","2019-04-21 00:00:00","2019-04-21 00:30:00",3069,639,3708
"2019-04-20 10:10:11","2019-04-21 01:00:00","2019-04-21 01:30:00",2995,567,3562
"2019-04-20 10:10:11","2019-04-21 02:00:00","2019-04-21 02:30:00",2822,509,3331
"2019-04-20 10:10:11","2019-04-21 03:00:00","2019-04-21 03:30:00",2710,502,3212
"2019-04-20 10:10:11","2019-04-21 04:00:00","2019-04-21 04:30:00",2622,498,3120
"2019-04-20 10:10:11","2019-04-21 05:00:00","2019-04-21 05:30:00",2600,507,3107
"2019-04-20 10:10:11","2019-04-21 06:00:00","2019-04-21 06:30:00",2614,524,3138
"2019-04-20 10:10:11","2019-04-21 07:00:00","2019-04-21 07:30:00",2661,560,3221
"2019-04-20 10:10:11","2019-04-21 08:00:00","2019-04-21 08:30:00",2879,664,3543
"2019-04-20 10:10:11","2019-04-21 09:00:00","2019-04-21 09:30:00",3155,769,3924
"2019-04-20 10:10:11","2019-04-21 10:00:00","2019-04-21 10:30:00",3346,823,4169
"2019-04-20 10:10:11","2019-04-21 11:00:00","2019-04-21 11:30:00",3514,864,4378
"2019-04-20 10:10:11","2019-04-21 12:00:00","2019-04-21 12:30:00",3582,914,4496
"2019-04-20 10:10:11","2019-04-21 13:00:00","2019-04-21 13:30:00",3650,956,4606
"2019-04-20 10:10:11","2019-04-21 14:00:00","2019-04-21 14:30:00",3544,840,4384
"2019-04-20 10:10:11","2019-04-21 15:00:00","2019-04-21 15:30:00",3404,777,4181
"2019-04-20 10:10:11","2019-04-21 16:00:00","2019-04-21 16:30:00",3350,829,4179
"2019-04-20 10:10:11","2019-04-21 17:00:00","2019-04-21 17:30:00",3355,877,4232
"2019-04-20 10:10:11","2019-04-21 18:00:00","2019-04-21 18:30:00",3397,908,4305
"2019-04-20 10:10:11","2019-04-21 19:00:00","2019-04-21 19:30:00",3371,892,4263
"2019-04-20 10:10:11","2019-04-21 20:00:00","2019-04-21 20:30:00",3429,888,4317
"2019-04-20 10:10:11","2019-04-21 21:00:00","2019-04-21 21:30:00",3492,926,4418
"2019-04-20 10:10:11","2019-04-21 22:00:00","2019-04-21 22:30:00",3323,825,4148
"2019-04-21 10:10:30","2019-04-21 23:00:00","2019-04-21 23:30:00",2902,765,3667
"2019-04-21 10:10:30","2019-04-22 00:00:00","2019-04-22 00:30:00",2783,658,3441
"2019-04-21 10:10:30","2019-04-22 01:00:00","2019-04-22 01:30:00",2679,598,3277
"2019-04-21 10:10:30","2019-04-22 02:00:00","2019-04-22 02:30:00",2557,579,3136
"2019-04-21 10:10:30","2019-04-22 03:00:00","2019-04-22 03:30:00",2416,590,3006
"2019-04-21 10:10:30","2019-04-22 04:00:00","2019-04-22 04:30:00",2350,581,2931
"2019-04-21 10:10:30","2019-04-22 05:00:00","2019-04-22 05:30:00",2371,583,2954
"2019-04-21 10:10:30","2019-04-22 06:00:00","2019-04-22 06:30:00",2430,597,3027
"2019-04-21 10:10:30","2019-04-22 07:00:00","2019-04-22 07:30:00",2464,635,3099
"2019-04-21 10:10:30","2019-04-22 08:00:00","2019-04-22 08:30:00",2713,703,3416
"2019-04-21 10:10:30","2019-04-22 09:00:00","2019-04-22 09:30:00",2993,801,3794
"2019-04-21 10:10:30","2019-04-22 10:00:00","2019-04-22 10:30:00",3195,864,4059
"2019-04-21 10:10:30","2019-04-22 11:00:00","2019-04-22 11:30:00",3349,885,4234
"2019-04-21 10:10:30","2019-04-22 12:00:00","2019-04-22 12:30:00",3421,891,4312
"2019-04-21 10:10:30","2019-04-22 13:00:00","2019-04-22 13:30:00",3448,869,4317
"2019-04-21 10:10:30","2019-04-22 14:00:00","2019-04-22 14:30:00",3327,826,4153
"2019-04-21 10:10:30","2019-04-22 15:00:00","2019-04-22 15:30:00",3248,798,4046
"2019-04-21 10:10:30","2019-04-22 16:00:00","2019-04-22 16:30:00",3212,802,4014
"2019-04-21 10:10:30","2019-04-22 17:00:00","2019-04-22 17:30:00",3331,870,4201
"2019-04-21 10:10:30","2019-04-22 18:00:00","2019-04-22 18:30:00",3483,910,4393
"2019-04-21 10:10:30","2019-04-22 19:00:00","2019-04-22 19:30:00",3424,887,4311
"2019-04-21 10:10:30","2019-04-22 20:00:00","2019-04-22 20:30:00",3323,879,4202
"2019-04-21 10:10:30","2019-04-22 21:00:00","2019-04-22 21:30:00",3550,975,4525
"2019-04-21 10:10:30","2019-04-22 22:00:00","2019-04-22 22:30:00",3354,921,4275
"2019-04-22 10:10:10","2019-04-22 23:00:00","2019-04-22 23:30:00",2962,812,3774
"2019-04-22 10:10:10","2019-04-23 00:00:00","2019-04-23 00:30:00",2665,705,3370
"2019-04-22 10:10:10","2019-04-23 01:00:00","2019-04-23 01:30:00",2557,636,3193
"2019-04-22 10:10:10","2019-04-23 02:00:00","2019-04-23 02:30:00",2426,620,3046
"2019-04-22 10:10:10","2019-04-23 03:00:00","2019-04-23 03:30:00",2321,633,2954
"2019-04-22 10:10:10","2019-04-23 04:00:00","2019-04-23 04:30:00",2300,609,2909
"2019-04-22 10:10:10","2019-04-23 05:00:00","2019-04-23 05:30:00",2332,633,2965
"2019-04-22 10:10:10","2019-04-23 06:00:00","2019-04-23 06:30:00",2494,706,3200
"2019-04-22 10:10:10","2019-04-23 07:00:00","2019-04-23 07:30:00",2815,845,3660
"2019-04-22 10:10:10","2019-04-23 08:00:00","2019-04-23 08:30:00",3371,1030,4401
"2019-04-22 10:10:10","2019-04-23 09:00:00","2019-04-23 09:30:00",3735,1109,4844
"2019-04-22 10:10:10","2019-04-23 10:00:00","2019-04-23 10:30:00",3842,1077,4919
"2019-04-22 10:10:10","2019-04-23 11:00:00","2019-04-23 11:30:00",3865,1057,4922
"2019-04-22 10:10:10","2019-04-23 12:00:00","2019-04-23 12:30:00",3851,1021,4872
"2019-04-22 10:10:10","2019-04-23 13:00:00","2019-04-23 13:30:00",3853,995,4848
"2019-04-22 10:10:10","2019-04-23 14:00:00","2019-04-23 14:30:00",3732,968,4700
"2019-04-22 10:10:10","2019-04-23 15:00:00","2019-04-23 15:30:00",3687,969,4656
"2019-04-22 10:10:10","2019-04-23 16:00:00","2019-04-23 16:30:00",3712,960,4672
"2019-04-22 10:10:10","2019-04-23 17:00:00","2019-04-23 17:30:00",3803,1026,4829
"2019-04-22 10:10:10","2019-04-23 18:00:00","2019-04-23 18:30:00",3900,1045,4945
"2019-04-22 10:10:10","2019-04-23 19:00:00","2019-04-23 19:30:00",3761,996,4757
"2019-04-22 10:10:10","2019-04-23 20:00:00","2019-04-23 20:30:00",3666,961,4627
"2019-04-22 10:10:10","2019-04-23 21:00:00","2019-04-23 21:30:00",3811,1044,4855
"2019-04-22 10:10:10","2019-04-23 22:00:00","2019-04-23 22:30:00",3552,957,4509
"2019-04-23 10:10:26","2019-04-23 23:00:00","2019-04-23 23:30:00",3119,780,3899
"2019-04-23 10:10:26","2019-04-24 00:00:00","2019-04-24 00:30:00",2946,689,3635
"2019-04-23 10:10:26","2019-04-24 01:00:00","2019-04-24 01:30:00",2851,624,3475
"2019-04-23 10:10:26","2019-04-24 02:00:00","2019-04-24 02:30:00",2714,613,3327
"2019-04-23 10:10:26","2019-04-24 03:00:00","2019-04-24 03:30:00",2640,612,3252
"2019-04-23 10:10:26","2019-04-24 04:00:00","2019-04-24 04:30:00",2600,599,3199
"2019-04-23 10:10:26","2019-04-24 05:00:00","2019-04-24 05:30:00",2635,610,3245
"2019-04-23 10:10:26","2019-04-24 06:00:00","2019-04-24 06:30:00",2770,685,3455
"2019-04-23 10:10:26","2019-04-24 07:00:00","2019-04-24 07:30:00",3048,817,3865
"2019-04-23 10:10:26","2019-04-24 08:00:00","2019-04-24 08:30:00",3503,1001,4504
"2019-04-23 10:10:26","2019-04-24 09:00:00","2019-04-24 09:30:00",3802,1070,4872
"2019-04-23 10:10:26","2019-04-24 10:00:00","2019-04-24 10:30:00",3865,1042,4907
"2019-04-23 10:10:26","2019-04-24 11:00:00","2019-04-24 11:30:00",3909,1045,4954
"2019-04-23 10:10:26","2019-04-24 12:00:00","2019-04-24 12:30:00",3894,994,4888
"2019-04-23 10:10:26","2019-04-24 13:00:00","2019-04-24 13:30:00",3900,930,4830
"2019-04-23 10:10:26","2019-04-24 14:00:00","2019-04-24 14:30:00",3812,896,4708
"2019-04-23 10:10:26","2019-04-24 15:00:00","2019-04-24 15:30:00",3780,904,4684
"2019-04-23 10:10:26","2019-04-24 16:00:00","2019-04-24 16:30:00",3790,957,4747
"2019-04-23 10:10:26","2019-04-24 17:00:00","2019-04-24 17:30:00",3872,1054,4926
"2019-04-23 10:10:26","2019-04-24 18:00:00","2019-04-24 18:30:00",3950,1115,5065
"2019-04-23 10:10:26","2019-04-24 19:00:00","2019-04-24 19:30:00",3826,1070,4896
"2019-04-23 10:10:26","2019-04-24 20:00:00","2019-04-24 20:30:00",3722,1009,4731
"2019-04-23 10:10:26","2019-04-24 21:00:00","2019-04-24 21:30:00",3832,1085,4917
"2019-04-23 10:10:26","2019-04-24 22:00:00","2019-04-24 22:30:00",3635,987,4622
"2019-04-24 10:10:11","2019-04-24 23:00:00","2019-04-24 23:30:00",3257,820,4077
"2019-04-24 10:10:11","2019-04-25 00:00:00","2019-04-25 00:30:00",3000,701,3701
"2019-04-24 10:10:11","2019-04-25 01:00:00","2019-04-25 01:30:00",2875,642,3517
"2019-04-24 10:10:11","2019-04-25 02:00:00","2019-04-25 02:30:00",2717,603,3320
"2019-04-24 10:10:11","2019-04-25 03:00:00","2019-04-25 03:30:00",2618,588,3206
"2019-04-24 10:10:11","2019-04-25 04:00:00","2019-04-25 04:30:00",2600,577,3177
"2019-04-24 10:10:11","2019-04-25 05:00:00","2019-04-25 05:30:00",2630,575,3205
"2019-04-24 10:10:11","2019-04-25 06:00:00","2019-04-25 06:30:00",2767,624,3391
"2019-04-24 10:10:11","2019-04-25 07:00:00","2019-04-25 07:30:00",3065,780,3845
"2019-04-24 10:10:11","2019-04-25 08:00:00","2019-04-25 08:30:00",3549,940,4489
"2019-04-24 10:10:11","2019-04-25 09:00:00","2019-04-25 09:30:00",3829,1050,4879
"2019-04-24 10:10:11","2019-04-25 10:00:00","2019-04-25 10:30:00",3877,1065,4942
"2019-04-24 10:10:11","2019-04-25 11:00:00","2019-04-25 11:30:00",3901,1068,4969
"2019-04-24 10:10:11","2019-04-25 12:00:00","2019-04-25 12:30:00",3890,1068,4958
"2019-04-24 10:10:11","2019-04-25 13:00:00","2019-04-25 13:30:00",3909,1050,4959
"2019-04-24 10:10:11","2019-04-25 14:00:00","2019-04-25 14:30:00",3783,1020,4803
"2019-04-24 10:10:11","2019-04-25 15:00:00","2019-04-25 15:30:00",3777,1020,4797
"2019-04-24 10:10:11","2019-04-25 16:00:00","2019-04-25 16:30:00",3781,1040,4821
"2019-04-24 10:10:11","2019-04-25 17:00:00","2019-04-25 17:30:00",3876,1080,4956
"2019-04-24 10:10:11","2019-04-25 18:00:00","2019-04-25 18:30:00",3950,1130,5080
"2019-04-24 10:10:11","2019-04-25 19:00:00","2019-04-25 19:30:00",3837,1100,4937
"2019-04-24 10:10:11","2019-04-25 20:00:00","2019-04-25 20:30:00",3724,1045,4769
"2019-04-24 10:10:11","2019-04-25 21:00:00","2019-04-25 21:30:00",3858,1065,4923
"2019-04-24 10:10:11","2019-04-25 22:00:00","2019-04-25 22:30:00",3658,977,4635
"2019-04-25 10:10:31","2019-04-25 23:00:00","2019-04-25 23:30:00",3042,828,3870
"2019-04-25 10:10:31","2019-04-26 00:00:00","2019-04-26 00:30:00",2802,743,3545
"2019-04-25 10:10:31","2019-04-26 01:00:00","2019-04-26 01:30:00",2699,668,3367
"2019-04-25 10:10:31","2019-04-26 02:00:00","2019-04-26 02:30:00",2576,615,3191
"2019-04-25 10:10:31","2019-04-26 03:00:00","2019-04-26 03:30:00",2488,608,3096
"2019-04-25 10:10:31","2019-04-26 04:00:00","2019-04-26 04:30:00",2450,604,3054
"2019-04-25 10:10:31","2019-04-26 05:00:00","2019-04-26 05:30:00",2495,613,3108
"2019-04-25 10:10:31","2019-04-26 06:00:00","2019-04-26 06:30:00",2598,656,3254
"2019-04-25 10:10:31","2019-04-26 07:00:00","2019-04-26 07:30:00",3028,778,3806
"2019-04-25 10:10:31","2019-04-26 08:00:00","2019-04-26 08:30:00",3608,954,4562
"2019-04-25 10:10:31","2019-04-26 09:00:00","2019-04-26 09:30:00",3759,1091,4850
"2019-04-25 10:10:31","2019-04-26 10:00:00","2019-04-26 10:30:00",3790,1121,4911
"2019-04-25 10:10:31","2019-04-26 11:00:00","2019-04-26 11:30:00",3780,1108,4888
"2019-04-25 10:10:31","2019-04-26 12:00:00","2019-04-26 12:30:00",3752,1087,4839
"2019-04-25 10:10:31","2019-04-26 13:00:00","2019-04-26 13:30:00",3746,1081,4827
"2019-04-25 10:10:31","2019-04-26 14:00:00","2019-04-26 14:30:00",3634,1006,4640
"2019-04-25 10:10:31","2019-04-26 15:00:00","2019-04-26 15:30:00",3603,956,4559
"2019-04-25 10:10:31","2019-04-26 16:00:00","2019-04-26 16:30:00",3589,973,4562
"2019-04-25 10:10:31","2019-04-26 17:00:00","2019-04-26 17:30:00",3634,1052,4686
"2019-04-25 10:10:31","2019-04-26 18:00:00","2019-04-26 18:30:00",3646,1132,4778
"2019-04-25 10:10:31","2019-04-26 19:00:00","2019-04-26 19:30:00",3547,1100,4647
"2019-04-25 10:10:31","2019-04-26 20:00:00","2019-04-26 20:30:00",3425,1073,4498
"2019-04-25 10:10:31","2019-04-26 21:00:00","2019-04-26 21:30:00",3487,1023,4510
"2019-04-25 10:10:31","2019-04-26 22:00:00","2019-04-26 22:30:00",3386,977,4363
"2019-04-26 10:10:15","2019-04-26 23:00:00","2019-04-26 23:30:00",3068,860,3928
"2019-04-26 10:10:15","2019-04-27 00:00:00","2019-04-27 00:30:00",2937,741,3678
"2019-04-26 10:10:15","2019-04-27 01:00:00","2019-04-27 01:30:00",2790,634,3424
"2019-04-26 10:10:15","2019-04-27 02:00:00","2019-04-27 02:30:00",2624,607,3231
"2019-04-26 10:10:15","2019-04-27 03:00:00","2019-04-27 03:30:00",2511,599,3110
"2019-04-26 10:10:15","2019-04-27 04:00:00","2019-04-27 04:30:00",2450,576,3026
"2019-04-26 10:10:15","2019-04-27 05:00:00","2019-04-27 05:30:00",2471,590,3061
"2019-04-26 10:10:15","2019-04-27 06:00:00","2019-04-27 06:30:00",2538,596,3134
"2019-04-26 10:10:15","2019-04-27 07:00:00","2019-04-27 07:30:00",2655,638,3293
"2019-04-26 10:10:15","2019-04-27 08:00:00","2019-04-27 08:30:00",3042,748,3790
"2019-04-26 10:10:15","2019-04-27 09:00:00","2019-04-27 09:30:00",3392,867,4259
"2019-04-26 10:10:15","2019-04-27 10:00:00","2019-04-27 10:30:00",3545,949,4494
"2019-04-26 10:10:15","2019-04-27 11:00:00","2019-04-27 11:30:00",3594,945,4539
"2019-04-26 10:10:15","2019-04-27 12:00:00","2019-04-27 12:30:00",3579,956,4535
"2019-04-26 10:10:15","2019-04-27 13:00:00","2019-04-27 13:30:00",3541,917,4458
"2019-04-26 10:10:15","2019-04-27 14:00:00","2019-04-27 14:30:00",3396,865,4261
"2019-04-26 10:10:15","2019-04-27 15:00:00","2019-04-27 15:30:00",3317,833,4150
"2019-04-26 10:10:15","2019-04-27 16:00:00","2019-04-27 16:30:00",3300,838,4138
"2019-04-26 10:10:15","2019-04-27 17:00:00","2019-04-27 17:30:00",3391,879,4270
"2019-04-26 10:10:15","2019-04-27 18:00:00","2019-04-27 18:30:00",3548,961,4509
"2019-04-26 10:10:15","2019-04-27 19:00:00","2019-04-27 19:30:00",3507,955,4462
"2019-04-26 10:10:15","2019-04-27 20:00:00","2019-04-27 20:30:00",3384,923,4307
"2019-04-26 10:10:15","2019-04-27 21:00:00","2019-04-27 21:30:00",3453,949,4402
"2019-04-26 10:10:15","2019-04-27 22:00:00","2019-04-27 22:30:00",3305,904,4209
"2019-04-27 10:10:36","2019-04-27 23:00:00","2019-04-27 23:30:00",3060,787,3847
"2019-04-27 10:10:36","2019-04-28 00:00:00","2019-04-28 00:30:00",2874,681,3555
"2019-04-27 10:10:36","2019-04-28 01:00:00","2019-04-28 01:30:00",2768,602,3370
"2019-04-27 10:10:36","2019-04-28 02:00:00","2019-04-28 02:30:00",2608,576,3184
"2019-04-27 10:10:36","2019-04-28 03:00:00","2019-04-28 03:30:00",2473,523,2996
"2019-04-27 10:10:36","2019-04-28 04:00:00","2019-04-28 04:30:00",2395,525,2920
"2019-04-27 10:10:36","2019-04-28 05:00:00","2019-04-28 05:30:00",2385,544,2929
"2019-04-27 10:10:36","2019-04-28 06:00:00","2019-04-28 06:30:00",2403,558,2961
"2019-04-27 10:10:36","2019-04-28 07:00:00","2019-04-28 07:30:00",2424,596,3020
"2019-04-27 10:10:36","2019-04-28 08:00:00","2019-04-28 08:30:00",2672,692,3364
"2019-04-27 10:10:36","2019-04-28 09:00:00","2019-04-28 09:30:00",2939,807,3746
"2019-04-27 10:10:36","2019-04-28 10:00:00","2019-04-28 10:30:00",3167,885,4052
"2019-04-27 10:10:36","2019-04-28 11:00:00","2019-04-28 11:30:00",3248,897,4145
"2019-04-27 10:10:36","2019-04-28 12:00:00","2019-04-28 12:30:00",3276,923,4199
"2019-04-27 10:10:36","2019-04-28 13:00:00","2019-04-28 13:30:00",3328,954,4282
"2019-04-27 10:10:36","2019-04-28 14:00:00","2019-04-28 14:30:00",3215,882,4097
"2019-04-27 10:10:36","2019-04-28 15:00:00","2019-04-28 15:30:00",3049,818,3867
"2019-04-27 10:10:36","2019-04-28 16:00:00","2019-04-28 16:30:00",3070,817,3887
"2019-04-27 10:10:36","2019-04-28 17:00:00","2019-04-28 17:30:00",3064,881,3945
"2019-04-27 10:10:36","2019-04-28 18:00:00","2019-04-28 18:30:00",3180,923,4103
"2019-04-27 10:10:36","2019-04-28 19:00:00","2019-04-28 19:30:00",3233,907,4140
"2019-04-27 10:10:36","2019-04-28 20:00:00","2019-04-28 20:30:00",3176,899,4075
"2019-04-27 10:10:36","2019-04-28 21:00:00","2019-04-28 21:30:00",3304,963,4267
"2019-04-27 10:10:36","2019-04-28 22:00:00","2019-04-28 22:30:00",3199,886,4085
"2019-04-28 10:10:21","2019-04-28 23:00:00","2019-04-28 23:30:00",2864,778,3642
"2019-04-28 10:10:21","2019-04-29 00:00:00","2019-04-29 00:30:00",2732,608,3340
"2019-04-28 10:10:21","2019-04-29 01:00:00","2019-04-29 01:30:00",2658,572,3230
"2019-04-28 10:10:21","2019-04-29 02:00:00","2019-04-29 02:30:00",2543,561,3104
"2019-04-28 10:10:21","2019-04-29 03:00:00","2019-04-29 03:30:00",2461,566,3027
"2019-04-28 10:10:21","2019-04-29 04:00:00","2019-04-29 04:30:00",2421,542,2963
"2019-04-28 10:10:21","2019-04-29 05:00:00","2019-04-29 05:30:00",2466,587,3053
"2019-04-28 10:10:21","2019-04-29 06:00:00","2019-04-29 06:30:00",2675,652,3327
"2019-04-28 10:10:21","2019-04-29 07:00:00","2019-04-29 07:30:00",3132,840,3972
"2019-04-28 10:10:21","2019-04-29 08:00:00","2019-04-29 08:30:00",3698,1045,4743
"2019-04-28 10:10:21","2019-04-29 09:00:00","2019-04-29 09:30:00",3866,1095,4961
"2019-04-28 10:10:21","2019-04-29 10:00:00","2019-04-29 10:30:00",3873,1100,4973
"2019-04-28 10:10:21","2019-04-29 11:00:00","2019-04-29 11:30:00",3872,1113,4985
"2019-04-28 10:10:21","2019-04-29 12:00:00","2019-04-29 12:30:00",3881,1121,5002
"2019-04-28 10:10:21","2019-04-29 13:00:00","2019-04-29 13:30:00",3897,1096,4993
"2019-04-28 10:10:21","2019-04-29 14:00:00","2019-04-29 14:30:00",3792,1040,4832
"2019-04-28 10:10:21","2019-04-29 15:00:00","2019-04-29 15:30:00",3815,1000,4815
"2019-04-28 10:10:21","2019-04-29 16:00:00","2019-04-29 16:30:00",3869,1070,4939
"2019-04-28 10:10:21","2019-04-29 17:00:00","2019-04-29 17:30:00",3979,1148,5127
"2019-04-28 10:10:21","2019-04-29 18:00:00","2019-04-29 18:30:00",4077,1095,5172
"2019-04-28 10:10:21","2019-04-29 19:00:00","2019-04-29 19:30:00",3937,982,4919
"2019-04-28 10:10:21","2019-04-29 20:00:00","2019-04-29 20:30:00",3979,943,4922
"2019-04-28 10:10:21","2019-04-29 21:00:00","2019-04-29 21:30:00",3975,1020,4995
"2019-04-28 10:10:21","2019-04-29 22:00:00","2019-04-29 22:30:00",3565,978,4543
"2019-04-29 10:10:36","2019-04-29 23:00:00","2019-04-29 23:30:00",3170,817,3987
"2019-04-29 10:10:36","2019-04-30 00:00:00","2019-04-30 00:30:00",2880,673,3553
"2019-04-29 10:10:36","2019-04-30 01:00:00","2019-04-30 01:30:00",2803,606,3409
"2019-04-29 10:10:36","2019-04-30 02:00:00","2019-04-30 02:30:00",2714,572,3286
"2019-04-29 10:10:36","2019-04-30 03:00:00","2019-04-30 03:30:00",2624,564,3188
"2019-04-29 10:10:36","2019-04-30 04:00:00","2019-04-30 04:30:00",2558,555,3113
"2019-04-29 10:10:36","2019-04-30 05:00:00","2019-04-30 05:30:00",2579,568,3147
"2019-04-29 10:10:36","2019-04-30 06:00:00","2019-04-30 06:30:00",2823,604,3427
"2019-04-29 10:10:36","2019-04-30 07:00:00","2019-04-30 07:30:00",3272,712,3984
"2019-04-29 10:10:36","2019-04-30 08:00:00","2019-04-30 08:30:00",3791,884,4675
"2019-04-29 10:10:36","2019-04-30 09:00:00","2019-04-30 09:30:00",3913,997,4910
"2019-04-29 10:10:36","2019-04-30 10:00:00","2019-04-30 10:30:00",3879,995,4874
"2019-04-29 10:10:36","2019-04-30 11:00:00","2019-04-30 11:30:00",3906,1004,4910
"2019-04-29 10:10:36","2019-04-30 12:00:00","2019-04-30 12:30:00",3940,1023,4963
"2019-04-29 10:10:36","2019-04-30 13:00:00","2019-04-30 13:30:00",3927,1026,4953
"2019-04-29 10:10:36","2019-04-30 14:00:00","2019-04-30 14:30:00",3835,1006,4841
"2019-04-29 10:10:36","2019-04-30 15:00:00","2019-04-30 15:30:00",3866,984,4850
"2019-04-29 10:10:36","2019-04-30 16:00:00","2019-04-30 16:30:00",3878,1007,4885
"2019-04-29 10:10:36","2019-04-30 17:00:00","2019-04-30 17:30:00",4066,1083,5149
"2019-04-29 10:10:36","2019-04-30 18:00:00","2019-04-30 18:30:00",4121,1110,5231
"2019-04-29 10:10:36","2019-04-30 19:00:00","2019-04-30 19:30:00",4010,1053,5063
"2019-04-29 10:10:36","2019-04-30 20:00:00","2019-04-30 20:30:00",3987,1006,4993
"2019-04-29 10:10:36","2019-04-30 21:00:00","2019-04-30 21:30:00",4047,1039,5086
"2019-04-29 10:10:36","2019-04-30 22:00:00","2019-04-30 22:30:00",3769,959,4728
"2019-04-30 10:10:20","2019-04-30 23:00:00","2019-04-30 23:30:00",3250,890,4140
"2019-04-30 10:10:20","2019-05-01 00:00:00","2019-05-01 00:30:00",2803,717,3520
"2019-04-30 10:10:20","2019-05-01 01:00:00","2019-05-01 01:30:00",2698,651,3349
"2019-04-30 10:10:20","2019-05-01 02:00:00","2019-05-01 02:30:00",2590,618,3208
"2019-04-30 10:10:20","2019-05-01 03:00:00","2019-05-01 03:30:00",2513,614,3127
"2019-04-30 10:10:20","2019-05-01 04:00:00","2019-05-01 04:30:00",2506,605,3111
"2019-04-30 10:10:20","2019-05-01 05:00:00","2019-05-01 05:30:00",2548,619,3167
"2019-04-30 10:10:20","2019-05-01 06:00:00","2019-05-01 06:30:00",2701,658,3359
"2019-04-30 10:10:20","2019-05-01 07:00:00","2019-05-01 07:30:00",3149,777,3926
"2019-04-30 10:10:20","2019-05-01 08:00:00","2019-05-01 08:30:00",3697,956,4653
"2019-04-30 10:10:20","2019-05-01 09:00:00","2019-05-01 09:30:00",3846,1033,4879
"2019-04-30 10:10:20","2019-05-01 10:00:00","2019-05-01 10:30:00",3892,1027,4919
"2019-04-30 10:10:20","2019-05-01 11:00:00","2019-05-01 11:30:00",3908,1019,4927
"2019-04-30 10:10:20","2019-05-01 12:00:00","2019-05-01 12:30:00",3932,1021,4953
"2019-04-30 10:10:20","2019-05-01 13:00:00","2019-05-01 13:30:00",3947,1004,4951
"2019-04-30 10:10:20","2019-05-01 14:00:00","2019-05-01 14:30:00",3841,976,4817
"2019-04-30 10:10:20","2019-05-01 15:00:00","2019-05-01 15:30:00",3851,953,4804
"2019-04-30 10:10:20","2019-05-01 16:00:00","2019-05-01 16:30:00",3871,988,4859
"2019-04-30 10:10:20","2019-05-01 17:00:00","2019-05-01 17:30:00",4023,1082,5105
"2019-04-30 10:10:20","2019-05-01 18:00:00","2019-05-01 18:30:00",4100,1128,5228
"2019-04-30 10:10:20","2019-05-01 19:00:00","2019-05-01 19:30:00",3918,1055,4973
"2019-04-30 10:10:20","2019-05-01 20:00:00","2019-05-01 20:30:00",3816,1031,4847
"2019-04-30 10:10:20","2019-05-01 21:00:00","2019-05-01 21:30:00",3841,1044,4885
"2019-04-30 10:10:20","2019-05-01 22:00:00","2019-05-01 22:30:00",3598,967,4565
"2019-05-01 10:10:35","2019-05-01 23:00:00","2019-05-01 23:30:00",3250,852,4102
"2019-05-01 10:10:35","2019-05-02 00:00:00","2019-05-02 00:30:00",2774,739,3513
"2019-05-01 10:10:35","2019-05-02 01:00:00","2019-05-02 01:30:00",2679,668,3347
"2019-05-01 10:10:35","2019-05-02 02:00:00","2019-05-02 02:30:00",2581,638,3219
"2019-05-01 10:10:35","2019-05-02 03:00:00","2019-05-02 03:30:00",2512,635,3147
"2019-05-01 10:10:35","2019-05-02 04:00:00","2019-05-02 04:30:00",2505,617,3122
"2019-05-01 10:10:35","2019-05-02 05:00:00","2019-05-02 05:30:00",2544,643,3187
"2019-05-01 10:10:35","2019-05-02 06:00:00","2019-05-02 06:30:00",2682,678,3360
"2019-05-01 10:10:35","2019-05-02 07:00:00","2019-05-02 07:30:00",3088,823,3911
"2019-05-01 10:10:35","2019-05-02 08:00:00","2019-05-02 08:30:00",3585,1021,4606
"2019-05-01 10:10:35","2019-05-02 09:00:00","2019-05-02 09:30:00",3720,1090,4810
"2019-05-01 10:10:35","2019-05-02 10:00:00","2019-05-02 10:30:00",3762,1101,4863
"2019-05-01 10:10:35","2019-05-02 11:00:00","2019-05-02 11:30:00",3776,1116,4892
"2019-05-01 10:10:35","2019-05-02 12:00:00","2019-05-02 12:30:00",3798,1117,4915
"2019-05-01 10:10:35","2019-05-02 13:00:00","2019-05-02 13:30:00",3811,1089,4900
"2019-05-01 10:10:35","2019-05-02 14:00:00","2019-05-02 14:30:00",3716,1074,4790
"2019-05-01 10:10:35","2019-05-02 15:00:00","2019-05-02 15:30:00",3725,1039,4764
"2019-05-01 10:10:35","2019-05-02 16:00:00","2019-05-02 16:30:00",3742,1067,4809
"2019-05-01 10:10:35","2019-05-02 17:00:00","2019-05-02 17:30:00",3880,1116,4996
"2019-05-01 10:10:35","2019-05-02 18:00:00","2019-05-02 18:30:00",3950,1141,5091
"2019-05-01 10:10:35","2019-05-02 19:00:00","2019-05-02 19:30:00",3785,1070,4855
"2019-05-01 10:10:35","2019-05-02 20:00:00","2019-05-02 20:30:00",3693,1009,4702
"2019-05-01 10:10:35","2019-05-02 21:00:00","2019-05-02 21:30:00",3715,1029,4744
"2019-05-01 10:10:35","2019-05-02 22:00:00","2019-05-02 22:30:00",3495,954,4449
"2019-05-02 10:10:20","2019-05-02 23:00:00","2019-05-02 23:30:00",3180,869,4049
"2019-05-02 10:10:20","2019-05-03 00:00:00","2019-05-03 00:30:00",2821,746,3567
"2019-05-02 10:10:20","2019-05-03 01:00:00","2019-05-03 01:30:00",2696,692,3388
"2019-05-02 10:10:20","2019-05-03 02:00:00","2019-05-03 02:30:00",2518,674,3192
"2019-05-02 10:10:20","2019-05-03 03:00:00","2019-05-03 03:30:00",2444,663,3107
"2019-05-02 10:10:20","2019-05-03 04:00:00","2019-05-03 04:30:00",2405,637,3042
"2019-05-02 10:10:20","2019-05-03 05:00:00","2019-05-03 05:30:00",2421,644,3065
"2019-05-02 10:10:20","2019-05-03 06:00:00","2019-05-03 06:30:00",2549,690,3239
"2019-05-02 10:10:20","2019-05-03 07:00:00","2019-05-03 07:30:00",3072,826,3898
"2019-05-02 10:10:20","2019-05-03 08:00:00","2019-05-03 08:30:00",3687,1010,4697
"2019-05-02 10:10:20","2019-05-03 09:00:00","2019-05-03 09:30:00",3861,1126,4987
"2019-05-02 10:10:20","2019-05-03 10:00:00","2019-05-03 10:30:00",3883,1087,4970
"2019-05-02 10:10:20","2019-05-03 11:00:00","2019-05-03 11:30:00",3883,1149,5032
"2019-05-02 10:10:20","2019-05-03 12:00:00","2019-05-03 12:30:00",3832,1106,4938
"2019-05-02 10:10:20","2019-05-03 13:00:00","2019-05-03 13:30:00",3830,1042,4872
"2019-05-02 10:10:20","2019-05-03 14:00:00","2019-05-03 14:30:00",3705,991,4696
"2019-05-02 10:10:20","2019-05-03 15:00:00","2019-05-03 15:30:00",3636,1006,4642
"2019-05-02 10:10:20","2019-05-03 16:00:00","2019-05-03 16:30:00",3658,991,4649
"2019-05-02 10:10:20","2019-05-03 17:00:00","2019-05-03 17:30:00",3703,1048,4751
"2019-05-02 10:10:20","2019-05-03 18:00:00","2019-05-03 18:30:00",3773,1033,4806
"2019-05-02 10:10:20","2019-05-03 19:00:00","2019-05-03 19:30:00",3630,1003,4633
"2019-05-02 10:10:20","2019-05-03 20:00:00","2019-05-03 20:30:00",3453,973,4426
"2019-05-02 10:10:20","2019-05-03 21:00:00","2019-05-03 21:30:00",3438,1002,4440
"2019-05-02 10:10:20","2019-05-03 22:00:00","2019-05-03 22:30:00",3457,930,4387
"2019-05-03 10:10:35","2019-05-03 23:00:00","2019-05-03 23:30:00",3099,840,3939
"2019-05-03 10:10:35","2019-05-04 00:00:00","2019-05-04 00:30:00",2871,760,3631
"2019-05-03 10:10:35","2019-05-04 01:00:00","2019-05-04 01:30:00",2699,683,3382
"2019-05-03 10:10:35","2019-05-04 02:00:00","2019-05-04 02:30:00",2519,650,3169
"2019-05-03 10:10:35","2019-05-04 03:00:00","2019-05-04 03:30:00",2397,637,3034
"2019-05-03 10:10:35","2019-05-04 04:00:00","2019-05-04 04:30:00",2370,629,2999
"2019-05-03 10:10:35","2019-05-04 05:00:00","2019-05-04 05:30:00",2359,634,2993
"2019-05-03 10:10:35","2019-05-04 06:00:00","2019-05-04 06:30:00",2340,629,2969
"2019-05-03 10:10:35","2019-05-04 07:00:00","2019-05-04 07:30:00",2555,714,3269
"2019-05-03 10:10:35","2019-05-04 08:00:00","2019-05-04 08:30:00",2929,831,3760
"2019-05-03 10:10:35","2019-05-04 09:00:00","2019-05-04 09:30:00",3291,945,4236
"2019-05-03 10:10:35","2019-05-04 10:00:00","2019-05-04 10:30:00",3470,969,4439
"2019-05-03 10:10:35","2019-05-04 11:00:00","2019-05-04 11:30:00",3483,976,4459
"2019-05-03 10:10:35","2019-05-04 12:00:00","2019-05-04 12:30:00",3478,958,4436
"2019-05-03 10:10:35","2019-05-04 13:00:00","2019-05-04 13:30:00",3415,924,4339
"2019-05-03 10:10:35","2019-05-04 14:00:00","2019-05-04 14:30:00",3277,866,4143
"2019-05-03 10:10:35","2019-05-04 15:00:00","2019-05-04 15:30:00",3205,860,4065
"2019-05-03 10:10:35","2019-05-04 16:00:00","2019-05-04 16:30:00",3191,868,4059
"2019-05-03 10:10:35","2019-05-04 17:00:00","2019-05-04 17:30:00",3272,949,4221
"2019-05-03 10:10:35","2019-05-04 18:00:00","2019-05-04 18:30:00",3374,993,4367
"2019-05-03 10:10:35","2019-05-04 19:00:00","2019-05-04 19:30:00",3299,968,4267
"2019-05-03 10:10:35","2019-05-04 20:00:00","2019-05-04 20:30:00",3149,927,4076
"2019-05-03 10:10:35","2019-05-04 21:00:00","2019-05-04 21:30:00",3100,921,4021
"2019-05-03 10:10:35","2019-05-04 22:00:00","2019-05-04 22:30:00",3175,926,4101
"2019-05-04 10:10:25","2019-05-04 23:00:00","2019-05-04 23:30:00",2921,780,3701
"2019-05-04 10:10:25","2019-05-05 00:00:00","2019-05-05 00:30:00",2833,711,3544
"2019-05-04 10:10:25","2019-05-05 01:00:00","2019-05-05 01:30:00",2714,653,3367
"2019-05-04 10:10:25","2019-05-05 02:00:00","2019-05-05 02:30:00",2565,619,3184
"2019-05-04 10:10:25","2019-05-05 03:00:00","2019-05-05 03:30:00",2455,608,3063
"2019-05-04 10:10:25","2019-05-05 04:00:00","2019-05-05 04:30:00",2420,583,3003
"2019-05-04 10:10:25","2019-05-05 05:00:00","2019-05-05 05:30:00",2408,581,2989
"2019-05-04 10:10:25","2019-05-05 06:00:00","2019-05-05 06:30:00",2350,572,2922
"2019-05-04 10:10:25","2019-05-05 07:00:00","2019-05-05 07:30:00",2467,638,3105
"2019-05-04 10:10:25","2019-05-05 08:00:00","2019-05-05 08:30:00",2714,712,3426
"2019-05-04 10:10:25","2019-05-05 09:00:00","2019-05-05 09:30:00",3030,798,3828
"2019-05-04 10:10:25","2019-05-05 10:00:00","2019-05-05 10:30:00",3235,912,4147
"2019-05-04 10:10:25","2019-05-05 11:00:00","2019-05-05 11:30:00",3330,924,4254
"2019-05-04 10:10:25","2019-05-05 12:00:00","2019-05-05 12:30:00",3390,985,4375
"2019-05-04 10:10:25","2019-05-05 13:00:00","2019-05-05 13:30:00",3371,1043,4414
"2019-05-04 10:10:25","2019-05-05 14:00:00","2019-05-05 14:30:00",3226,965,4191
"2019-05-04 10:10:25","2019-05-05 15:00:00","2019-05-05 15:30:00",3129,940,4069
"2019-05-04 10:10:25","2019-05-05 16:00:00","2019-05-05 16:30:00",3065,934,3999
"2019-05-04 10:10:25","2019-05-05 17:00:00","2019-05-05 17:30:00",3116,971,4087
"2019-05-04 10:10:25","2019-05-05 18:00:00","2019-05-05 18:30:00",3210,992,4202
"2019-05-04 10:10:25","2019-05-05 19:00:00","2019-05-05 19:30:00",3164,970,4134
"2019-05-04 10:10:25","2019-05-05 20:00:00","2019-05-05 20:30:00",3084,968,4052
"2019-05-04 10:10:25","2019-05-05 21:00:00","2019-05-05 21:30:00",3069,998,4067
"2019-05-04 10:10:25","2019-05-05 22:00:00","2019-05-05 22:30:00",3131,924,4055
"2019-05-05 10:10:11","2019-05-05 23:00:00","2019-05-05 23:30:00",2927,808,3735
"2019-05-05 10:10:11","2019-05-06 00:00:00","2019-05-06 00:30:00",2665,717,3382
"2019-05-05 10:10:11","2019-05-06 01:00:00","2019-05-06 01:30:00",2586,641,3227
"2019-05-05 10:10:11","2019-05-06 02:00:00","2019-05-06 02:30:00",2472,616,3088
"2019-05-05 10:10:11","2019-05-06 03:00:00","2019-05-06 03:30:00",2404,611,3015
"2019-05-05 10:10:11","2019-05-06 04:00:00","2019-05-06 04:30:00",2381,608,2989
"2019-05-05 10:10:11","2019-05-06 05:00:00","2019-05-06 05:30:00",2402,608,3010
"2019-05-05 10:10:11","2019-05-06 06:00:00","2019-05-06 06:30:00",2400,618,3018
"2019-05-05 10:10:11","2019-05-06 07:00:00","2019-05-06 07:30:00",2537,681,3218
"2019-05-05 10:10:11","2019-05-06 08:00:00","2019-05-06 08:30:00",2791,760,3551
"2019-05-05 10:10:11","2019-05-06 09:00:00","2019-05-06 09:30:00",3059,842,3901
"2019-05-05 10:10:11","2019-05-06 10:00:00","2019-05-06 10:30:00",3277,917,4194
"2019-05-05 10:10:11","2019-05-06 11:00:00","2019-05-06 11:30:00",3397,947,4344
"2019-05-05 10:10:11","2019-05-06 12:00:00","2019-05-06 12:30:00",3435,959,4394
"2019-05-05 10:10:11","2019-05-06 13:00:00","2019-05-06 13:30:00",3432,946,4378
"2019-05-05 10:10:11","2019-05-06 14:00:00","2019-05-06 14:30:00",3356,897,4253
"2019-05-05 10:10:11","2019-05-06 15:00:00","2019-05-06 15:30:00",3280,891,4171
"2019-05-05 10:10:11","2019-05-06 16:00:00","2019-05-06 16:30:00",3247,922,4169
"2019-05-05 10:10:11","2019-05-06 17:00:00","2019-05-06 17:30:00",3370,1012,4382
"2019-05-05 10:10:11","2019-05-06 18:00:00","2019-05-06 18:30:00",3500,1022,4522
"2019-05-05 10:10:11","2019-05-06 19:00:00","2019-05-06 19:30:00",3430,985,4415
"2019-05-05 10:10:11","2019-05-06 20:00:00","2019-05-06 20:30:00",3329,977,4306
"2019-05-05 10:10:11","2019-05-06 21:00:00","2019-05-06 21:30:00",3296,981,4277
"2019-05-05 10:10:11","2019-05-06 22:00:00","2019-05-06 22:30:00",3232,993,4225
"2019-05-06 10:10:26","2019-05-06 23:00:00","2019-05-06 23:30:00",2849,847,3696
"2019-05-06 10:10:26","2019-05-07 00:00:00","2019-05-07 00:30:00",2740,765,3505
"2019-05-06 10:10:26","2019-05-07 01:00:00","2019-05-07 01:30:00",2645,687,3332
"2019-05-06 10:10:26","2019-05-07 02:00:00","2019-05-07 02:30:00",2531,657,3188
"2019-05-06 10:10:26","2019-05-07 03:00:00","2019-05-07 03:30:00",2440,639,3079
"2019-05-06 10:10:26","2019-05-07 04:00:00","2019-05-07 04:30:00",2447,627,3074
"2019-05-06 10:10:26","2019-05-07 05:00:00","2019-05-07 05:30:00",2489,650,3139
"2019-05-06 10:10:26","2019-05-07 06:00:00","2019-05-07 06:30:00",2641,691,3332
"2019-05-06 10:10:26","2019-05-07 07:00:00","2019-05-07 07:30:00",3104,859,3963
"2019-05-06 10:10:26","2019-05-07 08:00:00","2019-05-07 08:30:00",3676,1050,4726
"2019-05-06 10:10:26","2019-05-07 09:00:00","2019-05-07 09:30:00",3801,1123,4924
"2019-05-06 10:10:26","2019-05-07 10:00:00","2019-05-07 10:30:00",3804,1140,4944
"2019-05-06 10:10:26","2019-05-07 11:00:00","2019-05-07 11:30:00",3809,1140,4949
"2019-05-06 10:10:26","2019-05-07 12:00:00","2019-05-07 12:30:00",3800,1139,4939
"2019-05-06 10:10:26","2019-05-07 13:00:00","2019-05-07 13:30:00",3812,1147,4959
"2019-05-06 10:10:26","2019-05-07 14:00:00","2019-05-07 14:30:00",3678,1096,4774
"2019-05-06 10:10:26","2019-05-07 15:00:00","2019-05-07 15:30:00",3710,1087,4797
"2019-05-06 10:10:26","2019-05-07 16:00:00","2019-05-07 16:30:00",3724,1097,4821
"2019-05-06 10:10:26","2019-05-07 17:00:00","2019-05-07 17:30:00",3906,1189,5095
"2019-05-06 10:10:26","2019-05-07 18:00:00","2019-05-07 18:30:00",3996,1182,5178
"2019-05-06 10:10:26","2019-05-07 19:00:00","2019-05-07 19:30:00",3825,1112,4937
"2019-05-06 10:10:26","2019-05-07 20:00:00","2019-05-07 20:30:00",3742,1031,4773
"2019-05-06 10:10:26","2019-05-07 21:00:00","2019-05-07 21:30:00",3797,1045,4842
"2019-05-06 10:10:26","2019-05-07 22:00:00","2019-05-07 22:30:00",3528,993,4521
"2019-05-07 10:10:10","2019-05-07 23:00:00","2019-05-07 23:30:00",3194,842,4036
"2019-05-07 10:10:10","2019-05-08 00:00:00","2019-05-08 00:30:00",2844,719,3563
"2019-05-07 10:10:10","2019-05-08 01:00:00","2019-05-08 01:30:00",2719,647,3366
"2019-05-07 10:10:10","2019-05-08 02:00:00","2019-05-08 02:30:00",2595,615,3210
"2019-05-07 10:10:10","2019-05-08 03:00:00","2019-05-08 03:30:00",2480,602,3082
"2019-05-07 10:10:10","2019-05-08 04:00:00","2019-05-08 04:30:00",2472,593,3065
"2019-05-07 10:10:10","2019-05-08 05:00:00","2019-05-08 05:30:00",2470,609,3079
"2019-05-07 10:10:10","2019-05-08 06:00:00","2019-05-08 06:30:00",2645,646,3291
"2019-05-07 10:10:10","2019-05-08 07:00:00","2019-05-08 07:30:00",3144,798,3942
"2019-05-07 10:10:10","2019-05-08 08:00:00","2019-05-08 08:30:00",3708,982,4690
"2019-05-07 10:10:10","2019-05-08 09:00:00","2019-05-08 09:30:00",3851,1055,4906
"2019-05-07 10:10:10","2019-05-08 10:00:00","2019-05-08 10:30:00",3863,1069,4932
"2019-05-07 10:10:10","2019-05-08 11:00:00","2019-05-08 11:30:00",3832,1073,4905
"2019-05-07 10:10:10","2019-05-08 12:00:00","2019-05-08 12:30:00",3847,1079,4926
"2019-05-07 10:10:10","2019-05-08 13:00:00","2019-05-08 13:30:00",3859,1087,4946
"2019-05-07 10:10:10","2019-05-08 14:00:00","2019-05-08 14:30:00",3759,1037,4796
"2019-05-07 10:10:10","2019-05-08 15:00:00","2019-05-08 15:30:00",3789,1026,4815
"2019-05-07 10:10:10","2019-05-08 16:00:00","2019-05-08 16:30:00",3850,1035,4885
"2019-05-07 10:10:10","2019-05-08 17:00:00","2019-05-08 17:30:00",3933,1129,5062
"2019-05-07 10:10:10","2019-05-08 18:00:00","2019-05-08 18:30:00",3987,1133,5120
"2019-05-07 10:10:10","2019-05-08 19:00:00","2019-05-08 19:30:00",3840,1067,4907
"2019-05-07 10:10:10","2019-05-08 20:00:00","2019-05-08 20:30:00",3704,990,4694
"2019-05-07 10:10:10","2019-05-08 21:00:00","2019-05-08 21:30:00",3663,998,4661
"2019-05-07 10:10:10","2019-05-08 22:00:00","2019-05-08 22:30:00",3604,964,4568
"2019-05-08 10:10:50","2019-05-08 23:00:00","2019-05-08 23:30:00",3189,869,4058
"2019-05-08 10:10:50","2019-05-09 00:00:00","2019-05-09 00:30:00",2831,712,3543
"2019-05-08 10:10:50","2019-05-09 01:00:00","2019-05-09 01:30:00",2735,643,3378
"2019-05-08 10:10:50","2019-05-09 02:00:00","2019-05-09 02:30:00",2620,617,3237
"2019-05-08 10:10:50","2019-05-09 03:00:00","2019-05-09 03:30:00",2533,612,3145
"2019-05-08 10:10:50","2019-05-09 04:00:00","2019-05-09 04:30:00",2521,608,3129
"2019-05-08 10:10:50","2019-05-09 05:00:00","2019-05-09 05:30:00",2573,615,3188
"2019-05-08 10:10:50","2019-05-09 06:00:00","2019-05-09 06:30:00",2717,655,3372
"2019-05-08 10:10:50","2019-05-09 07:00:00","2019-05-09 07:30:00",3210,826,4036
"2019-05-08 10:10:50","2019-05-09 08:00:00","2019-05-09 08:30:00",3767,1020,4787
"2019-05-08 10:10:50","2019-05-09 09:00:00","2019-05-09 09:30:00",3897,1101,4998
"2019-05-08 10:10:50","2019-05-09 10:00:00","2019-05-09 10:30:00",3905,1117,5022
"2019-05-08 10:10:50","2019-05-09 11:00:00","2019-05-09 11:30:00",3861,1140,5001
"2019-05-08 10:10:50","2019-05-09 12:00:00","2019-05-09 12:30:00",3862,1136,4998
"2019-05-08 10:10:50","2019-05-09 13:00:00","2019-05-09 13:30:00",3872,1141,5013
"2019-05-08 10:10:50","2019-05-09 14:00:00","2019-05-09 14:30:00",3811,1084,4895
"2019-05-08 10:10:50","2019-05-09 15:00:00","2019-05-09 15:30:00",3797,1076,4873
"2019-05-08 10:10:50","2019-05-09 16:00:00","2019-05-09 16:30:00",3869,1099,4968
"2019-05-08 10:10:50","2019-05-09 17:00:00","2019-05-09 17:30:00",3990,1207,5197
"2019-05-08 10:10:50","2019-05-09 18:00:00","2019-05-09 18:30:00",4043,1195,5238
"2019-05-08 10:10:50","2019-05-09 19:00:00","2019-05-09 19:30:00",3895,1111,5006
"2019-05-08 10:10:50","2019-05-09 20:00:00","2019-05-09 20:30:00",3759,1051,4810
"2019-05-08 10:10:50","2019-05-09 21:00:00","2019-05-09 21:30:00",3806,1054,4860
"2019-05-08 10:10:50","2019-05-09 22:00:00","2019-05-09 22:30:00",3625,1007,4632
"2019-05-09 10:10:11","2019-05-09 23:00:00","2019-05-09 23:30:00",3125,869,3994
"2019-05-09 10:10:11","2019-05-10 00:00:00","2019-05-10 00:30:00",2858,728,3586
"2019-05-09 10:10:11","2019-05-10 01:00:00","2019-05-10 01:30:00",2708,659,3367
"2019-05-09 10:10:11","2019-05-10 02:00:00","2019-05-10 02:30:00",2581,609,3190
"2019-05-09 10:10:11","2019-05-10 03:00:00","2019-05-10 03:30:00",2504,616,3120
"2019-05-09 10:10:11","2019-05-10 04:00:00","2019-05-10 04:30:00",2492,591,3083
"2019-05-09 10:10:11","2019-05-10 05:00:00","2019-05-10 05:30:00",2531,602,3133
"2019-05-09 10:10:11","2019-05-10 06:00:00","2019-05-10 06:30:00",2648,637,3285
"2019-05-09 10:10:11","2019-05-10 07:00:00","2019-05-10 07:30:00",3142,797,3939
"2019-05-09 10:10:11","2019-05-10 08:00:00","2019-05-10 08:30:00",3735,970,4705
"2019-05-09 10:10:11","2019-05-10 09:00:00","2019-05-10 09:30:00",3863,1056,4919
"2019-05-09 10:10:11","2019-05-10 10:00:00","2019-05-10 10:30:00",3809,1054,4863
"2019-05-09 10:10:11","2019-05-10 11:00:00","2019-05-10 11:30:00",3770,1026,4796
"2019-05-09 10:10:11","2019-05-10 12:00:00","2019-05-10 12:30:00",3760,1042,4802
"2019-05-09 10:10:11","2019-05-10 13:00:00","2019-05-10 13:30:00",3741,978,4719
"2019-05-09 10:10:11","2019-05-10 14:00:00","2019-05-10 14:30:00",3626,949,4575
"2019-05-09 10:10:11","2019-05-10 15:00:00","2019-05-10 15:30:00",3568,892,4460
"2019-05-09 10:10:11","2019-05-10 16:00:00","2019-05-10 16:30:00",3670,913,4583
"2019-05-09 10:10:11","2019-05-10 17:00:00","2019-05-10 17:30:00",3756,973,4729
"2019-05-09 10:10:11","2019-05-10 18:00:00","2019-05-10 18:30:00",3791,964,4755
"2019-05-09 10:10:11","2019-05-10 19:00:00","2019-05-10 19:30:00",3718,923,4641
"2019-05-09 10:10:11","2019-05-10 20:00:00","2019-05-10 20:30:00",3541,910,4451
"2019-05-09 10:10:11","2019-05-10 21:00:00","2019-05-10 21:30:00",3508,875,4383
"2019-05-09 10:10:11","2019-05-10 22:00:00","2019-05-10 22:30:00",3450,895,4345
"2019-05-10 10:10:11","2019-05-10 23:00:00","2019-05-10 23:30:00",3164,860,4024
"2019-05-10 10:10:11","2019-05-11 00:00:00","2019-05-11 00:30:00",2935,711,3646
"2019-05-10 10:10:11","2019-05-11 01:00:00","2019-05-11 01:30:00",2770,623,3393
"2019-05-10 10:10:11","2019-05-11 02:00:00","2019-05-11 02:30:00",2629,580,3209
"2019-05-10 10:10:11","2019-05-11 03:00:00","2019-05-11 03:30:00",2519,574,3093
"2019-05-10 10:10:11","2019-05-11 04:00:00","2019-05-11 04:30:00",2500,535,3035
"2019-05-10 10:10:11","2019-05-11 05:00:00","2019-05-11 05:30:00",2524,554,3078
"2019-05-10 10:10:11","2019-05-11 06:00:00","2019-05-11 06:30:00",2535,538,3073
"2019-05-10 10:10:11","2019-05-11 07:00:00","2019-05-11 07:30:00",2669,609,3278
"2019-05-10 10:10:11","2019-05-11 08:00:00","2019-05-11 08:30:00",3021,710,3731
"2019-05-10 10:10:11","2019-05-11 09:00:00","2019-05-11 09:30:00",3325,779,4104
"2019-05-10 10:10:11","2019-05-11 10:00:00","2019-05-11 10:30:00",3447,847,4294
"2019-05-10 10:10:11","2019-05-11 11:00:00","2019-05-11 11:30:00",3499,859,4358
"2019-05-10 10:10:11","2019-05-11 12:00:00","2019-05-11 12:30:00",3449,852,4301
"2019-05-10 10:10:11","2019-05-11 13:00:00","2019-05-11 13:30:00",3434,792,4226
"2019-05-10 10:10:11","2019-05-11 14:00:00","2019-05-11 14:30:00",3307,772,4079
"2019-05-10 10:10:11","2019-05-11 15:00:00","2019-05-11 15:30:00",3241,766,4007
"2019-05-10 10:10:11","2019-05-11 16:00:00","2019-05-11 16:30:00",3218,808,4026
"2019-05-10 10:10:11","2019-05-11 17:00:00","2019-05-11 17:30:00",3313,830,4143
"2019-05-10 10:10:11","2019-05-11 18:00:00","2019-05-11 18:30:00",3418,842,4260
"2019-05-10 10:10:11","2019-05-11 19:00:00","2019-05-11 19:30:00",3360,827,4187
"2019-05-10 10:10:11","2019-05-11 20:00:00","2019-05-11 20:30:00",3223,774,3997
"2019-05-10 10:10:11","2019-05-11 21:00:00","2019-05-11 21:30:00",3176,786,3962
"2019-05-10 10:10:11","2019-05-11 22:00:00","2019-05-11 22:30:00",3220,819,4039
"2019-05-11 10:10:31","2019-05-11 23:00:00","2019-05-11 23:30:00",2959,805,3764
"2019-05-11 10:10:31","2019-05-12 00:00:00","2019-05-12 00:30:00",2928,722,3650
"2019-05-11 10:10:31","2019-05-12 01:00:00","2019-05-12 01:30:00",2762,653,3415
"2019-05-11 10:10:31","2019-05-12 02:00:00","2019-05-12 02:30:00",2617,615,3232
"2019-05-11 10:10:31","2019-05-12 03:00:00","2019-05-12 03:30:00",2503,600,3103
"2019-05-11 10:10:31","2019-05-12 04:00:00","2019-05-12 04:30:00",2476,579,3055
"2019-05-11 10:10:31","2019-05-12 05:00:00","2019-05-12 05:30:00",2462,561,3023
"2019-05-11 10:10:31","2019-05-12 06:00:00","2019-05-12 06:30:00",2401,553,2954
"2019-05-11 10:10:31","2019-05-12 07:00:00","2019-05-12 07:30:00",2522,589,3111
"2019-05-11 10:10:31","2019-05-12 08:00:00","2019-05-12 08:30:00",2751,659,3410
"2019-05-11 10:10:31","2019-05-12 09:00:00","2019-05-12 09:30:00",3015,745,3760
"2019-05-11 10:10:31","2019-05-12 10:00:00","2019-05-12 10:30:00",3213,820,4033
"2019-05-11 10:10:31","2019-05-12 11:00:00","2019-05-12 11:30:00",3324,837,4161
"2019-05-11 10:10:31","2019-05-12 12:00:00","2019-05-12 12:30:00",3373,854,4227
"2019-05-11 10:10:31","2019-05-12 13:00:00","2019-05-12 13:30:00",3400,870,4270
"2019-05-11 10:10:31","2019-05-12 14:00:00","2019-05-12 14:30:00",3310,827,4137
"2019-05-11 10:10:31","2019-05-12 15:00:00","2019-05-12 15:30:00",3186,793,3979
"2019-05-11 10:10:31","2019-05-12 16:00:00","2019-05-12 16:30:00",3138,811,3949
"2019-05-11 10:10:31","2019-05-12 17:00:00","2019-05-12 17:30:00",3262,888,4150
"2019-05-11 10:10:31","2019-05-12 18:00:00","2019-05-12 18:30:00",3378,924,4302
"2019-05-11 10:10:31","2019-05-12 19:00:00","2019-05-12 19:30:00",3353,899,4252
"2019-05-11 10:10:31","2019-05-12 20:00:00","2019-05-12 20:30:00",3280,885,4165
"2019-05-11 10:10:31","2019-05-12 21:00:00","2019-05-12 21:30:00",3239,875,4114
"2019-05-11 10:10:31","2019-05-12 22:00:00","2019-05-12 22:30:00",3262,896,4158
"2019-05-12 10:10:16","2019-05-12 23:00:00","2019-05-12 23:30:00",2961,827,3788
"2019-05-12 10:10:16","2019-05-13 00:00:00","2019-05-13 00:30:00",2636,674,3310
"2019-05-12 10:10:16","2019-05-13 01:00:00","2019-05-13 01:30:00",2535,610,3145
"2019-05-12 10:10:16","2019-05-13 02:00:00","2019-05-13 02:30:00",2425,588,3013
"2019-05-12 10:10:16","2019-05-13 03:00:00","2019-05-13 03:30:00",2347,590,2937
"2019-05-12 10:10:16","2019-05-13 04:00:00","2019-05-13 04:30:00",2336,582,2918
"2019-05-12 10:10:16","2019-05-13 05:00:00","2019-05-13 05:30:00",2400,596,2996
"2019-05-12 10:10:16","2019-05-13 06:00:00","2019-05-13 06:30:00",2537,636,3173
"2019-05-12 10:10:16","2019-05-13 07:00:00","2019-05-13 07:30:00",3020,801,3821
"2019-05-12 10:10:16","2019-05-13 08:00:00","2019-05-13 08:30:00",3563,995,4558
"2019-05-12 10:10:16","2019-05-13 09:00:00","2019-05-13 09:30:00",3731,1070,4801
"2019-05-12 10:10:16","2019-05-13 10:00:00","2019-05-13 10:30:00",3772,1099,4871
"2019-05-12 10:10:16","2019-05-13 11:00:00","2019-05-13 11:30:00",3751,1097,4848
"2019-05-12 10:10:16","2019-05-13 12:00:00","2019-05-13 12:30:00",3764,1108,4872
"2019-05-12 10:10:16","2019-05-13 13:00:00","2019-05-13 13:30:00",3779,1070,4849
"2019-05-12 10:10:16","2019-05-13 14:00:00","2019-05-13 14:30:00",3755,1000,4755
"2019-05-12 10:10:16","2019-05-13 15:00:00","2019-05-13 15:30:00",3749,1020,4769
"2019-05-12 10:10:16","2019-05-13 16:00:00","2019-05-13 16:30:00",3783,1088,4871
"2019-05-12 10:10:16","2019-05-13 17:00:00","2019-05-13 17:30:00",3892,1182,5074
"2019-05-12 10:10:16","2019-05-13 18:00:00","2019-05-13 18:30:00",3931,1153,5084
"2019-05-12 10:10:16","2019-05-13 19:00:00","2019-05-13 19:30:00",3779,1059,4838
"2019-05-12 10:10:16","2019-05-13 20:00:00","2019-05-13 20:30:00",3632,1000,4632
"2019-05-12 10:10:16","2019-05-13 21:00:00","2019-05-13 21:30:00",3631,991,4622
"2019-05-12 10:10:16","2019-05-13 22:00:00","2019-05-13 22:30:00",3457,1003,4460
"2019-05-13 10:10:30","2019-05-13 23:00:00","2019-05-13 23:30:00",3005,867,3872
"2019-05-13 10:10:30","2019-05-14 00:00:00","2019-05-14 00:30:00",2728,681,3409
"2019-05-13 10:10:30","2019-05-14 01:00:00","2019-05-14 01:30:00",2615,616,3231
"2019-05-13 10:10:30","2019-05-14 02:00:00","2019-05-14 02:30:00",2483,604,3087
"2019-05-13 10:10:30","2019-05-14 03:00:00","2019-05-14 03:30:00",2404,602,3006
"2019-05-13 10:10:30","2019-05-14 04:00:00","2019-05-14 04:30:00",2361,599,2960
"2019-05-13 10:10:30","2019-05-14 05:00:00","2019-05-14 05:30:00",2403,605,3008
"2019-05-13 10:10:30","2019-05-14 06:00:00","2019-05-14 06:30:00",2531,633,3164
"2019-05-13 10:10:30","2019-05-14 07:00:00","2019-05-14 07:30:00",3046,777,3823
"2019-05-13 10:10:30","2019-05-14 08:00:00","2019-05-14 08:30:00",3630,927,4557
"2019-05-13 10:10:30","2019-05-14 09:00:00","2019-05-14 09:30:00",3768,958,4726
"2019-05-13 10:10:30","2019-05-14 10:00:00","2019-05-14 10:30:00",3834,952,4786
"2019-05-13 10:10:30","2019-05-14 11:00:00","2019-05-14 11:30:00",3779,944,4723
"2019-05-13 10:10:30","2019-05-14 12:00:00","2019-05-14 12:30:00",3780,918,4698
"2019-05-13 10:10:30","2019-05-14 13:00:00","2019-05-14 13:30:00",3820,906,4726
"2019-05-13 10:10:30","2019-05-14 14:00:00","2019-05-14 14:30:00",3746,870,4616
"2019-05-13 10:10:30","2019-05-14 15:00:00","2019-05-14 15:30:00",3792,879,4671
"2019-05-13 10:10:30","2019-05-14 16:00:00","2019-05-14 16:30:00",3823,916,4739
"2019-05-13 10:10:30","2019-05-14 17:00:00","2019-05-14 17:30:00",3949,990,4939
"2019-05-13 10:10:30","2019-05-14 18:00:00","2019-05-14 18:30:00",3977,989,4966
"2019-05-13 10:10:30","2019-05-14 19:00:00","2019-05-14 19:30:00",3842,960,4802
"2019-05-13 10:10:30","2019-05-14 20:00:00","2019-05-14 20:30:00",3676,963,4639
"2019-05-13 10:10:30","2019-05-14 21:00:00","2019-05-14 21:30:00",3594,963,4557
"2019-05-13 10:10:30","2019-05-14 22:00:00","2019-05-14 22:30:00",3408,917,4325
"2019-05-15 10:10:11","2019-05-14 23:00:00","2019-05-14 23:30:00",2958,815,3773
"2019-05-15 10:10:11","2019-05-15 00:00:00","2019-05-15 00:30:00",2696,651,3347
"2019-05-15 10:10:11","2019-05-15 01:00:00","2019-05-15 01:30:00",2538,605,3143
"2019-05-15 10:10:11","2019-05-15 02:00:00","2019-05-15 02:30:00",2412,586,2998
"2019-05-15 10:10:11","2019-05-15 03:00:00","2019-05-15 03:30:00",2336,583,2919
"2019-05-15 10:10:11","2019-05-15 04:00:00","2019-05-15 04:30:00",2338,580,2918
"2019-05-15 10:10:11","2019-05-15 05:00:00","2019-05-15 05:30:00",2366,575,2941
"2019-05-15 10:10:11","2019-05-15 06:00:00","2019-05-15 06:30:00",2463,627,3090
"2019-05-15 10:10:11","2019-05-15 07:00:00","2019-05-15 07:30:00",2942,809,3751
"2019-05-15 10:10:11","2019-05-15 08:00:00","2019-05-15 08:30:00",3480,983,4463
"2019-05-15 10:10:11","2019-05-15 09:00:00","2019-05-15 09:30:00",3591,1008,4599
"2019-05-15 10:10:11","2019-05-15 10:00:00","2019-05-15 10:30:00",3548,1000,4548
"2019-05-15 10:10:11","2019-05-15 11:00:00","2019-05-15 11:30:00",3639,1010,4649
"2019-05-15 10:10:11","2019-05-15 12:00:00","2019-05-15 12:30:00",3540,990,4530
"2019-05-15 10:10:11","2019-05-15 13:00:00","2019-05-15 13:30:00",3545,951,4496
"2019-05-15 10:10:11","2019-05-15 14:00:00","2019-05-15 14:30:00",3516,916,4432
"2019-05-15 10:10:11","2019-05-15 15:00:00","2019-05-15 15:30:00",3514,892,4406
"2019-05-15 10:10:11","2019-05-15 16:00:00","2019-05-15 16:30:00",3545,931,4476
"2019-05-15 10:10:11","2019-05-15 17:00:00","2019-05-15 17:30:00",3658,1024,4682
"2019-05-15 10:10:11","2019-05-15 18:00:00","2019-05-15 18:30:00",3696,1046,4742
"2019-05-15 10:10:11","2019-05-15 19:00:00","2019-05-15 19:30:00",3558,981,4539
"2019-05-15 10:10:11","2019-05-15 20:00:00","2019-05-15 20:30:00",3442,955,4397
"2019-05-15 10:10:11","2019-05-15 21:00:00","2019-05-15 21:30:00",3326,955,4281
"2019-05-15 10:10:11","2019-05-15 22:00:00","2019-05-15 22:30:00",3392,963,4355
"2019-05-15 10:10:11","2019-05-15 23:00:00","2019-05-15 23:30:00",3000,835,3835
"2019-05-15 10:10:11","2019-05-16 00:00:00","2019-05-16 00:30:00",2705,717,3422
"2019-05-15 10:10:11","2019-05-16 01:00:00","2019-05-16 01:30:00",2546,653,3199
"2019-05-15 10:10:11","2019-05-16 02:00:00","2019-05-16 02:30:00",2419,634,3053
"2019-05-15 10:10:11","2019-05-16 03:00:00","2019-05-16 03:30:00",2342,631,2973
"2019-05-15 10:10:11","2019-05-16 04:00:00","2019-05-16 04:30:00",2344,621,2965
"2019-05-15 10:10:11","2019-05-16 05:00:00","2019-05-16 05:30:00",2372,615,2987
"2019-05-15 10:10:11","2019-05-16 06:00:00","2019-05-16 06:30:00",2470,663,3133
"2019-05-15 10:10:11","2019-05-16 07:00:00","2019-05-16 07:30:00",2953,840,3793
"2019-05-15 10:10:11","2019-05-16 08:00:00","2019-05-16 08:30:00",3496,1025,4521
"2019-05-15 10:10:11","2019-05-16 09:00:00","2019-05-16 09:30:00",3608,1038,4646
"2019-05-15 10:10:11","2019-05-16 10:00:00","2019-05-16 10:30:00",3564,1027,4591
"2019-05-15 10:10:11","2019-05-16 11:00:00","2019-05-16 11:30:00",3655,1018,4673
"2019-05-15 10:10:11","2019-05-16 12:00:00","2019-05-16 12:30:00",3556,990,4546
"2019-05-15 10:10:11","2019-05-16 13:00:00","2019-05-16 13:30:00",3561,950,4511
"2019-05-15 10:10:11","2019-05-16 14:00:00","2019-05-16 14:30:00",3531,909,4440
"2019-05-15 10:10:11","2019-05-16 15:00:00","2019-05-16 15:30:00",3530,890,4420
"2019-05-15 10:10:11","2019-05-16 16:00:00","2019-05-16 16:30:00",3561,915,4476
"2019-05-15 10:10:11","2019-05-16 17:00:00","2019-05-16 17:30:00",3675,980,4655
"2019-05-15 10:10:11","2019-05-16 18:00:00","2019-05-16 18:30:00",3714,1058,4772
"2019-05-15 10:10:11","2019-05-16 19:00:00","2019-05-16 19:30:00",3574,1000,4574
"2019-05-15 10:10:11","2019-05-16 20:00:00","2019-05-16 20:30:00",3458,960,4418
"2019-05-15 10:10:11","2019-05-16 21:00:00","2019-05-16 21:30:00",3340,956,4296
"2019-05-15 10:10:11","2019-05-16 22:00:00","2019-05-16 22:30:00",3407,968,4375
"2019-05-16 10:10:10","2019-05-16 23:00:00","2019-05-16 23:30:00",3014,858,3872
"2019-05-16 10:10:10","2019-05-17 00:00:00","2019-05-17 00:30:00",2695,712,3407
"2019-05-16 10:10:10","2019-05-17 01:00:00","2019-05-17 01:30:00",2555,659,3214
"2019-05-16 10:10:10","2019-05-17 02:00:00","2019-05-17 02:30:00",2437,627,3064
"2019-05-16 10:10:10","2019-05-17 03:00:00","2019-05-17 03:30:00",2364,640,3004
"2019-05-16 10:10:10","2019-05-17 04:00:00","2019-05-17 04:30:00",2350,623,2973
"2019-05-16 10:10:10","2019-05-17 05:00:00","2019-05-17 05:30:00",2395,637,3032
"2019-05-16 10:10:10","2019-05-17 06:00:00","2019-05-17 06:30:00",2471,680,3151
"2019-05-16 10:10:10","2019-05-17 07:00:00","2019-05-17 07:30:00",2921,859,3780
"2019-05-16 10:10:10","2019-05-17 08:00:00","2019-05-17 08:30:00",3437,1039,4476
"2019-05-16 10:10:10","2019-05-17 09:00:00","2019-05-17 09:30:00",3568,1103,4671
"2019-05-16 10:10:10","2019-05-17 10:00:00","2019-05-17 10:30:00",3584,1092,4676
"2019-05-16 10:10:10","2019-05-17 11:00:00","2019-05-17 11:30:00",3552,1098,4650
"2019-05-16 10:10:10","2019-05-17 12:00:00","2019-05-17 12:30:00",3558,1093,4651
"2019-05-16 10:10:10","2019-05-17 13:00:00","2019-05-17 13:30:00",3560,1040,4600
"2019-05-16 10:10:10","2019-05-17 14:00:00","2019-05-17 14:30:00",3479,981,4460
"2019-05-16 10:10:10","2019-05-17 15:00:00","2019-05-17 15:30:00",3454,953,4407
"2019-05-16 10:10:10","2019-05-17 16:00:00","2019-05-17 16:30:00",3475,939,4414
"2019-05-16 10:10:10","2019-05-17 17:00:00","2019-05-17 17:30:00",3511,995,4506
"2019-05-16 10:10:10","2019-05-17 18:00:00","2019-05-17 18:30:00",3564,993,4557
"2019-05-16 10:10:10","2019-05-17 19:00:00","2019-05-17 19:30:00",3438,940,4378
"2019-05-16 10:10:10","2019-05-17 20:00:00","2019-05-17 20:30:00",3307,950,4257
"2019-05-16 10:10:10","2019-05-17 21:00:00","2019-05-17 21:30:00",3242,922,4164
"2019-05-16 10:10:10","2019-05-17 22:00:00","2019-05-17 22:30:00",3271,917,4188
"2019-05-17 10:10:25","2019-05-17 23:00:00","2019-05-17 23:30:00",3023,844,3867
"2019-05-17 10:10:25","2019-05-18 00:00:00","2019-05-18 00:30:00",2829,680,3509
"2019-05-17 10:10:25","2019-05-18 01:00:00","2019-05-18 01:30:00",2639,613,3252
"2019-05-17 10:10:25","2019-05-18 02:00:00","2019-05-18 02:30:00",2475,605,3080
"2019-05-17 10:10:25","2019-05-18 03:00:00","2019-05-18 03:30:00",2398,614,3012
"2019-05-17 10:10:25","2019-05-18 04:00:00","2019-05-18 04:30:00",2363,575,2938
"2019-05-17 10:10:25","2019-05-18 05:00:00","2019-05-18 05:30:00",2380,580,2960
"2019-05-17 10:10:25","2019-05-18 06:00:00","2019-05-18 06:30:00",2362,588,2950
"2019-05-17 10:10:25","2019-05-18 07:00:00","2019-05-18 07:30:00",2560,676,3236
"2019-05-17 10:10:25","2019-05-18 08:00:00","2019-05-18 08:30:00",2897,800,3697
"2019-05-17 10:10:25","2019-05-18 09:00:00","2019-05-18 09:30:00",3200,864,4064
"2019-05-17 10:10:25","2019-05-18 10:00:00","2019-05-18 10:30:00",3338,934,4272
"2019-05-17 10:10:25","2019-05-18 11:00:00","2019-05-18 11:30:00",3384,935,4319
"2019-05-17 10:10:25","2019-05-18 12:00:00","2019-05-18 12:30:00",3353,942,4295
"2019-05-17 10:10:25","2019-05-18 13:00:00","2019-05-18 13:30:00",3322,891,4213
"2019-05-17 10:10:25","2019-05-18 14:00:00","2019-05-18 14:30:00",3237,871,4108
"2019-05-17 10:10:25","2019-05-18 15:00:00","2019-05-18 15:30:00",3139,786,3925
"2019-05-17 10:10:25","2019-05-18 16:00:00","2019-05-18 16:30:00",3121,833,3954
"2019-05-17 10:10:25","2019-05-18 17:00:00","2019-05-18 17:30:00",3198,892,4090
"2019-05-17 10:10:25","2019-05-18 18:00:00","2019-05-18 18:30:00",3291,933,4224
"2019-05-17 10:10:25","2019-05-18 19:00:00","2019-05-18 19:30:00",3240,918,4158
"2019-05-17 10:10:25","2019-05-18 20:00:00","2019-05-18 20:30:00",3132,871,4003
"2019-05-17 10:10:25","2019-05-18 21:00:00","2019-05-18 21:30:00",3050,841,3891
"2019-05-17 10:10:25","2019-05-18 22:00:00","2019-05-18 22:30:00",3063,870,3933
"2019-05-18 10:10:10","2019-05-18 23:00:00","2019-05-18 23:30:00",2900,805,3705
"2019-05-18 10:10:10","2019-05-19 00:00:00","2019-05-19 00:30:00",2829,708,3537
"2019-05-18 10:10:10","2019-05-19 01:00:00","2019-05-19 01:30:00",2639,637,3276
"2019-05-18 10:10:10","2019-05-19 02:00:00","2019-05-19 02:30:00",2475,599,3074
"2019-05-18 10:10:10","2019-05-19 03:00:00","2019-05-19 03:30:00",2398,589,2987
"2019-05-18 10:10:10","2019-05-19 04:00:00","2019-05-19 04:30:00",2363,577,2940
"2019-05-18 10:10:10","2019-05-19 05:00:00","2019-05-19 05:30:00",2380,551,2931
"2019-05-18 10:10:10","2019-05-19 06:00:00","2019-05-19 06:30:00",2362,538,2900
"2019-05-18 10:10:10","2019-05-19 07:00:00","2019-05-19 07:30:00",2560,599,3159
"2019-05-18 10:10:10","2019-05-19 08:00:00","2019-05-19 08:30:00",2897,679,3576
"2019-05-18 10:10:10","2019-05-19 09:00:00","2019-05-19 09:30:00",3200,796,3996
"2019-05-18 10:10:10","2019-05-19 10:00:00","2019-05-19 10:30:00",3338,861,4199
"2019-05-18 10:10:10","2019-05-19 11:00:00","2019-05-19 11:30:00",3384,887,4271
"2019-05-18 10:10:10","2019-05-19 12:00:00","2019-05-19 12:30:00",3353,927,4280
"2019-05-18 10:10:10","2019-05-19 13:00:00","2019-05-19 13:30:00",3322,972,4294
"2019-05-18 10:10:10","2019-05-19 14:00:00","2019-05-19 14:30:00",3237,927,4164
"2019-05-18 10:10:10","2019-05-19 15:00:00","2019-05-19 15:30:00",3139,875,4014
"2019-05-18 10:10:10","2019-05-19 16:00:00","2019-05-19 16:30:00",3121,893,4014
"2019-05-18 10:10:10","2019-05-19 17:00:00","2019-05-19 17:30:00",3198,963,4161
"2019-05-18 10:10:10","2019-05-19 18:00:00","2019-05-19 18:30:00",3291,1017,4308
"2019-05-18 10:10:10","2019-05-19 19:00:00","2019-05-19 19:30:00",3240,962,4202
"2019-05-18 10:10:10","2019-05-19 20:00:00","2019-05-19 20:30:00",3132,927,4059
"2019-05-18 10:10:10","2019-05-19 21:00:00","2019-05-19 21:30:00",3050,882,3932
"2019-05-18 10:10:10","2019-05-19 22:00:00","2019-05-19 22:30:00",3063,882,3945
"2019-05-19 10:10:30","2019-05-19 23:00:00","2019-05-19 23:30:00",2827,808,3635
"2019-05-19 10:10:30","2019-05-20 00:00:00","2019-05-20 00:30:00",2550,692,3242
"2019-05-19 10:10:30","2019-05-20 01:00:00","2019-05-20 01:30:00",2453,642,3095
"2019-05-19 10:10:30","2019-05-20 02:00:00","2019-05-20 02:30:00",2349,618,2967
"2019-05-19 10:10:30","2019-05-20 03:00:00","2019-05-20 03:30:00",2289,608,2897
"2019-05-19 10:10:30","2019-05-20 04:00:00","2019-05-20 04:30:00",2244,605,2849
"2019-05-19 10:10:30","2019-05-20 05:00:00","2019-05-20 05:30:00",2283,584,2867
"2019-05-19 10:10:30","2019-05-20 06:00:00","2019-05-20 06:30:00",2422,680,3102
"2019-05-19 10:10:30","2019-05-20 07:00:00","2019-05-20 07:30:00",2896,890,3786
"2019-05-19 10:10:30","2019-05-20 08:00:00","2019-05-20 08:30:00",3473,1023,4496
"2019-05-19 10:10:30","2019-05-20 09:00:00","2019-05-20 09:30:00",3573,1083,4656
"2019-05-19 10:10:30","2019-05-20 10:00:00","2019-05-20 10:30:00",3592,1088,4680
"2019-05-19 10:10:30","2019-05-20 11:00:00","2019-05-20 11:30:00",3570,1080,4650
"2019-05-19 10:10:30","2019-05-20 12:00:00","2019-05-20 12:30:00",3580,1081,4661
"2019-05-19 10:10:30","2019-05-20 13:00:00","2019-05-20 13:30:00",3588,1072,4660
"2019-05-19 10:10:30","2019-05-20 14:00:00","2019-05-20 14:30:00",3520,1059,4579
"2019-05-19 10:10:30","2019-05-20 15:00:00","2019-05-20 15:30:00",3527,1008,4535
"2019-05-19 10:10:30","2019-05-20 16:00:00","2019-05-20 16:30:00",3509,1062,4571
"2019-05-19 10:10:30","2019-05-20 17:00:00","2019-05-20 17:30:00",3641,1156,4797
"2019-05-19 10:10:30","2019-05-20 18:00:00","2019-05-20 18:30:00",3675,1152,4827
"2019-05-19 10:10:30","2019-05-20 19:00:00","2019-05-20 19:30:00",3513,1091,4604
"2019-05-19 10:10:30","2019-05-20 20:00:00","2019-05-20 20:30:00",3403,1038,4441
"2019-05-19 10:10:30","2019-05-20 21:00:00","2019-05-20 21:30:00",3351,1012,4363
"2019-05-19 10:10:30","2019-05-20 22:00:00","2019-05-20 22:30:00",3297,1003,4300
"2019-05-20 10:10:15","2019-05-20 23:00:00","2019-05-20 23:30:00",2958,820,3778
"2019-05-20 10:10:15","2019-05-21 00:00:00","2019-05-21 00:30:00",2773,748,3521
"2019-05-20 10:10:15","2019-05-21 01:00:00","2019-05-21 01:30:00",2642,682,3324
"2019-05-20 10:10:15","2019-05-21 02:00:00","2019-05-21 02:30:00",2549,641,3190
"2019-05-20 10:10:15","2019-05-21 03:00:00","2019-05-21 03:30:00",2501,629,3130
"2019-05-20 10:10:15","2019-05-21 04:00:00","2019-05-21 04:30:00",2488,620,3108
"2019-05-20 10:10:15","2019-05-21 05:00:00","2019-05-21 05:30:00",2513,617,3130
"2019-05-20 10:10:15","2019-05-21 06:00:00","2019-05-21 06:30:00",2601,679,3280
"2019-05-20 10:10:15","2019-05-21 07:00:00","2019-05-21 07:30:00",3093,881,3974
"2019-05-20 10:10:15","2019-05-21 08:00:00","2019-05-21 08:30:00",3605,1077,4682
"2019-05-20 10:10:15","2019-05-21 09:00:00","2019-05-21 09:30:00",3678,1133,4811
"2019-05-20 10:10:15","2019-05-21 10:00:00","2019-05-21 10:30:00",3644,1129,4773
"2019-05-20 10:10:15","2019-05-21 11:00:00","2019-05-21 11:30:00",3586,1113,4699
"2019-05-20 10:10:15","2019-05-21 12:00:00","2019-05-21 12:30:00",3560,1110,4670
"2019-05-20 10:10:15","2019-05-21 13:00:00","2019-05-21 13:30:00",3561,1072,4633
"2019-05-20 10:10:15","2019-05-21 14:00:00","2019-05-21 14:30:00",3513,1027,4540
"2019-05-20 10:10:15","2019-05-21 15:00:00","2019-05-21 15:30:00",3545,1009,4554
"2019-05-20 10:10:15","2019-05-21 16:00:00","2019-05-21 16:30:00",3638,1053,4691
"2019-05-20 10:10:15","2019-05-21 17:00:00","2019-05-21 17:30:00",3754,1134,4888
"2019-05-20 10:10:15","2019-05-21 18:00:00","2019-05-21 18:30:00",3781,1138,4919
"2019-05-20 10:10:15","2019-05-21 19:00:00","2019-05-21 19:30:00",3671,1065,4736
"2019-05-20 10:10:15","2019-05-21 20:00:00","2019-05-21 20:30:00",3592,1034,4626
"2019-05-20 10:10:15","2019-05-21 21:00:00","2019-05-21 21:30:00",3568,1023,4591
"2019-05-20 10:10:15","2019-05-21 22:00:00","2019-05-21 22:30:00",3529,1010,4539
"2019-05-21 10:10:30","2019-05-21 23:00:00","2019-05-21 23:30:00",3058,860,3918
"2019-05-21 10:10:30","2019-05-22 00:00:00","2019-05-22 00:30:00",2686,761,3447
"2019-05-21 10:10:30","2019-05-22 01:00:00","2019-05-22 01:30:00",2535,696,3231
"2019-05-21 10:10:30","2019-05-22 02:00:00","2019-05-22 02:30:00",2430,657,3087
"2019-05-21 10:10:30","2019-05-22 03:00:00","2019-05-22 03:30:00",2372,642,3014
"2019-05-21 10:10:30","2019-05-22 04:00:00","2019-05-22 04:30:00",2360,634,2994
"2019-05-21 10:10:30","2019-05-22 05:00:00","2019-05-22 05:30:00",2394,633,3027
"2019-05-21 10:10:30","2019-05-22 06:00:00","2019-05-22 06:30:00",2495,698,3193
"2019-05-21 10:10:30","2019-05-22 07:00:00","2019-05-22 07:30:00",2996,900,3896
"2019-05-21 10:10:30","2019-05-22 08:00:00","2019-05-22 08:30:00",3570,1095,4665
"2019-05-21 10:10:30","2019-05-22 09:00:00","2019-05-22 09:30:00",3691,1144,4835
"2019-05-21 10:10:30","2019-05-22 10:00:00","2019-05-22 10:30:00",3701,1138,4839
"2019-05-21 10:10:30","2019-05-22 11:00:00","2019-05-22 11:30:00",3667,1119,4786
"2019-05-21 10:10:30","2019-05-22 12:00:00","2019-05-22 12:30:00",3683,1108,4791
"2019-05-21 10:10:30","2019-05-22 13:00:00","2019-05-22 13:30:00",3678,1068,4746
"2019-05-21 10:10:30","2019-05-22 14:00:00","2019-05-22 14:30:00",3592,1012,4604
"2019-05-21 10:10:30","2019-05-22 15:00:00","2019-05-22 15:30:00",3614,984,4598
"2019-05-21 10:10:30","2019-05-22 16:00:00","2019-05-22 16:30:00",3678,1024,4702
"2019-05-21 10:10:30","2019-05-22 17:00:00","2019-05-22 17:30:00",3788,1098,4886
"2019-05-21 10:10:30","2019-05-22 18:00:00","2019-05-22 18:30:00",3830,1114,4944
"2019-05-21 10:10:30","2019-05-22 19:00:00","2019-05-22 19:30:00",3693,1049,4742
"2019-05-21 10:10:30","2019-05-22 20:00:00","2019-05-22 20:30:00",3564,1023,4587
"2019-05-21 10:10:30","2019-05-22 21:00:00","2019-05-22 21:30:00",3493,1012,4505
"2019-05-21 10:10:30","2019-05-22 22:00:00","2019-05-22 22:30:00",3445,1002,4447
"2019-05-22 10:10:26","2019-05-22 23:00:00","2019-05-22 23:30:00",3058,847,3905
"2019-05-22 10:10:26","2019-05-23 00:00:00","2019-05-23 00:30:00",2686,735,3421
"2019-05-22 10:10:26","2019-05-23 01:00:00","2019-05-23 01:30:00",2535,677,3212
"2019-05-22 10:10:26","2019-05-23 02:00:00","2019-05-23 02:30:00",2430,644,3074
"2019-05-22 10:10:26","2019-05-23 03:00:00","2019-05-23 03:30:00",2372,627,2999
"2019-05-22 10:10:26","2019-05-23 04:00:00","2019-05-23 04:30:00",2360,613,2973
"2019-05-22 10:10:26","2019-05-23 05:00:00","2019-05-23 05:30:00",2394,604,2998
"2019-05-22 10:10:26","2019-05-23 06:00:00","2019-05-23 06:30:00",2495,670,3165
"2019-05-22 10:10:26","2019-05-23 07:00:00","2019-05-23 07:30:00",2996,865,3861
"2019-05-22 10:10:26","2019-05-23 08:00:00","2019-05-23 08:30:00",3570,1057,4627
"2019-05-22 10:10:26","2019-05-23 09:00:00","2019-05-23 09:30:00",3691,1105,4796
"2019-05-22 10:10:26","2019-05-23 10:00:00","2019-05-23 10:30:00",3701,1094,4795
"2019-05-22 10:10:26","2019-05-23 11:00:00","2019-05-23 11:30:00",3667,1081,4748
"2019-05-22 10:10:26","2019-05-23 12:00:00","2019-05-23 12:30:00",3683,1085,4768
"2019-05-22 10:10:26","2019-05-23 13:00:00","2019-05-23 13:30:00",3678,1054,4732
"2019-05-22 10:10:26","2019-05-23 14:00:00","2019-05-23 14:30:00",3592,1003,4595
"2019-05-22 10:10:26","2019-05-23 15:00:00","2019-05-23 15:30:00",3614,985,4599
"2019-05-22 10:10:26","2019-05-23 16:00:00","2019-05-23 16:30:00",3678,1016,4694
"2019-05-22 10:10:26","2019-05-23 17:00:00","2019-05-23 17:30:00",3788,1097,4885
"2019-05-22 10:10:26","2019-05-23 18:00:00","2019-05-23 18:30:00",3830,1078,4908
"2019-05-22 10:10:26","2019-05-23 19:00:00","2019-05-23 19:30:00",3693,999,4692
"2019-05-22 10:10:26","2019-05-23 20:00:00","2019-05-23 20:30:00",3564,969,4533
"2019-05-22 10:10:26","2019-05-23 21:00:00","2019-05-23 21:30:00",3493,954,4447
"2019-05-22 10:10:26","2019-05-23 22:00:00","2019-05-23 22:30:00",3445,939,4384
"2019-05-23 10:10:35","2019-05-23 23:00:00","2019-05-23 23:30:00",3056,862,3918
"2019-05-23 10:10:35","2019-05-24 00:00:00","2019-05-24 00:30:00",2749,735,3484
"2019-05-23 10:10:35","2019-05-24 01:00:00","2019-05-24 01:30:00",2607,654,3261
"2019-05-23 10:10:35","2019-05-24 02:00:00","2019-05-24 02:30:00",2435,610,3045
"2019-05-23 10:10:35","2019-05-24 03:00:00","2019-05-24 03:30:00",2381,601,2982
"2019-05-23 10:10:35","2019-05-24 04:00:00","2019-05-24 04:30:00",2368,590,2958
"2019-05-23 10:10:35","2019-05-24 05:00:00","2019-05-24 05:30:00",2414,591,3005
"2019-05-23 10:10:35","2019-05-24 06:00:00","2019-05-24 06:30:00",2520,634,3154
"2019-05-23 10:10:35","2019-05-24 07:00:00","2019-05-24 07:30:00",2996,812,3808
"2019-05-23 10:10:35","2019-05-24 08:00:00","2019-05-24 08:30:00",3568,1007,4575
"2019-05-23 10:10:35","2019-05-24 09:00:00","2019-05-24 09:30:00",3725,1074,4799
"2019-05-23 10:10:35","2019-05-24 10:00:00","2019-05-24 10:30:00",3741,1086,4827
"2019-05-23 10:10:35","2019-05-24 11:00:00","2019-05-24 11:30:00",3720,1057,4777
"2019-05-23 10:10:35","2019-05-24 12:00:00","2019-05-24 12:30:00",3716,1011,4727
"2019-05-23 10:10:35","2019-05-24 13:00:00","2019-05-24 13:30:00",3734,1001,4735
"2019-05-23 10:10:35","2019-05-24 14:00:00","2019-05-24 14:30:00",3662,950,4612
"2019-05-23 10:10:35","2019-05-24 15:00:00","2019-05-24 15:30:00",3654,947,4601
"2019-05-23 10:10:35","2019-05-24 16:00:00","2019-05-24 16:30:00",3684,959,4643
"2019-05-23 10:10:35","2019-05-24 17:00:00","2019-05-24 17:30:00",3733,1026,4759
"2019-05-23 10:10:35","2019-05-24 18:00:00","2019-05-24 18:30:00",3775,1041,4816
"2019-05-23 10:10:35","2019-05-24 19:00:00","2019-05-24 19:30:00",3657,982,4639
"2019-05-23 10:10:35","2019-05-24 20:00:00","2019-05-24 20:30:00",3538,914,4452
"2019-05-23 10:10:35","2019-05-24 21:00:00","2019-05-24 21:30:00",3446,893,4339
"2019-05-23 10:10:35","2019-05-24 22:00:00","2019-05-24 22:30:00",3397,890,4287
"2019-05-24 10:10:25","2019-05-24 23:00:00","2019-05-24 23:30:00",3096,862,3958
"2019-05-24 10:10:25","2019-05-25 00:00:00","2019-05-25 00:30:00",2822,682,3504
"2019-05-24 10:10:25","2019-05-25 01:00:00","2019-05-25 01:30:00",2630,608,3238
"2019-05-24 10:10:25","2019-05-25 02:00:00","2019-05-25 02:30:00",2465,588,3053
"2019-05-24 10:10:25","2019-05-25 03:00:00","2019-05-25 03:30:00",2384,576,2960
"2019-05-24 10:10:25","2019-05-25 04:00:00","2019-05-25 04:30:00",2337,569,2906
"2019-05-24 10:10:25","2019-05-25 05:00:00","2019-05-25 05:30:00",2356,565,2921
"2019-05-24 10:10:25","2019-05-25 06:00:00","2019-05-25 06:30:00",2349,577,2926
"2019-05-24 10:10:25","2019-05-25 07:00:00","2019-05-25 07:30:00",2558,656,3214
"2019-05-24 10:10:25","2019-05-25 08:00:00","2019-05-25 08:30:00",2963,765,3728
"2019-05-24 10:10:25","2019-05-25 09:00:00","2019-05-25 09:30:00",3281,874,4155
"2019-05-24 10:10:25","2019-05-25 10:00:00","2019-05-25 10:30:00",3425,924,4349
"2019-05-24 10:10:25","2019-05-25 11:00:00","2019-05-25 11:30:00",3435,933,4368
"2019-05-24 10:10:25","2019-05-25 12:00:00","2019-05-25 12:30:00",3429,922,4351
"2019-05-24 10:10:25","2019-05-25 13:00:00","2019-05-25 13:30:00",3412,902,4314
"2019-05-24 10:10:25","2019-05-25 14:00:00","2019-05-25 14:30:00",3297,855,4152
"2019-05-24 10:10:25","2019-05-25 15:00:00","2019-05-25 15:30:00",3219,811,4030
"2019-05-24 10:10:25","2019-05-25 16:00:00","2019-05-25 16:30:00",3234,804,4038
"2019-05-24 10:10:25","2019-05-25 17:00:00","2019-05-25 17:30:00",3386,834,4220
"2019-05-24 10:10:25","2019-05-25 18:00:00","2019-05-25 18:30:00",3480,873,4353
"2019-05-24 10:10:25","2019-05-25 19:00:00","2019-05-25 19:30:00",3400,840,4240
"2019-05-24 10:10:25","2019-05-25 20:00:00","2019-05-25 20:30:00",3276,803,4079
"2019-05-24 10:10:25","2019-05-25 21:00:00","2019-05-25 21:30:00",3160,774,3934
"2019-05-24 10:10:25","2019-05-25 22:00:00","2019-05-25 22:30:00",3147,786,3933
"2019-05-25 10:10:45","2019-05-25 23:00:00","2019-05-25 23:30:00",2943,739,3682
"2019-05-25 10:10:45","2019-05-26 00:00:00","2019-05-26 00:30:00",2758,637,3395
"2019-05-25 10:10:45","2019-05-26 01:00:00","2019-05-26 01:30:00",2580,577,3157
"2019-05-25 10:10:45","2019-05-26 02:00:00","2019-05-26 02:30:00",2422,550,2972
"2019-05-25 10:10:45","2019-05-26 03:00:00","2019-05-26 03:30:00",2339,537,2876
"2019-05-25 10:10:45","2019-05-26 04:00:00","2019-05-26 04:30:00",2301,517,2818
"2019-05-25 10:10:45","2019-05-26 05:00:00","2019-05-26 05:30:00",2316,498,2814
"2019-05-25 10:10:45","2019-05-26 06:00:00","2019-05-26 06:30:00",2256,501,2757
"2019-05-25 10:10:45","2019-05-26 07:00:00","2019-05-26 07:30:00",2362,531,2893
"2019-05-25 10:10:45","2019-05-26 08:00:00","2019-05-26 08:30:00",2616,594,3210
"2019-05-25 10:10:45","2019-05-26 09:00:00","2019-05-26 09:30:00",2914,700,3614
"2019-05-25 10:10:45","2019-05-26 10:00:00","2019-05-26 10:30:00",3123,792,3915
"2019-05-25 10:10:45","2019-05-26 11:00:00","2019-05-26 11:30:00",3240,826,4066
"2019-05-25 10:10:45","2019-05-26 12:00:00","2019-05-26 12:30:00",3295,859,4154
"2019-05-25 10:10:45","2019-05-26 13:00:00","2019-05-26 13:30:00",3340,897,4237
"2019-05-25 10:10:45","2019-05-26 14:00:00","2019-05-26 14:30:00",3230,867,4097
"2019-05-25 10:10:45","2019-05-26 15:00:00","2019-05-26 15:30:00",3156,831,3987
"2019-05-25 10:10:45","2019-05-26 16:00:00","2019-05-26 16:30:00",3138,824,3962
"2019-05-25 10:10:45","2019-05-26 17:00:00","2019-05-26 17:30:00",3208,885,4093
"2019-05-25 10:10:45","2019-05-26 18:00:00","2019-05-26 18:30:00",3316,930,4246
"2019-05-25 10:10:45","2019-05-26 19:00:00","2019-05-26 19:30:00",3278,901,4179
"2019-05-25 10:10:45","2019-05-26 20:00:00","2019-05-26 20:30:00",3220,884,4104
"2019-05-25 10:10:45","2019-05-26 21:00:00","2019-05-26 21:30:00",3151,854,4005
"2019-05-25 10:10:45","2019-05-26 22:00:00","2019-05-26 22:30:00",3137,859,3996
"2019-05-26 10:10:31","2019-05-26 23:00:00","2019-05-26 23:30:00",2853,756,3609
"2019-05-26 10:10:31","2019-05-27 00:00:00","2019-05-27 00:30:00",2563,649,3212
"2019-05-26 10:10:31","2019-05-27 01:00:00","2019-05-27 01:30:00",2435,615,3050
"2019-05-26 10:10:31","2019-05-27 02:00:00","2019-05-27 02:30:00",2342,589,2931
"2019-05-26 10:10:31","2019-05-27 03:00:00","2019-05-27 03:30:00",2267,589,2856
"2019-05-26 10:10:31","2019-05-27 04:00:00","2019-05-27 04:30:00",2265,586,2851
"2019-05-26 10:10:31","2019-05-27 05:00:00","2019-05-27 05:30:00",2318,577,2895
"2019-05-26 10:10:31","2019-05-27 06:00:00","2019-05-27 06:30:00",2447,641,3088
"2019-05-26 10:10:31","2019-05-27 07:00:00","2019-05-27 07:30:00",2941,820,3761
"2019-05-26 10:10:31","2019-05-27 08:00:00","2019-05-27 08:30:00",3486,1001,4487
"2019-05-26 10:10:31","2019-05-27 09:00:00","2019-05-27 09:30:00",3638,1066,4704
"2019-05-26 10:10:31","2019-05-27 10:00:00","2019-05-27 10:30:00",3672,1053,4725
"2019-05-26 10:10:31","2019-05-27 11:00:00","2019-05-27 11:30:00",3695,1081,4776
"2019-05-26 10:10:31","2019-05-27 12:00:00","2019-05-27 12:30:00",3699,1099,4798
"2019-05-26 10:10:31","2019-05-27 13:00:00","2019-05-27 13:30:00",3719,1083,4802
"2019-05-26 10:10:31","2019-05-27 14:00:00","2019-05-27 14:30:00",3651,1046,4697
"2019-05-26 10:10:31","2019-05-27 15:00:00","2019-05-27 15:30:00",3679,1013,4692
"2019-05-26 10:10:31","2019-05-27 16:00:00","2019-05-27 16:30:00",3707,1080,4787
"2019-05-26 10:10:31","2019-05-27 17:00:00","2019-05-27 17:30:00",3853,1153,5006
"2019-05-26 10:10:31","2019-05-27 18:00:00","2019-05-27 18:30:00",3878,1144,5022
"2019-05-26 10:10:31","2019-05-27 19:00:00","2019-05-27 19:30:00",3683,1043,4726
"2019-05-26 10:10:31","2019-05-27 20:00:00","2019-05-27 20:30:00",3512,982,4494
"2019-05-26 10:10:31","2019-05-27 21:00:00","2019-05-27 21:30:00",3389,943,4332
"2019-05-26 10:10:31","2019-05-27 22:00:00","2019-05-27 22:30:00",3336,942,4278
"2019-05-27 10:10:50","2019-05-27 23:00:00","2019-05-27 23:30:00",3019,868,3887
"2019-05-27 10:10:50","2019-05-28 00:00:00","2019-05-28 00:30:00",2702,731,3433
"2019-05-27 10:10:50","2019-05-28 01:00:00","2019-05-28 01:30:00",2569,669,3238
"2019-05-27 10:10:50","2019-05-28 02:00:00","2019-05-28 02:30:00",2453,634,3087
"2019-05-27 10:10:50","2019-05-28 03:00:00","2019-05-28 03:30:00",2399,624,3023
"2019-05-27 10:10:50","2019-05-28 04:00:00","2019-05-28 04:30:00",2400,613,3013
"2019-05-27 10:10:50","2019-05-28 05:00:00","2019-05-28 05:30:00",2418,603,3021
"2019-05-27 10:10:50","2019-05-28 06:00:00","2019-05-28 06:30:00",2521,657,3178
"2019-05-27 10:10:50","2019-05-28 07:00:00","2019-05-28 07:30:00",3061,849,3910
"2019-05-27 10:10:50","2019-05-28 08:00:00","2019-05-28 08:30:00",3633,1016,4649
"2019-05-27 10:10:50","2019-05-28 09:00:00","2019-05-28 09:30:00",3777,1078,4855
"2019-05-27 10:10:50","2019-05-28 10:00:00","2019-05-28 10:30:00",3791,1068,4859
"2019-05-27 10:10:50","2019-05-28 11:00:00","2019-05-28 11:30:00",3749,1068,4817
"2019-05-27 10:10:50","2019-05-28 12:00:00","2019-05-28 12:30:00",3756,1077,4833
"2019-05-27 10:10:50","2019-05-28 13:00:00","2019-05-28 13:30:00",3764,1082,4846
"2019-05-27 10:10:50","2019-05-28 14:00:00","2019-05-28 14:30:00",3673,1028,4701
"2019-05-27 10:10:50","2019-05-28 15:00:00","2019-05-28 15:30:00",3669,1014,4683
"2019-05-27 10:10:50","2019-05-28 16:00:00","2019-05-28 16:30:00",3720,1051,4771
"2019-05-27 10:10:50","2019-05-28 17:00:00","2019-05-28 17:30:00",3840,1129,4969
"2019-05-27 10:10:50","2019-05-28 18:00:00","2019-05-28 18:30:00",3875,1115,4990
"2019-05-27 10:10:50","2019-05-28 19:00:00","2019-05-28 19:30:00",3709,1034,4743
"2019-05-27 10:10:50","2019-05-28 20:00:00","2019-05-28 20:30:00",3547,1002,4549
"2019-05-27 10:10:50","2019-05-28 21:00:00","2019-05-28 21:30:00",3436,979,4415
"2019-05-27 10:10:50","2019-05-28 22:00:00","2019-05-28 22:30:00",3402,963,4365
"2019-05-28 10:10:35","2019-05-28 23:00:00","2019-05-28 23:30:00",3036,862,3898
"2019-05-28 10:10:35","2019-05-29 00:00:00","2019-05-29 00:30:00",2696,724,3420
"2019-05-28 10:10:35","2019-05-29 01:00:00","2019-05-29 01:30:00",2557,657,3214
"2019-05-28 10:10:35","2019-05-29 02:00:00","2019-05-29 02:30:00",2434,616,3050
"2019-05-28 10:10:35","2019-05-29 03:00:00","2019-05-29 03:30:00",2373,606,2979
"2019-05-28 10:10:35","2019-05-29 04:00:00","2019-05-29 04:30:00",2364,591,2955
"2019-05-28 10:10:35","2019-05-29 05:00:00","2019-05-29 05:30:00",2381,585,2966
"2019-05-28 10:10:35","2019-05-29 06:00:00","2019-05-29 06:30:00",2480,633,3113
"2019-05-28 10:10:35","2019-05-29 07:00:00","2019-05-29 07:30:00",2997,822,3819
"2019-05-28 10:10:35","2019-05-29 08:00:00","2019-05-29 08:30:00",3545,1004,4549
"2019-05-28 10:10:35","2019-05-29 09:00:00","2019-05-29 09:30:00",3683,1056,4739
"2019-05-28 10:10:35","2019-05-29 10:00:00","2019-05-29 10:30:00",3697,1060,4757
"2019-05-28 10:10:35","2019-05-29 11:00:00","2019-05-29 11:30:00",3657,1065,4722
"2019-05-28 10:10:35","2019-05-29 12:00:00","2019-05-29 12:30:00",3664,1075,4739
"2019-05-28 10:10:35","2019-05-29 13:00:00","2019-05-29 13:30:00",3672,1074,4746
"2019-05-28 10:10:35","2019-05-29 14:00:00","2019-05-29 14:30:00",3585,1030,4615
"2019-05-28 10:10:35","2019-05-29 15:00:00","2019-05-29 15:30:00",3582,1010,4592
"2019-05-28 10:10:35","2019-05-29 16:00:00","2019-05-29 16:30:00",3631,1037,4668
"2019-05-28 10:10:35","2019-05-29 17:00:00","2019-05-29 17:30:00",3746,1110,4856
"2019-05-28 10:10:35","2019-05-29 18:00:00","2019-05-29 18:30:00",3785,1089,4874
"2019-05-28 10:10:35","2019-05-29 19:00:00","2019-05-29 19:30:00",3635,996,4631
"2019-05-28 10:10:35","2019-05-29 20:00:00","2019-05-29 20:30:00",3488,948,4436
"2019-05-28 10:10:35","2019-05-29 21:00:00","2019-05-29 21:30:00",3389,906,4295
"2019-05-28 10:10:35","2019-05-29 22:00:00","2019-05-29 22:30:00",3365,886,4251
"2019-05-29 10:10:31","2019-05-29 23:00:00","2019-05-29 23:30:00",3040,899,3939
"2019-05-29 10:10:31","2019-05-30 00:00:00","2019-05-30 00:30:00",2768,634,3402
"2019-05-29 10:10:31","2019-05-30 01:00:00","2019-05-30 01:30:00",2607,573,3180
"2019-05-29 10:10:31","2019-05-30 02:00:00","2019-05-30 02:30:00",2488,539,3027
"2019-05-29 10:10:31","2019-05-30 03:00:00","2019-05-30 03:30:00",2420,531,2951
"2019-05-29 10:10:31","2019-05-30 04:00:00","2019-05-30 04:30:00",2400,514,2914
"2019-05-29 10:10:31","2019-05-30 05:00:00","2019-05-30 05:30:00",2447,509,2956
"2019-05-29 10:10:31","2019-05-30 06:00:00","2019-05-30 06:30:00",2528,577,3105
"2019-05-29 10:10:31","2019-05-30 07:00:00","2019-05-30 07:30:00",3009,739,3748
"2019-05-29 10:10:31","2019-05-30 08:00:00","2019-05-30 08:30:00",3546,883,4429
"2019-05-29 10:10:31","2019-05-30 09:00:00","2019-05-30 09:30:00",3687,940,4627
"2019-05-29 10:10:31","2019-05-30 10:00:00","2019-05-30 10:30:00",3704,936,4640
"2019-05-29 10:10:31","2019-05-30 11:00:00","2019-05-30 11:30:00",3693,929,4622
"2019-05-29 10:10:31","2019-05-30 12:00:00","2019-05-30 12:30:00",3708,932,4640
"2019-05-29 10:10:31","2019-05-30 13:00:00","2019-05-30 13:30:00",3753,929,4682
"2019-05-29 10:10:31","2019-05-30 14:00:00","2019-05-30 14:30:00",3689,903,4592
"2019-05-29 10:10:31","2019-05-30 15:00:00","2019-05-30 15:30:00",3705,906,4611
"2019-05-29 10:10:31","2019-05-30 16:00:00","2019-05-30 16:30:00",3740,925,4665
"2019-05-29 10:10:31","2019-05-30 17:00:00","2019-05-30 17:30:00",3841,991,4832
"2019-05-29 10:10:31","2019-05-30 18:00:00","2019-05-30 18:30:00",3893,986,4879
"2019-05-29 10:10:31","2019-05-30 19:00:00","2019-05-30 19:30:00",3751,903,4654
"2019-05-29 10:10:31","2019-05-30 20:00:00","2019-05-30 20:30:00",3588,886,4474
"2019-05-29 10:10:31","2019-05-30 21:00:00","2019-05-30 21:30:00",3493,859,4352
"2019-05-29 10:10:31","2019-05-30 22:00:00","2019-05-30 22:30:00",3433,854,4287
"2019-05-30 10:10:46","2019-05-30 23:00:00","2019-05-30 23:30:00",3106,811,3917
"2019-05-30 10:10:46","2019-05-31 00:00:00","2019-05-31 00:30:00",2816,681,3497
"2019-05-30 10:10:46","2019-05-31 01:00:00","2019-05-31 01:30:00",2654,615,3269
"2019-05-30 10:10:46","2019-05-31 02:00:00","2019-05-31 02:30:00",2497,585,3082
"2019-05-30 10:10:46","2019-05-31 03:00:00","2019-05-31 03:30:00",2412,574,2986
"2019-05-30 10:10:46","2019-05-31 04:00:00","2019-05-31 04:30:00",2379,562,2941
"2019-05-30 10:10:46","2019-05-31 05:00:00","2019-05-31 05:30:00",2374,560,2934
"2019-05-30 10:10:46","2019-05-31 06:00:00","2019-05-31 06:30:00",2469,605,3074
"2019-05-30 10:10:46","2019-05-31 07:00:00","2019-05-31 07:30:00",2919,761,3680
"2019-05-30 10:10:46","2019-05-31 08:00:00","2019-05-31 08:30:00",3436,920,4356
"2019-05-30 10:10:46","2019-05-31 09:00:00","2019-05-31 09:30:00",3652,989,4641
"2019-05-30 10:10:46","2019-05-31 10:00:00","2019-05-31 10:30:00",3715,1009,4724
"2019-05-30 10:10:46","2019-05-31 11:00:00","2019-05-31 11:30:00",3723,989,4712
"2019-05-30 10:10:46","2019-05-31 12:00:00","2019-05-31 12:30:00",3716,976,4692
"2019-05-30 10:10:46","2019-05-31 13:00:00","2019-05-31 13:30:00",3725,967,4692
"2019-05-30 10:10:46","2019-05-31 14:00:00","2019-05-31 14:30:00",3645,927,4572
"2019-05-30 10:10:46","2019-05-31 15:00:00","2019-05-31 15:30:00",3600,903,4503
"2019-05-30 10:10:46","2019-05-31 16:00:00","2019-05-31 16:30:00",3609,911,4520
"2019-05-30 10:10:46","2019-05-31 17:00:00","2019-05-31 17:30:00",3660,964,4624
"2019-05-30 10:10:46","2019-05-31 18:00:00","2019-05-31 18:30:00",3705,994,4699
"2019-05-30 10:10:46","2019-05-31 19:00:00","2019-05-31 19:30:00",3582,940,4522
"2019-05-30 10:10:46","2019-05-31 20:00:00","2019-05-31 20:30:00",3413,896,4309
"2019-05-30 10:10:46","2019-05-31 21:00:00","2019-05-31 21:30:00",3317,848,4165
"2019-05-30 10:10:46","2019-05-31 22:00:00","2019-05-31 22:30:00",3336,841,4177
"2019-05-31 10:10:30","2019-05-31 23:00:00","2019-05-31 23:30:00",3141,852,3993
"2019-05-31 10:10:30","2019-06-01 00:00:00","2019-06-01 00:30:00",2807,760,3567
"2019-05-31 10:10:30","2019-06-01 01:00:00","2019-06-01 01:30:00",2607,669,3276
"2019-05-31 10:10:30","2019-06-01 02:00:00","2019-06-01 02:30:00",2459,628,3087
"2019-05-31 10:10:30","2019-06-01 03:00:00","2019-06-01 03:30:00",2369,607,2976
"2019-05-31 10:10:30","2019-06-01 04:00:00","2019-06-01 04:30:00",2326,594,2920
"2019-05-31 10:10:30","2019-06-01 05:00:00","2019-06-01 05:30:00",2324,563,2887
"2019-05-31 10:10:30","2019-06-01 06:00:00","2019-06-01 06:30:00",2321,585,2906
"2019-05-31 10:10:30","2019-06-01 07:00:00","2019-06-01 07:30:00",2542,654,3196
"2019-05-31 10:10:30","2019-06-01 08:00:00","2019-06-01 08:30:00",2869,779,3648
"2019-05-31 10:10:30","2019-06-01 09:00:00","2019-06-01 09:30:00",3191,910,4101
"2019-05-31 10:10:30","2019-06-01 10:00:00","2019-06-01 10:30:00",3351,966,4317
"2019-05-31 10:10:30","2019-06-01 11:00:00","2019-06-01 11:30:00",3382,976,4358
"2019-05-31 10:10:30","2019-06-01 12:00:00","2019-06-01 12:30:00",3370,954,4324
"2019-05-31 10:10:30","2019-06-01 13:00:00","2019-06-01 13:30:00",3392,926,4318
"2019-05-31 10:10:30","2019-06-01 14:00:00","2019-06-01 14:30:00",3259,883,4142
"2019-05-31 10:10:30","2019-06-01 15:00:00","2019-06-01 15:30:00",3180,848,4028
"2019-05-31 10:10:30","2019-06-01 16:00:00","2019-06-01 16:30:00",3133,845,3978
"2019-05-31 10:10:30","2019-06-01 17:00:00","2019-06-01 17:30:00",3224,903,4127
"2019-05-31 10:10:30","2019-06-01 18:00:00","2019-06-01 18:30:00",3318,936,4254
"2019-05-31 10:10:30","2019-06-01 19:00:00","2019-06-01 19:30:00",3224,908,4132
"2019-05-31 10:10:30","2019-06-01 20:00:00","2019-06-01 20:30:00",3120,863,3983
"2019-05-31 10:10:30","2019-06-01 21:00:00","2019-06-01 21:30:00",3030,834,3864
"2019-05-31 10:10:30","2019-06-01 22:00:00","2019-06-01 22:30:00",2993,830,3823
"2019-06-01 10:10:50","2019-06-01 23:00:00","2019-06-01 23:30:00",2830,744,3574
"2019-06-01 10:10:50","2019-06-02 00:00:00","2019-06-02 00:30:00",2611,682,3293
"2019-06-01 10:10:50","2019-06-02 01:00:00","2019-06-02 01:30:00",2442,598,3040
"2019-06-01 10:10:50","2019-06-02 02:00:00","2019-06-02 02:30:00",2329,566,2895
"2019-06-01 10:10:50","2019-06-02 03:00:00","2019-06-02 03:30:00",2237,549,2786
"2019-06-01 10:10:50","2019-06-02 04:00:00","2019-06-02 04:30:00",2235,527,2762
"2019-06-01 10:10:50","2019-06-02 05:00:00","2019-06-02 05:30:00",2199,500,2699
"2019-06-01 10:10:50","2019-06-02 06:00:00","2019-06-02 06:30:00",2143,480,2623
"2019-06-01 10:10:50","2019-06-02 07:00:00","2019-06-02 07:30:00",2272,530,2802
"2019-06-01 10:10:50","2019-06-02 08:00:00","2019-06-02 08:30:00",2527,619,3146
"2019-06-01 10:10:50","2019-06-02 09:00:00","2019-06-02 09:30:00",2871,709,3580
"2019-06-01 10:10:50","2019-06-02 10:00:00","2019-06-02 10:30:00",3074,790,3864
"2019-06-01 10:10:50","2019-06-02 11:00:00","2019-06-02 11:30:00",3230,830,4060
"2019-06-01 10:10:50","2019-06-02 12:00:00","2019-06-02 12:30:00",3256,863,4119
"2019-06-01 10:10:50","2019-06-02 13:00:00","2019-06-02 13:30:00",3290,876,4166
"2019-06-01 10:10:50","2019-06-02 14:00:00","2019-06-02 14:30:00",3187,809,3996
"2019-06-01 10:10:50","2019-06-02 15:00:00","2019-06-02 15:30:00",3079,807,3886
"2019-06-01 10:10:50","2019-06-02 16:00:00","2019-06-02 16:30:00",3064,800,3864
"2019-06-01 10:10:50","2019-06-02 17:00:00","2019-06-02 17:30:00",3108,807,3915
"2019-06-01 10:10:50","2019-06-02 18:00:00","2019-06-02 18:30:00",3205,840,4045
"2019-06-01 10:10:50","2019-06-02 19:00:00","2019-06-02 19:30:00",3193,802,3995
"2019-06-01 10:10:50","2019-06-02 20:00:00","2019-06-02 20:30:00",3126,796,3922
"2019-06-01 10:10:50","2019-06-02 21:00:00","2019-06-02 21:30:00",3074,762,3836
"2019-06-01 10:10:50","2019-06-02 22:00:00","2019-06-02 22:30:00",3039,777,3816
"2019-06-02 10:10:50","2019-06-02 23:00:00","2019-06-02 23:30:00",2787,759,3546
"2019-06-02 10:10:50","2019-06-03 00:00:00","2019-06-03 00:30:00",2607,610,3217
"2019-06-02 10:10:50","2019-06-03 01:00:00","2019-06-03 01:30:00",2455,568,3023
"2019-06-02 10:10:50","2019-06-03 02:00:00","2019-06-03 02:30:00",2329,550,2879
"2019-06-02 10:10:50","2019-06-03 03:00:00","2019-06-03 03:30:00",2254,543,2797
"2019-06-02 10:10:50","2019-06-03 04:00:00","2019-06-03 04:30:00",2210,532,2742
"2019-06-02 10:10:50","2019-06-03 05:00:00","2019-06-03 05:30:00",2175,540,2715
"2019-06-02 10:10:50","2019-06-03 06:00:00","2019-06-03 06:30:00",2191,590,2781
"2019-06-02 10:10:50","2019-06-03 07:00:00","2019-06-03 07:30:00",2340,691,3031
"2019-06-02 10:10:50","2019-06-03 08:00:00","2019-06-03 08:30:00",2611,822,3433
"2019-06-02 10:10:50","2019-06-03 09:00:00","2019-06-03 09:30:00",2885,898,3783
"2019-06-02 10:10:50","2019-06-03 10:00:00","2019-06-03 10:30:00",3098,959,4057
"2019-06-02 10:10:50","2019-06-03 11:00:00","2019-06-03 11:30:00",3204,1003,4207
"2019-06-02 10:10:50","2019-06-03 12:00:00","2019-06-03 12:30:00",3222,1006,4228
"2019-06-02 10:10:50","2019-06-03 13:00:00","2019-06-03 13:30:00",3251,1006,4257
"2019-06-02 10:10:50","2019-06-03 14:00:00","2019-06-03 14:30:00",3171,997,4168
"2019-06-02 10:10:50","2019-06-03 15:00:00","2019-06-03 15:30:00",3104,975,4079
"2019-06-02 10:10:50","2019-06-03 16:00:00","2019-06-03 16:30:00",3107,983,4090
"2019-06-02 10:10:50","2019-06-03 17:00:00","2019-06-03 17:30:00",3183,1101,4284
"2019-06-02 10:10:50","2019-06-03 18:00:00","2019-06-03 18:30:00",3300,1080,4380
"2019-06-02 10:10:50","2019-06-03 19:00:00","2019-06-03 19:30:00",3243,1018,4261
"2019-06-02 10:10:50","2019-06-03 20:00:00","2019-06-03 20:30:00",3136,968,4104
"2019-06-02 10:10:50","2019-06-03 21:00:00","2019-06-03 21:30:00",3081,936,4017
"2019-06-02 10:10:50","2019-06-03 22:00:00","2019-06-03 22:30:00",3006,937,3943
"2019-06-04 10:10:55","2019-06-03 23:00:00","2019-06-03 23:30:00",2883,795,3678
"2019-06-04 10:10:55","2019-06-04 00:00:00","2019-06-04 00:30:00",2637,740,3377
"2019-06-04 10:10:55","2019-06-04 01:00:00","2019-06-04 01:30:00",2499,655,3154
"2019-06-04 10:10:55","2019-06-04 02:00:00","2019-06-04 02:30:00",2374,625,2999
"2019-06-04 10:10:55","2019-06-04 03:00:00","2019-06-04 03:30:00",2319,624,2943
"2019-06-04 10:10:55","2019-06-04 04:00:00","2019-06-04 04:30:00",2311,601,2912
"2019-06-04 10:10:55","2019-06-04 05:00:00","2019-06-04 05:30:00",2305,606,2911
"2019-06-04 10:10:55","2019-06-04 06:00:00","2019-06-04 06:30:00",2427,670,3097
"2019-06-04 10:10:55","2019-06-04 07:00:00","2019-06-04 07:30:00",2856,843,3699
"2019-06-04 10:10:55","2019-06-04 08:00:00","2019-06-04 08:30:00",3398,1029,4427
"2019-06-04 10:10:55","2019-06-04 09:00:00","2019-06-04 09:30:00",3614,1100,4714
"2019-06-04 10:10:55","2019-06-04 10:00:00","2019-06-04 10:30:00",3695,1104,4799
"2019-06-04 10:10:55","2019-06-04 11:00:00","2019-06-04 11:30:00",3711,1154,4865
"2019-06-04 10:10:55","2019-06-04 12:00:00","2019-06-04 12:30:00",3706,1162,4868
"2019-06-04 10:10:55","2019-06-04 13:00:00","2019-06-04 13:30:00",3705,1140,4845
"2019-06-04 10:10:55","2019-06-04 14:00:00","2019-06-04 14:30:00",3652,1108,4760
"2019-06-04 10:10:55","2019-06-04 15:00:00","2019-06-04 15:30:00",3662,1101,4763
"2019-06-04 10:10:55","2019-06-04 16:00:00","2019-06-04 16:30:00",3671,1125,4796
"2019-06-04 10:10:55","2019-06-04 17:00:00","2019-06-04 17:30:00",3759,1211,4970
"2019-06-04 10:10:55","2019-06-04 18:00:00","2019-06-04 18:30:00",3784,1214,4998
"2019-06-04 10:10:55","2019-06-04 19:00:00","2019-06-04 19:30:00",3602,1130,4732
"2019-06-04 10:10:55","2019-06-04 20:00:00","2019-06-04 20:30:00",3472,1074,4546
"2019-06-04 10:10:55","2019-06-04 21:00:00","2019-06-04 21:30:00",3393,1028,4421
"2019-06-04 10:10:55","2019-06-04 22:00:00","2019-06-04 22:30:00",3327,991,4318
"2019-06-04 10:10:55","2019-06-04 23:00:00","2019-06-04 23:30:00",3102,886,3988
"2019-06-04 10:10:55","2019-06-05 00:00:00","2019-06-05 00:30:00",2637,741,3378
"2019-06-04 10:10:55","2019-06-05 01:00:00","2019-06-05 01:30:00",2499,663,3162
"2019-06-04 10:10:55","2019-06-05 02:00:00","2019-06-05 02:30:00",2374,626,3000
"2019-06-04 10:10:55","2019-06-05 03:00:00","2019-06-05 03:30:00",2319,622,2941
"2019-06-04 10:10:55","2019-06-05 04:00:00","2019-06-05 04:30:00",2311,604,2915
"2019-06-04 10:10:55","2019-06-05 05:00:00","2019-06-05 05:30:00",2305,601,2906
"2019-06-04 10:10:55","2019-06-05 06:00:00","2019-06-05 06:30:00",2427,675,3102
"2019-06-04 10:10:55","2019-06-05 07:00:00","2019-06-05 07:30:00",2856,860,3716
"2019-06-04 10:10:55","2019-06-05 08:00:00","2019-06-05 08:30:00",3398,1054,4452
"2019-06-04 10:10:55","2019-06-05 09:00:00","2019-06-05 09:30:00",3614,1131,4745
"2019-06-04 10:10:55","2019-06-05 10:00:00","2019-06-05 10:30:00",3695,1135,4830
"2019-06-04 10:10:55","2019-06-05 11:00:00","2019-06-05 11:30:00",3711,1133,4844
"2019-06-04 10:10:55","2019-06-05 12:00:00","2019-06-05 12:30:00",3706,1138,4844
"2019-06-04 10:10:55","2019-06-05 13:00:00","2019-06-05 13:30:00",3705,1132,4837
"2019-06-04 10:10:55","2019-06-05 14:00:00","2019-06-05 14:30:00",3652,1089,4741
"2019-06-04 10:10:55","2019-06-05 15:00:00","2019-06-05 15:30:00",3662,1082,4744
"2019-06-04 10:10:55","2019-06-05 16:00:00","2019-06-05 16:30:00",3671,1107,4778
"2019-06-04 10:10:55","2019-06-05 17:00:00","2019-06-05 17:30:00",3759,1192,4951
"2019-06-04 10:10:55","2019-06-05 18:00:00","2019-06-05 18:30:00",3784,1198,4982
"2019-06-04 10:10:55","2019-06-05 19:00:00","2019-06-05 19:30:00",3602,1118,4720
"2019-06-04 10:10:55","2019-06-05 20:00:00","2019-06-05 20:30:00",3472,1068,4540
"2019-06-04 10:10:55","2019-06-05 21:00:00","2019-06-05 21:30:00",3393,1030,4423
"2019-06-04 10:10:55","2019-06-05 22:00:00","2019-06-05 22:30:00",3327,993,4320
"2019-06-05 10:10:50","2019-06-05 23:00:00","2019-06-05 23:30:00",3105,850,3955
"2019-06-05 10:10:50","2019-06-06 00:00:00","2019-06-06 00:30:00",2802,717,3519
"2019-06-05 10:10:50","2019-06-06 01:00:00","2019-06-06 01:30:00",2574,650,3224
"2019-06-05 10:10:50","2019-06-06 02:00:00","2019-06-06 02:30:00",2457,620,3077
"2019-06-05 10:10:50","2019-06-06 03:00:00","2019-06-06 03:30:00",2385,610,2995
"2019-06-05 10:10:50","2019-06-06 04:00:00","2019-06-06 04:30:00",2374,604,2978
"2019-06-05 10:10:50","2019-06-06 05:00:00","2019-06-06 05:30:00",2350,585,2935
"2019-06-05 10:10:50","2019-06-06 06:00:00","2019-06-06 06:30:00",2485,658,3143
"2019-06-05 10:10:50","2019-06-06 07:00:00","2019-06-06 07:30:00",2933,853,3786
"2019-06-05 10:10:50","2019-06-06 08:00:00","2019-06-06 08:30:00",3493,1041,4534
"2019-06-05 10:10:50","2019-06-06 09:00:00","2019-06-06 09:30:00",3691,1094,4785
"2019-06-05 10:10:50","2019-06-06 10:00:00","2019-06-06 10:30:00",3657,1107,4764
"2019-06-05 10:10:50","2019-06-06 11:00:00","2019-06-06 11:30:00",3766,1110,4876
"2019-06-05 10:10:50","2019-06-06 12:00:00","2019-06-06 12:30:00",3780,1096,4876
"2019-06-05 10:10:50","2019-06-06 13:00:00","2019-06-06 13:30:00",3799,1100,4899
"2019-06-05 10:10:50","2019-06-06 14:00:00","2019-06-06 14:30:00",3744,1055,4799
"2019-06-05 10:10:50","2019-06-06 15:00:00","2019-06-06 15:30:00",3745,1055,4800
"2019-06-05 10:10:50","2019-06-06 16:00:00","2019-06-06 16:30:00",3760,1079,4839
"2019-06-05 10:10:50","2019-06-06 17:00:00","2019-06-06 17:30:00",3815,1180,4995
"2019-06-05 10:10:50","2019-06-06 18:00:00","2019-06-06 18:30:00",3836,1176,5012
"2019-06-05 10:10:50","2019-06-06 19:00:00","2019-06-06 19:30:00",3695,1071,4766
"2019-06-05 10:10:50","2019-06-06 20:00:00","2019-06-06 20:30:00",3558,1012,4570
"2019-06-05 10:10:50","2019-06-06 21:00:00","2019-06-06 21:30:00",3423,986,4409
"2019-06-05 10:10:50","2019-06-06 22:00:00","2019-06-06 22:30:00",3304,943,4247
"2019-06-06 10:10:26","2019-06-06 23:00:00","2019-06-06 23:30:00",3033,761,3794
"2019-06-06 10:10:26","2019-06-07 00:00:00","2019-06-07 00:30:00",2733,746,3479
"2019-06-06 10:10:26","2019-06-07 01:00:00","2019-06-07 01:30:00",2539,688,3227
"2019-06-06 10:10:26","2019-06-07 02:00:00","2019-06-07 02:30:00",2391,653,3044
"2019-06-06 10:10:26","2019-06-07 03:00:00","2019-06-07 03:30:00",2314,639,2953
"2019-06-06 10:10:26","2019-06-07 04:00:00","2019-06-07 04:30:00",2324,631,2955
"2019-06-06 10:10:26","2019-06-07 05:00:00","2019-06-07 05:30:00",2371,606,2977
"2019-06-06 10:10:26","2019-06-07 06:00:00","2019-06-07 06:30:00",2426,666,3092
"2019-06-06 10:10:26","2019-06-07 07:00:00","2019-06-07 07:30:00",2867,822,3689
"2019-06-06 10:10:26","2019-06-07 08:00:00","2019-06-07 08:30:00",3442,1020,4462
"2019-06-06 10:10:26","2019-06-07 09:00:00","2019-06-07 09:30:00",3636,1090,4726
"2019-06-06 10:10:26","2019-06-07 10:00:00","2019-06-07 10:30:00",3677,1080,4757
"2019-06-06 10:10:26","2019-06-07 11:00:00","2019-06-07 11:30:00",3683,1069,4752
"2019-06-06 10:10:26","2019-06-07 12:00:00","2019-06-07 12:30:00",3673,1063,4736
"2019-06-06 10:10:26","2019-06-07 13:00:00","2019-06-07 13:30:00",3702,1051,4753
"2019-06-06 10:10:26","2019-06-07 14:00:00","2019-06-07 14:30:00",3577,999,4576
"2019-06-06 10:10:26","2019-06-07 15:00:00","2019-06-07 15:30:00",3540,970,4510
"2019-06-06 10:10:26","2019-06-07 16:00:00","2019-06-07 16:30:00",3541,976,4517
"2019-06-06 10:10:26","2019-06-07 17:00:00","2019-06-07 17:30:00",3628,1042,4670
"2019-06-06 10:10:26","2019-06-07 18:00:00","2019-06-07 18:30:00",3632,1031,4663
"2019-06-06 10:10:26","2019-06-07 19:00:00","2019-06-07 19:30:00",3491,963,4454
"2019-06-06 10:10:26","2019-06-07 20:00:00","2019-06-07 20:30:00",3303,915,4218
"2019-06-06 10:10:26","2019-06-07 21:00:00","2019-06-07 21:30:00",3165,873,4038
"2019-06-06 10:10:26","2019-06-07 22:00:00","2019-06-07 22:30:00",3117,854,3971
"2019-06-07 10:10:15","2019-06-07 23:00:00","2019-06-07 23:30:00",3003,845,3848
"2019-06-07 10:10:15","2019-06-08 00:00:00","2019-06-08 00:30:00",2859,692,3551
"2019-06-07 10:10:15","2019-06-08 01:00:00","2019-06-08 01:30:00",2679,616,3295
"2019-06-07 10:10:15","2019-06-08 02:00:00","2019-06-08 02:30:00",2540,588,3128
"2019-06-07 10:10:15","2019-06-08 03:00:00","2019-06-08 03:30:00",2452,564,3016
"2019-06-07 10:10:15","2019-06-08 04:00:00","2019-06-08 04:30:00",2418,548,2966
"2019-06-07 10:10:15","2019-06-08 05:00:00","2019-06-08 05:30:00",2404,515,2919
"2019-06-07 10:10:15","2019-06-08 06:00:00","2019-06-08 06:30:00",2427,550,2977
"2019-06-07 10:10:15","2019-06-08 07:00:00","2019-06-08 07:30:00",2609,650,3259
"2019-06-07 10:10:15","2019-06-08 08:00:00","2019-06-08 08:30:00",2922,740,3662
"2019-06-07 10:10:15","2019-06-08 09:00:00","2019-06-08 09:30:00",3224,870,4094
"2019-06-07 10:10:15","2019-06-08 10:00:00","2019-06-08 10:30:00",3384,915,4299
"2019-06-07 10:10:15","2019-06-08 11:00:00","2019-06-08 11:30:00",3423,941,4364
"2019-06-07 10:10:15","2019-06-08 12:00:00","2019-06-08 12:30:00",3389,933,4322
"2019-06-07 10:10:15","2019-06-08 13:00:00","2019-06-08 13:30:00",3381,910,4291
"2019-06-07 10:10:15","2019-06-08 14:00:00","2019-06-08 14:30:00",3258,861,4119
"2019-06-07 10:10:15","2019-06-08 15:00:00","2019-06-08 15:30:00",3182,845,4027
"2019-06-07 10:10:15","2019-06-08 16:00:00","2019-06-08 16:30:00",3179,865,4044
"2019-06-07 10:10:15","2019-06-08 17:00:00","2019-06-08 17:30:00",3306,910,4216
"2019-06-07 10:10:15","2019-06-08 18:00:00","2019-06-08 18:30:00",3435,980,4415
"2019-06-07 10:10:15","2019-06-08 19:00:00","2019-06-08 19:30:00",3358,920,4278
"2019-06-07 10:10:15","2019-06-08 20:00:00","2019-06-08 20:30:00",3201,868,4069
"2019-06-07 10:10:15","2019-06-08 21:00:00","2019-06-08 21:30:00",3126,840,3966
"2019-06-07 10:10:15","2019-06-08 22:00:00","2019-06-08 22:30:00",3062,813,3875
"2019-06-08 10:10:31","2019-06-08 23:00:00","2019-06-08 23:30:00",2757,804,3561
"2019-06-08 10:10:31","2019-06-09 00:00:00","2019-06-09 00:30:00",2692,659,3351
"2019-06-08 10:10:31","2019-06-09 01:00:00","2019-06-09 01:30:00",2617,593,3210
"2019-06-08 10:10:31","2019-06-09 02:00:00","2019-06-09 02:30:00",2502,552,3054
"2019-06-08 10:10:31","2019-06-09 03:00:00","2019-06-09 03:30:00",2421,553,2974
"2019-06-08 10:10:31","2019-06-09 04:00:00","2019-06-09 04:30:00",2375,528,2903
"2019-06-08 10:10:31","2019-06-09 05:00:00","2019-06-09 05:30:00",2340,503,2843
"2019-06-08 10:10:31","2019-06-09 06:00:00","2019-06-09 06:30:00",2286,532,2818
"2019-06-08 10:10:31","2019-06-09 07:00:00","2019-06-09 07:30:00",2397,580,2977
"2019-06-08 10:10:31","2019-06-09 08:00:00","2019-06-09 08:30:00",2604,626,3230
"2019-06-08 10:10:31","2019-06-09 09:00:00","2019-06-09 09:30:00",2824,737,3561
"2019-06-08 10:10:31","2019-06-09 10:00:00","2019-06-09 10:30:00",3068,786,3854
"2019-06-08 10:10:31","2019-06-09 11:00:00","2019-06-09 11:30:00",3141,813,3954
"2019-06-08 10:10:31","2019-06-09 12:00:00","2019-06-09 12:30:00",3209,880,4089
"2019-06-08 10:10:31","2019-06-09 13:00:00","2019-06-09 13:30:00",3223,887,4110
"2019-06-08 10:10:31","2019-06-09 14:00:00","2019-06-09 14:30:00",3130,857,3987
"2019-06-08 10:10:31","2019-06-09 15:00:00","2019-06-09 15:30:00",3072,780,3852
"2019-06-08 10:10:31","2019-06-09 16:00:00","2019-06-09 16:30:00",3024,788,3812
"2019-06-08 10:10:31","2019-06-09 17:00:00","2019-06-09 17:30:00",3092,847,3939
"2019-06-08 10:10:31","2019-06-09 18:00:00","2019-06-09 18:30:00",3169,913,4082
"2019-06-08 10:10:31","2019-06-09 19:00:00","2019-06-09 19:30:00",3128,899,4027
"2019-06-08 10:10:31","2019-06-09 20:00:00","2019-06-09 20:30:00",3019,863,3882
"2019-06-08 10:10:31","2019-06-09 21:00:00","2019-06-09 21:30:00",2904,871,3775
"2019-06-08 10:10:31","2019-06-09 22:00:00","2019-06-09 22:30:00",2883,818,3701
"2019-06-09 10:10:15","2019-06-09 23:00:00","2019-06-09 23:30:00",2693,746,3439
"2019-06-09 10:10:15","2019-06-10 00:00:00","2019-06-10 00:30:00",2582,689,3271
"2019-06-09 10:10:15","2019-06-10 01:00:00","2019-06-10 01:30:00",2408,620,3028
"2019-06-09 10:10:15","2019-06-10 02:00:00","2019-06-10 02:30:00",2324,594,2918
"2019-06-09 10:10:15","2019-06-10 03:00:00","2019-06-10 03:30:00",2253,584,2837
"2019-06-09 10:10:15","2019-06-10 04:00:00","2019-06-10 04:30:00",2263,574,2837
"2019-06-09 10:10:15","2019-06-10 05:00:00","2019-06-10 05:30:00",2264,551,2815
"2019-06-09 10:10:15","2019-06-10 06:00:00","2019-06-10 06:30:00",2375,608,2983
"2019-06-09 10:10:15","2019-06-10 07:00:00","2019-06-10 07:30:00",2832,775,3607
"2019-06-09 10:10:15","2019-06-10 08:00:00","2019-06-10 08:30:00",3395,976,4371
"2019-06-09 10:10:15","2019-06-10 09:00:00","2019-06-10 09:30:00",3612,1065,4677
"2019-06-09 10:10:15","2019-06-10 10:00:00","2019-06-10 10:30:00",3696,1098,4794
"2019-06-09 10:10:15","2019-06-10 11:00:00","2019-06-10 11:30:00",3709,1106,4815
"2019-06-09 10:10:15","2019-06-10 12:00:00","2019-06-10 12:30:00",3733,1111,4844
"2019-06-09 10:10:15","2019-06-10 13:00:00","2019-06-10 13:30:00",3745,1107,4852
"2019-06-09 10:10:15","2019-06-10 14:00:00","2019-06-10 14:30:00",3677,1071,4748
"2019-06-09 10:10:15","2019-06-10 15:00:00","2019-06-10 15:30:00",3690,1054,4744
"2019-06-09 10:10:15","2019-06-10 16:00:00","2019-06-10 16:30:00",3730,1092,4822
"2019-06-09 10:10:15","2019-06-10 17:00:00","2019-06-10 17:30:00",3819,1173,4992
"2019-06-09 10:10:15","2019-06-10 18:00:00","2019-06-10 18:30:00",3825,1151,4976
"2019-06-09 10:10:15","2019-06-10 19:00:00","2019-06-10 19:30:00",3637,1042,4679
"2019-06-09 10:10:15","2019-06-10 20:00:00","2019-06-10 20:30:00",3475,988,4463
"2019-06-09 10:10:15","2019-06-10 21:00:00","2019-06-10 21:30:00",3372,968,4340
"2019-06-09 10:10:15","2019-06-10 22:00:00","2019-06-10 22:30:00",3249,929,4178
"2019-06-10 10:10:30","2019-06-10 23:00:00","2019-06-10 23:30:00",2964,813,3777
"2019-06-10 10:10:30","2019-06-11 00:00:00","2019-06-11 00:30:00",2703,707,3410
"2019-06-10 10:10:30","2019-06-11 01:00:00","2019-06-11 01:30:00",2578,659,3237
"2019-06-10 10:10:30","2019-06-11 02:00:00","2019-06-11 02:30:00",2444,626,3070
"2019-06-10 10:10:30","2019-06-11 03:00:00","2019-06-11 03:30:00",2387,614,3001
"2019-06-10 10:10:30","2019-06-11 04:00:00","2019-06-11 04:30:00",2336,597,2933
"2019-06-10 10:10:30","2019-06-11 05:00:00","2019-06-11 05:30:00",2350,589,2939
"2019-06-10 10:10:30","2019-06-11 06:00:00","2019-06-11 06:30:00",2469,647,3116
"2019-06-10 10:10:30","2019-06-11 07:00:00","2019-06-11 07:30:00",2948,812,3760
"2019-06-10 10:10:30","2019-06-11 08:00:00","2019-06-11 08:30:00",3466,991,4457
"2019-06-10 10:10:30","2019-06-11 09:00:00","2019-06-11 09:30:00",3615,1042,4657
"2019-06-10 10:10:30","2019-06-11 10:00:00","2019-06-11 10:30:00",3640,1070,4710
"2019-06-10 10:10:30","2019-06-11 11:00:00","2019-06-11 11:30:00",3707,1059,4766
"2019-06-10 10:10:30","2019-06-11 12:00:00","2019-06-11 12:30:00",3676,1037,4713
"2019-06-10 10:10:30","2019-06-11 13:00:00","2019-06-11 13:30:00",3684,1027,4711
"2019-06-10 10:10:30","2019-06-11 14:00:00","2019-06-11 14:30:00",3609,993,4602
"2019-06-10 10:10:30","2019-06-11 15:00:00","2019-06-11 15:30:00",3659,960,4619
"2019-06-10 10:10:30","2019-06-11 16:00:00","2019-06-11 16:30:00",3721,994,4715
"2019-06-10 10:10:30","2019-06-11 17:00:00","2019-06-11 17:30:00",3810,1062,4872
"2019-06-10 10:10:30","2019-06-11 18:00:00","2019-06-11 18:30:00",3857,1048,4905
"2019-06-10 10:10:30","2019-06-11 19:00:00","2019-06-11 19:30:00",3693,996,4689
"2019-06-10 10:10:30","2019-06-11 20:00:00","2019-06-11 20:30:00",3536,959,4495
"2019-06-10 10:10:30","2019-06-11 21:00:00","2019-06-11 21:30:00",3438,946,4384
"2019-06-10 10:10:30","2019-06-11 22:00:00","2019-06-11 22:30:00",3264,904,4168
"2019-06-11 10:10:16","2019-06-11 23:00:00","2019-06-11 23:30:00",3038,841,3879
"2019-06-11 10:10:16","2019-06-12 00:00:00","2019-06-12 00:30:00",2703,700,3403
"2019-06-11 10:10:16","2019-06-12 01:00:00","2019-06-12 01:30:00",2574,655,3229
"2019-06-11 10:10:16","2019-06-12 02:00:00","2019-06-12 02:30:00",2437,618,3055
"2019-06-11 10:10:16","2019-06-12 03:00:00","2019-06-12 03:30:00",2375,607,2982
"2019-06-11 10:10:16","2019-06-12 04:00:00","2019-06-12 04:30:00",2322,594,2916
"2019-06-11 10:10:16","2019-06-12 05:00:00","2019-06-12 05:30:00",2332,586,2918
"2019-06-11 10:10:16","2019-06-12 06:00:00","2019-06-12 06:30:00",2446,647,3093
"2019-06-11 10:10:16","2019-06-12 07:00:00","2019-06-12 07:30:00",2915,819,3734
"2019-06-11 10:10:16","2019-06-12 08:00:00","2019-06-12 08:30:00",3420,999,4419
"2019-06-11 10:10:16","2019-06-12 09:00:00","2019-06-12 09:30:00",3561,1044,4605
"2019-06-11 10:10:16","2019-06-12 10:00:00","2019-06-12 10:30:00",3578,1062,4640
"2019-06-11 10:10:16","2019-06-12 11:00:00","2019-06-12 11:30:00",3637,1052,4689
"2019-06-11 10:10:16","2019-06-12 12:00:00","2019-06-12 12:30:00",3600,1032,4632
"2019-06-11 10:10:16","2019-06-12 13:00:00","2019-06-12 13:30:00",3601,1025,4626
"2019-06-11 10:10:16","2019-06-12 14:00:00","2019-06-12 14:30:00",3521,983,4504
"2019-06-11 10:10:16","2019-06-12 15:00:00","2019-06-12 15:30:00",3563,964,4527
"2019-06-11 10:10:16","2019-06-12 16:00:00","2019-06-12 16:30:00",3616,983,4599
"2019-06-11 10:10:16","2019-06-12 17:00:00","2019-06-12 17:30:00",3696,1058,4754
"2019-06-11 10:10:16","2019-06-12 18:00:00","2019-06-12 18:30:00",3748,1055,4803
"2019-06-11 10:10:16","2019-06-12 19:00:00","2019-06-12 19:30:00",3607,994,4601
"2019-06-11 10:10:16","2019-06-12 20:00:00","2019-06-12 20:30:00",3472,958,4430
"2019-06-11 10:10:16","2019-06-12 21:00:00","2019-06-12 21:30:00",3394,942,4336
"2019-06-11 10:10:16","2019-06-12 22:00:00","2019-06-12 22:30:00",3239,895,4134
"2019-06-12 10:10:16","2019-06-12 23:00:00","2019-06-12 23:30:00",2997,803,3800
"2019-06-12 10:10:16","2019-06-13 00:00:00","2019-06-13 00:30:00",2703,683,3386
"2019-06-12 10:10:16","2019-06-13 01:00:00","2019-06-13 01:30:00",2574,622,3196
"2019-06-12 10:10:16","2019-06-13 02:00:00","2019-06-13 02:30:00",2437,599,3036
"2019-06-12 10:10:16","2019-06-13 03:00:00","2019-06-13 03:30:00",2375,578,2953
"2019-06-12 10:10:16","2019-06-13 04:00:00","2019-06-13 04:30:00",2322,575,2897
"2019-06-12 10:10:16","2019-06-13 05:00:00","2019-06-13 05:30:00",2332,564,2896
"2019-06-12 10:10:16","2019-06-13 06:00:00","2019-06-13 06:30:00",2447,622,3069
"2019-06-12 10:10:16","2019-06-13 07:00:00","2019-06-13 07:30:00",2918,806,3724
"2019-06-12 10:10:16","2019-06-13 08:00:00","2019-06-13 08:30:00",3427,982,4409
"2019-06-12 10:10:16","2019-06-13 09:00:00","2019-06-13 09:30:00",3572,1015,4587
"2019-06-12 10:10:16","2019-06-13 10:00:00","2019-06-13 10:30:00",3592,1043,4635
"2019-06-12 10:10:16","2019-06-13 11:00:00","2019-06-13 11:30:00",3654,1060,4714
"2019-06-12 10:10:16","2019-06-13 12:00:00","2019-06-13 12:30:00",3620,1025,4645
"2019-06-12 10:10:16","2019-06-13 13:00:00","2019-06-13 13:30:00",3625,1014,4639
"2019-06-12 10:10:16","2019-06-13 14:00:00","2019-06-13 14:30:00",3547,994,4541
"2019-06-12 10:10:16","2019-06-13 15:00:00","2019-06-13 15:30:00",3593,1002,4595
"2019-06-12 10:10:16","2019-06-13 16:00:00","2019-06-13 16:30:00",3650,1014,4664
"2019-06-12 10:10:16","2019-06-13 17:00:00","2019-06-13 17:30:00",3733,1091,4824
"2019-06-12 10:10:16","2019-06-13 18:00:00","2019-06-13 18:30:00",3784,1079,4863
"2019-06-12 10:10:16","2019-06-13 19:00:00","2019-06-13 19:30:00",3636,1016,4652
"2019-06-12 10:10:16","2019-06-13 20:00:00","2019-06-13 20:30:00",3493,965,4458
"2019-06-12 10:10:16","2019-06-13 21:00:00","2019-06-13 21:30:00",3409,948,4357
"2019-06-12 10:10:16","2019-06-13 22:00:00","2019-06-13 22:30:00",3247,892,4139
"2019-06-14 10:10:16","2019-06-13 23:00:00","2019-06-13 23:30:00",3046,826,3872
"2019-06-14 10:10:16","2019-06-14 00:00:00","2019-06-14 00:30:00",2666,722,3388
"2019-06-14 10:10:16","2019-06-14 01:00:00","2019-06-14 01:30:00",2496,649,3145
"2019-06-14 10:10:16","2019-06-14 02:00:00","2019-06-14 02:30:00",2333,606,2939
"2019-06-14 10:10:16","2019-06-14 03:00:00","2019-06-14 03:30:00",2251,597,2848
"2019-06-14 10:10:16","2019-06-14 04:00:00","2019-06-14 04:30:00",2255,587,2842
"2019-06-14 10:10:16","2019-06-14 05:00:00","2019-06-14 05:30:00",2268,577,2845
"2019-06-14 10:10:16","2019-06-14 06:00:00","2019-06-14 06:30:00",2426,644,3070
"2019-06-14 10:10:16","2019-06-14 07:00:00","2019-06-14 07:30:00",2876,831,3707
"2019-06-14 10:10:16","2019-06-14 08:00:00","2019-06-14 08:30:00",3405,1004,4409
"2019-06-14 10:10:16","2019-06-14 09:00:00","2019-06-14 09:30:00",3607,1016,4623
"2019-06-14 10:10:16","2019-06-14 10:00:00","2019-06-14 10:30:00",3638,1029,4667
"2019-06-14 10:10:16","2019-06-14 11:00:00","2019-06-14 11:30:00",3650,1063,4713
"2019-06-14 10:10:16","2019-06-14 12:00:00","2019-06-14 12:30:00",3630,1068,4698
"2019-06-14 10:10:16","2019-06-14 13:00:00","2019-06-14 13:30:00",3650,1052,4702
"2019-06-14 10:10:16","2019-06-14 14:00:00","2019-06-14 14:30:00",3504,980,4484
"2019-06-14 10:10:16","2019-06-14 15:00:00","2019-06-14 15:30:00",3488,941,4429
"2019-06-14 10:10:16","2019-06-14 16:00:00","2019-06-14 16:30:00",3479,949,4428
"2019-06-14 10:10:16","2019-06-14 17:00:00","2019-06-14 17:30:00",3600,1020,4620
"2019-06-14 10:10:16","2019-06-14 18:00:00","2019-06-14 18:30:00",3600,1045,4645
"2019-06-14 10:10:16","2019-06-14 19:00:00","2019-06-14 19:30:00",3499,959,4458
"2019-06-14 10:10:16","2019-06-14 20:00:00","2019-06-14 20:30:00",3363,905,4268
"2019-06-14 10:10:16","2019-06-14 21:00:00","2019-06-14 21:30:00",3239,872,4111
"2019-06-14 10:10:16","2019-06-14 22:00:00","2019-06-14 22:30:00",3153,839,3992
"2019-06-14 10:10:16","2019-06-14 23:00:00","2019-06-14 23:30:00",2997,788,3785
"2019-06-14 10:10:16","2019-06-15 00:00:00","2019-06-15 00:30:00",2731,666,3397
"2019-06-14 10:10:16","2019-06-15 01:00:00","2019-06-15 01:30:00",2560,600,3160
"2019-06-14 10:10:16","2019-06-15 02:00:00","2019-06-15 02:30:00",2410,572,2982
"2019-06-14 10:10:16","2019-06-15 03:00:00","2019-06-15 03:30:00",2296,560,2856
"2019-06-14 10:10:16","2019-06-15 04:00:00","2019-06-15 04:30:00",2275,540,2815
"2019-06-14 10:10:16","2019-06-15 05:00:00","2019-06-15 05:30:00",2258,523,2781
"2019-06-14 10:10:16","2019-06-15 06:00:00","2019-06-15 06:30:00",2264,552,2816
"2019-06-14 10:10:16","2019-06-15 07:00:00","2019-06-15 07:30:00",2465,619,3084
"2019-06-14 10:10:16","2019-06-15 08:00:00","2019-06-15 08:30:00",2798,722,3520
"2019-06-14 10:10:16","2019-06-15 09:00:00","2019-06-15 09:30:00",3139,839,3978
"2019-06-14 10:10:16","2019-06-15 10:00:00","2019-06-15 10:30:00",3280,875,4155
"2019-06-14 10:10:16","2019-06-15 11:00:00","2019-06-15 11:30:00",3315,890,4205
"2019-06-14 10:10:16","2019-06-15 12:00:00","2019-06-15 12:30:00",3335,899,4234
"2019-06-14 10:10:16","2019-06-15 13:00:00","2019-06-15 13:30:00",3290,869,4159
"2019-06-14 10:10:16","2019-06-15 14:00:00","2019-06-15 14:30:00",3202,824,4026
"2019-06-14 10:10:16","2019-06-15 15:00:00","2019-06-15 15:30:00",3125,792,3917
"2019-06-14 10:10:16","2019-06-15 16:00:00","2019-06-15 16:30:00",3097,830,3927
"2019-06-14 10:10:16","2019-06-15 17:00:00","2019-06-15 17:30:00",3173,852,4025
"2019-06-14 10:10:16","2019-06-15 18:00:00","2019-06-15 18:30:00",3255,877,4132
"2019-06-14 10:10:16","2019-06-15 19:00:00","2019-06-15 19:30:00",3197,868,4065
"2019-06-14 10:10:16","2019-06-15 20:00:00","2019-06-15 20:30:00",3037,827,3864
"2019-06-14 10:10:16","2019-06-15 21:00:00","2019-06-15 21:30:00",2923,782,3705
"2019-06-14 10:10:16","2019-06-15 22:00:00","2019-06-15 22:30:00",2827,779,3606
"2019-06-15 10:10:31","2019-06-15 23:00:00","2019-06-15 23:30:00",2833,804,3637
"2019-06-15 10:10:31","2019-06-16 00:00:00","2019-06-16 00:30:00",2583,650,3233
"2019-06-15 10:10:31","2019-06-16 01:00:00","2019-06-16 01:30:00",2422,582,3004
"2019-06-15 10:10:31","2019-06-16 02:00:00","2019-06-16 02:30:00",2296,544,2840
"2019-06-15 10:10:31","2019-06-16 03:00:00","2019-06-16 03:30:00",2200,528,2728
"2019-06-15 10:10:31","2019-06-16 04:00:00","2019-06-16 04:30:00",2183,524,2707
"2019-06-15 10:10:31","2019-06-16 05:00:00","2019-06-16 05:30:00",2138,489,2627
"2019-06-15 10:10:31","2019-06-16 06:00:00","2019-06-16 06:30:00",2151,502,2653
"2019-06-15 10:10:31","2019-06-16 07:00:00","2019-06-16 07:30:00",2281,538,2819
"2019-06-15 10:10:31","2019-06-16 08:00:00","2019-06-16 08:30:00",2528,617,3145
"2019-06-15 10:10:31","2019-06-16 09:00:00","2019-06-16 09:30:00",2818,710,3528
"2019-06-15 10:10:31","2019-06-16 10:00:00","2019-06-16 10:30:00",3033,804,3837
"2019-06-15 10:10:31","2019-06-16 11:00:00","2019-06-16 11:30:00",3139,867,4006
"2019-06-15 10:10:31","2019-06-16 12:00:00","2019-06-16 12:30:00",3216,896,4112
"2019-06-15 10:10:31","2019-06-16 13:00:00","2019-06-16 13:30:00",3238,935,4173
"2019-06-15 10:10:31","2019-06-16 14:00:00","2019-06-16 14:30:00",3153,886,4039
"2019-06-15 10:10:31","2019-06-16 15:00:00","2019-06-16 15:30:00",3090,844,3934
"2019-06-15 10:10:31","2019-06-16 16:00:00","2019-06-16 16:30:00",3094,847,3941
"2019-06-15 10:10:31","2019-06-16 17:00:00","2019-06-16 17:30:00",3150,916,4066
"2019-06-15 10:10:31","2019-06-16 18:00:00","2019-06-16 18:30:00",3291,948,4239
"2019-06-15 10:10:31","2019-06-16 19:00:00","2019-06-16 19:30:00",3239,916,4155
"2019-06-15 10:10:31","2019-06-16 20:00:00","2019-06-16 20:30:00",3136,882,4018
"2019-06-15 10:10:31","2019-06-16 21:00:00","2019-06-16 21:30:00",3049,855,3904
"2019-06-15 10:10:31","2019-06-16 22:00:00","2019-06-16 22:30:00",2907,800,3707
"2019-06-16 10:10:15","2019-06-16 23:00:00","2019-06-16 23:30:00",2795,809,3604
"2019-06-16 10:10:15","2019-06-17 00:00:00","2019-06-17 00:30:00",2484,672,3156
"2019-06-16 10:10:15","2019-06-17 01:00:00","2019-06-17 01:30:00",2316,613,2929
"2019-06-16 10:10:15","2019-06-17 02:00:00","2019-06-17 02:30:00",2215,588,2803
"2019-06-16 10:10:15","2019-06-17 03:00:00","2019-06-17 03:30:00",2150,584,2734
"2019-06-16 10:10:15","2019-06-17 04:00:00","2019-06-17 04:30:00",2160,578,2738
"2019-06-16 10:10:15","2019-06-17 05:00:00","2019-06-17 05:30:00",2134,550,2684
"2019-06-16 10:10:15","2019-06-17 06:00:00","2019-06-17 06:30:00",2284,623,2907
"2019-06-16 10:10:15","2019-06-17 07:00:00","2019-06-17 07:30:00",2716,789,3505
"2019-06-16 10:10:15","2019-06-17 08:00:00","2019-06-17 08:30:00",3207,983,4190
"2019-06-16 10:10:15","2019-06-17 09:00:00","2019-06-17 09:30:00",3440,1046,4486
"2019-06-16 10:10:15","2019-06-17 10:00:00","2019-06-17 10:30:00",3547,1038,4585
"2019-06-16 10:10:15","2019-06-17 11:00:00","2019-06-17 11:30:00",3595,1026,4621
"2019-06-16 10:10:15","2019-06-17 12:00:00","2019-06-17 12:30:00",3611,1025,4636
"2019-06-16 10:10:15","2019-06-17 13:00:00","2019-06-17 13:30:00",3661,995,4656
"2019-06-16 10:10:15","2019-06-17 14:00:00","2019-06-17 14:30:00",3610,956,4566
"2019-06-16 10:10:15","2019-06-17 15:00:00","2019-06-17 15:30:00",3642,934,4576
"2019-06-16 10:10:15","2019-06-17 16:00:00","2019-06-17 16:30:00",3690,958,4648
"2019-06-16 10:10:15","2019-06-17 17:00:00","2019-06-17 17:30:00",3779,1032,4811
"2019-06-16 10:10:15","2019-06-17 18:00:00","2019-06-17 18:30:00",3806,999,4805
"2019-06-16 10:10:15","2019-06-17 19:00:00","2019-06-17 19:30:00",3634,924,4558
"2019-06-16 10:10:15","2019-06-17 20:00:00","2019-06-17 20:30:00",3437,891,4328
"2019-06-16 10:10:15","2019-06-17 21:00:00","2019-06-17 21:30:00",3317,894,4211
"2019-06-16 10:10:15","2019-06-17 22:00:00","2019-06-17 22:30:00",3107,843,3950
"2019-06-17 10:10:06","2019-06-17 23:00:00","2019-06-17 23:30:00",2951,848,3799
"2019-06-17 10:10:06","2019-06-18 00:00:00","2019-06-18 00:30:00",2641,641,3282
"2019-06-17 10:10:06","2019-06-18 01:00:00","2019-06-18 01:30:00",2473,587,3060
"2019-06-17 10:10:06","2019-06-18 02:00:00","2019-06-18 02:30:00",2358,563,2921
"2019-06-17 10:10:06","2019-06-18 03:00:00","2019-06-18 03:30:00",2300,554,2854
"2019-06-17 10:10:06","2019-06-18 04:00:00","2019-06-18 04:30:00",2301,548,2849
"2019-06-17 10:10:06","2019-06-18 05:00:00","2019-06-18 05:30:00",2278,539,2817
"2019-06-17 10:10:06","2019-06-18 06:00:00","2019-06-18 06:30:00",2388,587,2975
"2019-06-17 10:10:06","2019-06-18 07:00:00","2019-06-18 07:30:00",2810,744,3554
"2019-06-17 10:10:06","2019-06-18 08:00:00","2019-06-18 08:30:00",3335,935,4270
"2019-06-17 10:10:06","2019-06-18 09:00:00","2019-06-18 09:30:00",3551,968,4519
"2019-06-17 10:10:06","2019-06-18 10:00:00","2019-06-18 10:30:00",3599,970,4569
"2019-06-17 10:10:06","2019-06-18 11:00:00","2019-06-18 11:30:00",3605,966,4571
"2019-06-17 10:10:06","2019-06-18 12:00:00","2019-06-18 12:30:00",3588,971,4559
"2019-06-17 10:10:06","2019-06-18 13:00:00","2019-06-18 13:30:00",3668,969,4637
"2019-06-17 10:10:06","2019-06-18 14:00:00","2019-06-18 14:30:00",3588,940,4528
"2019-06-17 10:10:06","2019-06-18 15:00:00","2019-06-18 15:30:00",3610,923,4533
"2019-06-17 10:10:06","2019-06-18 16:00:00","2019-06-18 16:30:00",3669,956,4625
"2019-06-17 10:10:06","2019-06-18 17:00:00","2019-06-18 17:30:00",3759,1052,4811
"2019-06-17 10:10:06","2019-06-18 18:00:00","2019-06-18 18:30:00",3781,1021,4802
"2019-06-17 10:10:06","2019-06-18 19:00:00","2019-06-18 19:30:00",3603,967,4570
"2019-06-17 10:10:06","2019-06-18 20:00:00","2019-06-18 20:30:00",3460,946,4406
"2019-06-17 10:10:06","2019-06-18 21:00:00","2019-06-18 21:30:00",3321,935,4256
"2019-06-17 10:10:06","2019-06-18 22:00:00","2019-06-18 22:30:00",3188,859,4047
"2019-06-18 10:10:25","2019-06-18 23:00:00","2019-06-18 23:30:00",3028,854,3882
"2019-06-18 10:10:25","2019-06-19 00:00:00","2019-06-19 00:30:00",2566,653,3219
"2019-06-18 10:10:25","2019-06-19 01:00:00","2019-06-19 01:30:00",2434,594,3028
"2019-06-18 10:10:25","2019-06-19 02:00:00","2019-06-19 02:30:00",2292,570,2862
"2019-06-18 10:10:25","2019-06-19 03:00:00","2019-06-19 03:30:00",2204,560,2764
"2019-06-18 10:10:25","2019-06-19 04:00:00","2019-06-19 04:30:00",2212,556,2768
"2019-06-18 10:10:25","2019-06-19 05:00:00","2019-06-19 05:30:00",2244,540,2784
"2019-06-18 10:10:25","2019-06-19 06:00:00","2019-06-19 06:30:00",2361,585,2946
"2019-06-18 10:10:25","2019-06-19 07:00:00","2019-06-19 07:30:00",2835,769,3604
"2019-06-18 10:10:25","2019-06-19 08:00:00","2019-06-19 08:30:00",3367,980,4347
"2019-06-18 10:10:25","2019-06-19 09:00:00","2019-06-19 09:30:00",3589,1052,4641
"2019-06-18 10:10:25","2019-06-19 10:00:00","2019-06-19 10:30:00",3621,1056,4677
"2019-06-18 10:10:25","2019-06-19 11:00:00","2019-06-19 11:30:00",3680,1039,4719
"2019-06-18 10:10:25","2019-06-19 12:00:00","2019-06-19 12:30:00",3694,1050,4744
"2019-06-18 10:10:25","2019-06-19 13:00:00","2019-06-19 13:30:00",3682,1038,4720
"2019-06-18 10:10:25","2019-06-19 14:00:00","2019-06-19 14:30:00",3584,1002,4586
"2019-06-18 10:10:25","2019-06-19 15:00:00","2019-06-19 15:30:00",3617,996,4613
"2019-06-18 10:10:25","2019-06-19 16:00:00","2019-06-19 16:30:00",3657,1053,4710
"2019-06-18 10:10:25","2019-06-19 17:00:00","2019-06-19 17:30:00",3719,1130,4849
"2019-06-18 10:10:25","2019-06-19 18:00:00","2019-06-19 18:30:00",3763,1114,4877
"2019-06-18 10:10:25","2019-06-19 19:00:00","2019-06-19 19:30:00",3605,1044,4649
"2019-06-18 10:10:25","2019-06-19 20:00:00","2019-06-19 20:30:00",3468,1008,4476
"2019-06-18 10:10:25","2019-06-19 21:00:00","2019-06-19 21:30:00",3372,994,4366
"2019-06-18 10:10:25","2019-06-19 22:00:00","2019-06-19 22:30:00",3210,926,4136
"2019-06-19 10:10:11","2019-06-19 23:00:00","2019-06-19 23:30:00",3055,854,3909
"2019-06-19 10:10:11","2019-06-20 00:00:00","2019-06-20 00:30:00",2665,653,3318
"2019-06-19 10:10:11","2019-06-20 01:00:00","2019-06-20 01:30:00",2525,594,3119
"2019-06-19 10:10:11","2019-06-20 02:00:00","2019-06-20 02:30:00",2421,570,2991
"2019-06-19 10:10:11","2019-06-20 03:00:00","2019-06-20 03:30:00",2350,560,2910
"2019-06-19 10:10:11","2019-06-20 04:00:00","2019-06-20 04:30:00",2325,556,2881
"2019-06-19 10:10:11","2019-06-20 05:00:00","2019-06-20 05:30:00",2300,540,2840
"2019-06-19 10:10:11","2019-06-20 06:00:00","2019-06-20 06:30:00",2437,585,3022
"2019-06-19 10:10:11","2019-06-20 07:00:00","2019-06-20 07:30:00",2878,769,3647
"2019-06-19 10:10:11","2019-06-20 08:00:00","2019-06-20 08:30:00",3426,980,4406
"2019-06-19 10:10:11","2019-06-20 09:00:00","2019-06-20 09:30:00",3621,1052,4673
"2019-06-19 10:10:11","2019-06-20 10:00:00","2019-06-20 10:30:00",3624,1056,4680
"2019-06-19 10:10:11","2019-06-20 11:00:00","2019-06-20 11:30:00",3638,1039,4677
"2019-06-19 10:10:11","2019-06-20 12:00:00","2019-06-20 12:30:00",3681,1050,4731
"2019-06-19 10:10:11","2019-06-20 13:00:00","2019-06-20 13:30:00",3670,1038,4708
"2019-06-19 10:10:11","2019-06-20 14:00:00","2019-06-20 14:30:00",3608,1002,4610
"2019-06-19 10:10:11","2019-06-20 15:00:00","2019-06-20 15:30:00",3613,996,4609
"2019-06-19 10:10:11","2019-06-20 16:00:00","2019-06-20 16:30:00",3649,1053,4702
"2019-06-19 10:10:11","2019-06-20 17:00:00","2019-06-20 17:30:00",3742,1130,4872
"2019-06-19 10:10:11","2019-06-20 18:00:00","2019-06-20 18:30:00",3778,1114,4892
"2019-06-19 10:10:11","2019-06-20 19:00:00","2019-06-20 19:30:00",3625,1044,4669
"2019-06-19 10:10:11","2019-06-20 20:00:00","2019-06-20 20:30:00",3455,1008,4463
"2019-06-19 10:10:11","2019-06-20 21:00:00","2019-06-20 21:30:00",3363,994,4357
"2019-06-19 10:10:11","2019-06-20 22:00:00","2019-06-20 22:30:00",3188,926,4114
"2019-06-20 10:10:30","2019-06-20 23:00:00","2019-06-20 23:30:00",3055,854,3909
"2019-06-20 10:10:30","2019-06-21 00:00:00","2019-06-21 00:30:00",2757,706,3463
"2019-06-20 10:10:30","2019-06-21 01:00:00","2019-06-21 01:30:00",2539,629,3168
"2019-06-20 10:10:30","2019-06-21 02:00:00","2019-06-21 02:30:00",2412,612,3024
"2019-06-20 10:10:30","2019-06-21 03:00:00","2019-06-21 03:30:00",2348,607,2955
"2019-06-20 10:10:30","2019-06-21 04:00:00","2019-06-21 04:30:00",2315,588,2903
"2019-06-20 10:10:30","2019-06-21 05:00:00","2019-06-21 05:30:00",2300,569,2869
"2019-06-20 10:10:30","2019-06-21 06:00:00","2019-06-21 06:30:00",2408,630,3038
"2019-06-20 10:10:30","2019-06-21 07:00:00","2019-06-21 07:30:00",2877,777,3654
"2019-06-20 10:10:30","2019-06-21 08:00:00","2019-06-21 08:30:00",3432,972,4404
"2019-06-20 10:10:30","2019-06-21 09:00:00","2019-06-21 09:30:00",3621,1003,4624
"2019-06-20 10:10:30","2019-06-21 10:00:00","2019-06-21 10:30:00",3659,1016,4675
"2019-06-20 10:10:30","2019-06-21 11:00:00","2019-06-21 11:30:00",3639,1033,4672
"2019-06-20 10:10:30","2019-06-21 12:00:00","2019-06-21 12:30:00",3658,1043,4701
"2019-06-20 10:10:30","2019-06-21 13:00:00","2019-06-21 13:30:00",3661,1019,4680
"2019-06-20 10:10:30","2019-06-21 14:00:00","2019-06-21 14:30:00",3581,958,4539
"2019-06-20 10:10:30","2019-06-21 15:00:00","2019-06-21 15:30:00",3579,982,4561
"2019-06-20 10:10:30","2019-06-21 16:00:00","2019-06-21 16:30:00",3564,1006,4570
"2019-06-20 10:10:30","2019-06-21 17:00:00","2019-06-21 17:30:00",3622,1042,4664
"2019-06-20 10:10:30","2019-06-21 18:00:00","2019-06-21 18:30:00",3648,1052,4700
"2019-06-20 10:10:30","2019-06-21 19:00:00","2019-06-21 19:30:00",3501,1004,4505
"2019-06-20 10:10:30","2019-06-21 20:00:00","2019-06-21 20:30:00",3336,967,4303
"2019-06-20 10:10:30","2019-06-21 21:00:00","2019-06-21 21:30:00",3220,903,4123
"2019-06-20 10:10:30","2019-06-21 22:00:00","2019-06-21 22:30:00",3118,878,3996
"2019-06-21 10:10:21","2019-06-21 23:00:00","2019-06-21 23:30:00",2945,824,3769
"2019-06-21 10:10:21","2019-06-22 00:00:00","2019-06-22 00:30:00",2778,719,3497
"2019-06-21 10:10:21","2019-06-22 01:00:00","2019-06-22 01:30:00",2581,638,3219
"2019-06-21 10:10:21","2019-06-22 02:00:00","2019-06-22 02:30:00",2414,598,3012
"2019-06-21 10:10:21","2019-06-22 03:00:00","2019-06-22 03:30:00",2320,579,2899
"2019-06-21 10:10:21","2019-06-22 04:00:00","2019-06-22 04:30:00",2280,567,2847
"2019-06-21 10:10:21","2019-06-22 05:00:00","2019-06-22 05:30:00",2251,540,2791
"2019-06-21 10:10:21","2019-06-22 06:00:00","2019-06-22 06:30:00",2267,558,2825
"2019-06-21 10:10:21","2019-06-22 07:00:00","2019-06-22 07:30:00",2471,627,3098
"2019-06-21 10:10:21","2019-06-22 08:00:00","2019-06-22 08:30:00",2826,742,3568
"2019-06-21 10:10:21","2019-06-22 09:00:00","2019-06-22 09:30:00",3161,849,4010
"2019-06-21 10:10:21","2019-06-22 10:00:00","2019-06-22 10:30:00",3333,890,4223
"2019-06-21 10:10:21","2019-06-22 11:00:00","2019-06-22 11:30:00",3370,906,4276
"2019-06-21 10:10:21","2019-06-22 12:00:00","2019-06-22 12:30:00",3361,893,4254
"2019-06-21 10:10:21","2019-06-22 13:00:00","2019-06-22 13:30:00",3313,882,4195
"2019-06-21 10:10:21","2019-06-22 14:00:00","2019-06-22 14:30:00",3192,837,4029
"2019-06-21 10:10:21","2019-06-22 15:00:00","2019-06-22 15:30:00",3125,797,3922
"2019-06-21 10:10:21","2019-06-22 16:00:00","2019-06-22 16:30:00",3081,790,3871
"2019-06-21 10:10:21","2019-06-22 17:00:00","2019-06-22 17:30:00",3221,840,4061
"2019-06-21 10:10:21","2019-06-22 18:00:00","2019-06-22 18:30:00",3319,888,4207
"2019-06-21 10:10:21","2019-06-22 19:00:00","2019-06-22 19:30:00",3236,848,4084
"2019-06-21 10:10:21","2019-06-22 20:00:00","2019-06-22 20:30:00",3084,831,3915
"2019-06-21 10:10:21","2019-06-22 21:00:00","2019-06-22 21:30:00",2982,802,3784
"2019-06-21 10:10:21","2019-06-22 22:00:00","2019-06-22 22:30:00",2877,774,3651
"2019-06-22 10:10:36","2019-06-22 23:00:00","2019-06-22 23:30:00",2802,756,3558
"2019-06-22 10:10:36","2019-06-23 00:00:00","2019-06-23 00:30:00",2618,662,3280
"2019-06-22 10:10:36","2019-06-23 01:00:00","2019-06-23 01:30:00",2496,596,3092
"2019-06-22 10:10:36","2019-06-23 02:00:00","2019-06-23 02:30:00",2356,558,2914
"2019-06-22 10:10:36","2019-06-23 03:00:00","2019-06-23 03:30:00",2250,529,2779
"2019-06-22 10:10:36","2019-06-23 04:00:00","2019-06-23 04:30:00",2194,528,2722
"2019-06-22 10:10:36","2019-06-23 05:00:00","2019-06-23 05:30:00",2138,482,2620
"2019-06-22 10:10:36","2019-06-23 06:00:00","2019-06-23 06:30:00",2136,495,2631
"2019-06-22 10:10:36","2019-06-23 07:00:00","2019-06-23 07:30:00",2258,533,2791
"2019-06-22 10:10:36","2019-06-23 08:00:00","2019-06-23 08:30:00",2488,607,3095
"2019-06-22 10:10:36","2019-06-23 09:00:00","2019-06-23 09:30:00",2770,705,3475
"2019-06-22 10:10:36","2019-06-23 10:00:00","2019-06-23 10:30:00",2989,777,3766
"2019-06-22 10:10:36","2019-06-23 11:00:00","2019-06-23 11:30:00",3116,818,3934
"2019-06-22 10:10:36","2019-06-23 12:00:00","2019-06-23 12:30:00",3196,867,4063
"2019-06-22 10:10:36","2019-06-23 13:00:00","2019-06-23 13:30:00",3212,876,4088
"2019-06-22 10:10:36","2019-06-23 14:00:00","2019-06-23 14:30:00",3145,818,3963
"2019-06-22 10:10:36","2019-06-23 15:00:00","2019-06-23 15:30:00",3116,797,3913
"2019-06-22 10:10:36","2019-06-23 16:00:00","2019-06-23 16:30:00",3122,815,3937
"2019-06-22 10:10:36","2019-06-23 17:00:00","2019-06-23 17:30:00",3193,870,4063
"2019-06-22 10:10:36","2019-06-23 18:00:00","2019-06-23 18:30:00",3203,898,4101
"2019-06-22 10:10:36","2019-06-23 19:00:00","2019-06-23 19:30:00",3145,856,4001
"2019-06-22 10:10:36","2019-06-23 20:00:00","2019-06-23 20:30:00",3045,849,3894
"2019-06-22 10:10:36","2019-06-23 21:00:00","2019-06-23 21:30:00",2955,816,3771
"2019-06-22 10:10:36","2019-06-23 22:00:00","2019-06-23 22:30:00",2826,761,3587
"2019-06-23 10:10:20","2019-06-23 23:00:00","2019-06-23 23:30:00",2747,763,3510
"2019-06-23 10:10:20","2019-06-24 00:00:00","2019-06-24 00:30:00",2549,618,3167
"2019-06-23 10:10:20","2019-06-24 01:00:00","2019-06-24 01:30:00",2357,565,2922
"2019-06-23 10:10:20","2019-06-24 02:00:00","2019-06-24 02:30:00",2244,548,2792
"2019-06-23 10:10:20","2019-06-24 03:00:00","2019-06-24 03:30:00",2197,549,2746
"2019-06-23 10:10:20","2019-06-24 04:00:00","2019-06-24 04:30:00",2185,521,2706
"2019-06-23 10:10:20","2019-06-24 05:00:00","2019-06-24 05:30:00",2138,498,2636
"2019-06-23 10:10:20","2019-06-24 06:00:00","2019-06-24 06:30:00",2288,557,2845
"2019-06-23 10:10:20","2019-06-24 07:00:00","2019-06-24 07:30:00",2727,750,3477
"2019-06-23 10:10:20","2019-06-24 08:00:00","2019-06-24 08:30:00",3252,930,4182
"2019-06-23 10:10:20","2019-06-24 09:00:00","2019-06-24 09:30:00",3514,990,4504
"2019-06-23 10:10:20","2019-06-24 10:00:00","2019-06-24 10:30:00",3618,990,4608
"2019-06-23 10:10:20","2019-06-24 11:00:00","2019-06-24 11:30:00",3646,970,4616
"2019-06-23 10:10:20","2019-06-24 12:00:00","2019-06-24 12:30:00",3666,970,4636
"2019-06-23 10:10:20","2019-06-24 13:00:00","2019-06-24 13:30:00",3712,953,4665
"2019-06-23 10:10:20","2019-06-24 14:00:00","2019-06-24 14:30:00",3628,932,4560
"2019-06-23 10:10:20","2019-06-24 15:00:00","2019-06-24 15:30:00",3646,952,4598
"2019-06-23 10:10:20","2019-06-24 16:00:00","2019-06-24 16:30:00",3686,1016,4702
"2019-06-23 10:10:20","2019-06-24 17:00:00","2019-06-24 17:30:00",3737,1081,4818
"2019-06-23 10:10:20","2019-06-24 18:00:00","2019-06-24 18:30:00",3762,1075,4837
"2019-06-23 10:10:20","2019-06-24 19:00:00","2019-06-24 19:30:00",3591,1005,4596
"2019-06-23 10:10:20","2019-06-24 20:00:00","2019-06-24 20:30:00",3433,956,4389
"2019-06-23 10:10:20","2019-06-24 21:00:00","2019-06-24 21:30:00",3289,930,4219
"2019-06-23 10:10:20","2019-06-24 22:00:00","2019-06-24 22:30:00",3162,847,4009
"2019-06-24 10:10:35","2019-06-24 23:00:00","2019-06-24 23:30:00",3067,804,3871
"2019-06-24 10:10:35","2019-06-25 00:00:00","2019-06-25 00:30:00",2665,656,3321
"2019-06-24 10:10:35","2019-06-25 01:00:00","2019-06-25 01:30:00",2525,590,3115
"2019-06-24 10:10:35","2019-06-25 02:00:00","2019-06-25 02:30:00",2421,569,2990
"2019-06-24 10:10:35","2019-06-25 03:00:00","2019-06-25 03:30:00",2350,560,2910
"2019-06-24 10:10:35","2019-06-25 04:00:00","2019-06-25 04:30:00",2325,547,2872
"2019-06-24 10:10:35","2019-06-25 05:00:00","2019-06-25 05:30:00",2300,538,2838
"2019-06-24 10:10:35","2019-06-25 06:00:00","2019-06-25 06:30:00",2437,640,3077
"2019-06-24 10:10:35","2019-06-25 07:00:00","2019-06-25 07:30:00",2878,830,3708
"2019-06-24 10:10:35","2019-06-25 08:00:00","2019-06-25 08:30:00",3426,980,4406
"2019-06-24 10:10:35","2019-06-25 09:00:00","2019-06-25 09:30:00",3621,1024,4645
"2019-06-24 10:10:35","2019-06-25 10:00:00","2019-06-25 10:30:00",3624,1020,4644
"2019-06-24 10:10:35","2019-06-25 11:00:00","2019-06-25 11:30:00",3638,1000,4638
"2019-06-24 10:10:35","2019-06-25 12:00:00","2019-06-25 12:30:00",3681,1010,4691
"2019-06-24 10:10:35","2019-06-25 13:00:00","2019-06-25 13:30:00",3670,960,4630
"2019-06-24 10:10:35","2019-06-25 14:00:00","2019-06-25 14:30:00",3608,936,4544
"2019-06-24 10:10:35","2019-06-25 15:00:00","2019-06-25 15:30:00",3613,955,4568
"2019-06-24 10:10:35","2019-06-25 16:00:00","2019-06-25 16:30:00",3649,1015,4664
"2019-06-24 10:10:35","2019-06-25 17:00:00","2019-06-25 17:30:00",3742,1080,4822
"2019-06-24 10:10:35","2019-06-25 18:00:00","2019-06-25 18:30:00",3778,1070,4848
"2019-06-24 10:10:35","2019-06-25 19:00:00","2019-06-25 19:30:00",3625,1000,4625
"2019-06-24 10:10:35","2019-06-25 20:00:00","2019-06-25 20:30:00",3455,950,4405
"2019-06-24 10:10:35","2019-06-25 21:00:00","2019-06-25 21:30:00",3363,910,4273
"2019-06-24 10:10:35","2019-06-25 22:00:00","2019-06-25 22:30:00",3188,844,4032
"2019-06-25 10:10:26","2019-06-25 23:00:00","2019-06-25 23:30:00",3119,845,3964
"2019-06-25 10:10:26","2019-06-26 00:00:00","2019-06-26 00:30:00",2773,671,3444
"2019-06-25 10:10:26","2019-06-26 01:00:00","2019-06-26 01:30:00",2581,602,3183
"2019-06-25 10:10:26","2019-06-26 02:00:00","2019-06-26 02:30:00",2446,590,3036
"2019-06-25 10:10:26","2019-06-26 03:00:00","2019-06-26 03:30:00",2371,577,2948
"2019-06-25 10:10:26","2019-06-26 04:00:00","2019-06-26 04:30:00",2363,595,2958
"2019-06-25 10:10:26","2019-06-26 05:00:00","2019-06-26 05:30:00",2336,585,2921
"2019-06-25 10:10:26","2019-06-26 06:00:00","2019-06-26 06:30:00",2463,644,3107
"2019-06-25 10:10:26","2019-06-26 07:00:00","2019-06-26 07:30:00",2908,803,3711
"2019-06-25 10:10:26","2019-06-26 08:00:00","2019-06-26 08:30:00",3402,1003,4405
"2019-06-25 10:10:26","2019-06-26 09:00:00","2019-06-26 09:30:00",3650,1060,4710
"2019-06-25 10:10:26","2019-06-26 10:00:00","2019-06-26 10:30:00",3737,1072,4809
"2019-06-25 10:10:26","2019-06-26 11:00:00","2019-06-26 11:30:00",3744,1065,4809
"2019-06-25 10:10:26","2019-06-26 12:00:00","2019-06-26 12:30:00",3742,1064,4806
"2019-06-25 10:10:26","2019-06-26 13:00:00","2019-06-26 13:30:00",3742,1068,4810
"2019-06-25 10:10:26","2019-06-26 14:00:00","2019-06-26 14:30:00",3667,1030,4697
"2019-06-25 10:10:26","2019-06-26 15:00:00","2019-06-26 15:30:00",3690,1024,4714
"2019-06-25 10:10:26","2019-06-26 16:00:00","2019-06-26 16:30:00",3696,1050,4746
"2019-06-25 10:10:26","2019-06-26 17:00:00","2019-06-26 17:30:00",3697,1145,4842
"2019-06-25 10:10:26","2019-06-26 18:00:00","2019-06-26 18:30:00",3699,1130,4829
"2019-06-25 10:10:26","2019-06-26 19:00:00","2019-06-26 19:30:00",3551,1020,4571
"2019-06-25 10:10:26","2019-06-26 20:00:00","2019-06-26 20:30:00",3423,938,4361
"2019-06-25 10:10:26","2019-06-26 21:00:00","2019-06-26 21:30:00",3311,941,4252
"2019-06-25 10:10:26","2019-06-26 22:00:00","2019-06-26 22:30:00",3167,880,4047
"2019-06-26 10:10:11","2019-06-26 23:00:00","2019-06-26 23:30:00",3119,822,3941
"2019-06-26 10:10:11","2019-06-27 00:00:00","2019-06-27 00:30:00",2814,736,3550
"2019-06-26 10:10:11","2019-06-27 01:00:00","2019-06-27 01:30:00",2586,662,3248
"2019-06-26 10:10:11","2019-06-27 02:00:00","2019-06-27 02:30:00",2449,626,3075
"2019-06-26 10:10:11","2019-06-27 03:00:00","2019-06-27 03:30:00",2389,606,2995
"2019-06-26 10:10:11","2019-06-27 04:00:00","2019-06-27 04:30:00",2371,596,2967
"2019-06-26 10:10:11","2019-06-27 05:00:00","2019-06-27 05:30:00",2335,583,2918
"2019-06-26 10:10:11","2019-06-27 06:00:00","2019-06-27 06:30:00",2465,628,3093
"2019-06-26 10:10:11","2019-06-27 07:00:00","2019-06-27 07:30:00",2899,789,3688
"2019-06-26 10:10:11","2019-06-27 08:00:00","2019-06-27 08:30:00",3383,982,4365
"2019-06-26 10:10:11","2019-06-27 09:00:00","2019-06-27 09:30:00",3650,1041,4691
"2019-06-26 10:10:11","2019-06-27 10:00:00","2019-06-27 10:30:00",3740,1075,4815
"2019-06-26 10:10:11","2019-06-27 11:00:00","2019-06-27 11:30:00",3751,1073,4824
"2019-06-26 10:10:11","2019-06-27 12:00:00","2019-06-27 12:30:00",3778,1070,4848
"2019-06-26 10:10:11","2019-06-27 13:00:00","2019-06-27 13:30:00",3772,1053,4825
"2019-06-26 10:10:11","2019-06-27 14:00:00","2019-06-27 14:30:00",3699,992,4691
"2019-06-26 10:10:11","2019-06-27 15:00:00","2019-06-27 15:30:00",3693,990,4683
"2019-06-26 10:10:11","2019-06-27 16:00:00","2019-06-27 16:30:00",3697,1013,4710
"2019-06-26 10:10:11","2019-06-27 17:00:00","2019-06-27 17:30:00",3742,1089,4831
"2019-06-26 10:10:11","2019-06-27 18:00:00","2019-06-27 18:30:00",3730,1093,4823
"2019-06-26 10:10:11","2019-06-27 19:00:00","2019-06-27 19:30:00",3599,1023,4622
"2019-06-26 10:10:11","2019-06-27 20:00:00","2019-06-27 20:30:00",3482,956,4438
"2019-06-26 10:10:11","2019-06-27 21:00:00","2019-06-27 21:30:00",3355,926,4281
"2019-06-26 10:10:11","2019-06-27 22:00:00","2019-06-27 22:30:00",3171,878,4049
"2019-06-27 10:10:25","2019-06-27 23:00:00","2019-06-27 23:30:00",3063,826,3889
"2019-06-27 10:10:25","2019-06-28 00:00:00","2019-06-28 00:30:00",2779,706,3485
"2019-06-27 10:10:25","2019-06-28 01:00:00","2019-06-28 01:30:00",2577,639,3216
"2019-06-27 10:10:25","2019-06-28 02:00:00","2019-06-28 02:30:00",2430,602,3032
"2019-06-27 10:10:25","2019-06-28 03:00:00","2019-06-28 03:30:00",2353,592,2945
"2019-06-27 10:10:25","2019-06-28 04:00:00","2019-06-28 04:30:00",2340,579,2919
"2019-06-27 10:10:25","2019-06-28 05:00:00","2019-06-28 05:30:00",2320,560,2880
"2019-06-27 10:10:25","2019-06-28 06:00:00","2019-06-28 06:30:00",2506,618,3124
"2019-06-27 10:10:25","2019-06-28 07:00:00","2019-06-28 07:30:00",2950,788,3738
"2019-06-27 10:10:25","2019-06-28 08:00:00","2019-06-28 08:30:00",3472,962,4434
"2019-06-27 10:10:25","2019-06-28 09:00:00","2019-06-28 09:30:00",3684,1012,4696
"2019-06-27 10:10:25","2019-06-28 10:00:00","2019-06-28 10:30:00",3731,1010,4741
"2019-06-27 10:10:25","2019-06-28 11:00:00","2019-06-28 11:30:00",3710,1020,4730
"2019-06-27 10:10:25","2019-06-28 12:00:00","2019-06-28 12:30:00",3688,1011,4699
"2019-06-27 10:10:25","2019-06-28 13:00:00","2019-06-28 13:30:00",3701,993,4694
"2019-06-27 10:10:25","2019-06-28 14:00:00","2019-06-28 14:30:00",3603,943,4546
"2019-06-27 10:10:25","2019-06-28 15:00:00","2019-06-28 15:30:00",3567,929,4496
"2019-06-27 10:10:25","2019-06-28 16:00:00","2019-06-28 16:30:00",3574,944,4518
"2019-06-27 10:10:25","2019-06-28 17:00:00","2019-06-28 17:30:00",3639,994,4633
"2019-06-27 10:10:25","2019-06-28 18:00:00","2019-06-28 18:30:00",3703,998,4701
"2019-06-27 10:10:25","2019-06-28 19:00:00","2019-06-28 19:30:00",3573,939,4512
"2019-06-27 10:10:25","2019-06-28 20:00:00","2019-06-28 20:30:00",3402,898,4300
"2019-06-27 10:10:25","2019-06-28 21:00:00","2019-06-28 21:30:00",3275,865,4140
"2019-06-27 10:10:25","2019-06-28 22:00:00","2019-06-28 22:30:00",3110,799,3909
"2019-06-28 10:10:21","2019-06-28 23:00:00","2019-06-28 23:30:00",2968,786,3754
"2019-06-28 10:10:21","2019-06-29 00:00:00","2019-06-29 00:30:00",2715,682,3397
"2019-06-28 10:10:21","2019-06-29 01:00:00","2019-06-29 01:30:00",2527,609,3136
"2019-06-28 10:10:21","2019-06-29 02:00:00","2019-06-29 02:30:00",2390,575,2965
"2019-06-28 10:10:21","2019-06-29 03:00:00","2019-06-29 03:30:00",2304,557,2861
"2019-06-28 10:10:21","2019-06-29 04:00:00","2019-06-29 04:30:00",2265,543,2808
"2019-06-28 10:10:21","2019-06-29 05:00:00","2019-06-29 05:30:00",2239,519,2758
"2019-06-28 10:10:21","2019-06-29 06:00:00","2019-06-29 06:30:00",2270,552,2822
"2019-06-28 10:10:21","2019-06-29 07:00:00","2019-06-29 07:30:00",2468,617,3085
"2019-06-28 10:10:21","2019-06-29 08:00:00","2019-06-29 08:30:00",2813,736,3549
"2019-06-28 10:10:21","2019-06-29 09:00:00","2019-06-29 09:30:00",3130,843,3973
"2019-06-28 10:10:21","2019-06-29 10:00:00","2019-06-29 10:30:00",3267,878,4145
"2019-06-28 10:10:21","2019-06-29 11:00:00","2019-06-29 11:30:00",3338,870,4208
"2019-06-28 10:10:21","2019-06-29 12:00:00","2019-06-29 12:30:00",3339,853,4192
"2019-06-28 10:10:21","2019-06-29 13:00:00","2019-06-29 13:30:00",3311,828,4139
"2019-06-28 10:10:21","2019-06-29 14:00:00","2019-06-29 14:30:00",3172,784,3956
"2019-06-28 10:10:21","2019-06-29 15:00:00","2019-06-29 15:30:00",3098,750,3848
"2019-06-28 10:10:21","2019-06-29 16:00:00","2019-06-29 16:30:00",3090,741,3831
"2019-06-28 10:10:21","2019-06-29 17:00:00","2019-06-29 17:30:00",3194,805,3999
"2019-06-28 10:10:21","2019-06-29 18:00:00","2019-06-29 18:30:00",3308,833,4141
"2019-06-28 10:10:21","2019-06-29 19:00:00","2019-06-29 19:30:00",3193,814,4007
"2019-06-28 10:10:21","2019-06-29 20:00:00","2019-06-29 20:30:00",3047,781,3828
"2019-06-28 10:10:21","2019-06-29 21:00:00","2019-06-29 21:30:00",2962,752,3714
"2019-06-28 10:10:21","2019-06-29 22:00:00","2019-06-29 22:30:00",2911,742,3653
"2019-06-29 10:10:30","2019-06-29 23:00:00","2019-06-29 23:30:00",2813,734,3547
"2019-06-29 10:10:30","2019-06-30 00:00:00","2019-06-30 00:30:00",2604,648,3252
"2019-06-29 10:10:30","2019-06-30 01:00:00","2019-06-30 01:30:00",2452,588,3040
"2019-06-29 10:10:30","2019-06-30 02:00:00","2019-06-30 02:30:00",2317,564,2881
"2019-06-29 10:10:30","2019-06-30 03:00:00","2019-06-30 03:30:00",2237,535,2772
"2019-06-29 10:10:30","2019-06-30 04:00:00","2019-06-30 04:30:00",2200,523,2723
"2019-06-29 10:10:30","2019-06-30 05:00:00","2019-06-30 05:30:00",2136,505,2641
"2019-06-29 10:10:30","2019-06-30 06:00:00","2019-06-30 06:30:00",2133,516,2649
"2019-06-29 10:10:30","2019-06-30 07:00:00","2019-06-30 07:30:00",2266,572,2838
"2019-06-29 10:10:30","2019-06-30 08:00:00","2019-06-30 08:30:00",2518,647,3165
"2019-06-29 10:10:30","2019-06-30 09:00:00","2019-06-30 09:30:00",2819,753,3572
"2019-06-29 10:10:30","2019-06-30 10:00:00","2019-06-30 10:30:00",3037,837,3874
"2019-06-29 10:10:30","2019-06-30 11:00:00","2019-06-30 11:30:00",3133,902,4035
"2019-06-29 10:10:30","2019-06-30 12:00:00","2019-06-30 12:30:00",3159,921,4080
"2019-06-29 10:10:30","2019-06-30 13:00:00","2019-06-30 13:30:00",3166,935,4101
"2019-06-29 10:10:30","2019-06-30 14:00:00","2019-06-30 14:30:00",3069,879,3948
"2019-06-29 10:10:30","2019-06-30 15:00:00","2019-06-30 15:30:00",2982,832,3814
"2019-06-29 10:10:30","2019-06-30 16:00:00","2019-06-30 16:30:00",2969,858,3827
"2019-06-29 10:10:30","2019-06-30 17:00:00","2019-06-30 17:30:00",3048,923,3971
"2019-06-29 10:10:30","2019-06-30 18:00:00","2019-06-30 18:30:00",3142,948,4090
"2019-06-29 10:10:30","2019-06-30 19:00:00","2019-06-30 19:30:00",3117,912,4029
"2019-06-29 10:10:30","2019-06-30 20:00:00","2019-06-30 20:30:00",3068,892,3960
"2019-06-29 10:10:30","2019-06-30 21:00:00","2019-06-30 21:30:00",2975,861,3836
"2019-06-29 10:10:30","2019-06-30 22:00:00","2019-06-30 22:30:00",2857,818,3675
"2019-06-30 10:10:15","2019-06-30 23:00:00","2019-06-30 23:30:00",2810,773,3583
"2019-06-30 10:10:15","2019-07-01 00:00:00","2019-07-01 00:30:00",2554,640,3194
"2019-06-30 10:10:15","2019-07-01 01:00:00","2019-07-01 01:30:00",2360,591,2951
"2019-06-30 10:10:15","2019-07-01 02:00:00","2019-07-01 02:30:00",2225,574,2799
"2019-06-30 10:10:15","2019-07-01 03:00:00","2019-07-01 03:30:00",2174,565,2739
"2019-06-30 10:10:15","2019-07-01 04:00:00","2019-07-01 04:30:00",2188,553,2741
"2019-06-30 10:10:15","2019-07-01 05:00:00","2019-07-01 05:30:00",2173,548,2721
"2019-06-30 10:10:15","2019-07-01 06:00:00","2019-07-01 06:30:00",2286,605,2891
"2019-06-30 10:10:15","2019-07-01 07:00:00","2019-07-01 07:30:00",2694,776,3470
"2019-06-30 10:10:15","2019-07-01 08:00:00","2019-07-01 08:30:00",3163,970,4133
"2019-06-30 10:10:15","2019-07-01 09:00:00","2019-07-01 09:30:00",3478,1063,4541
"2019-06-30 10:10:15","2019-07-01 10:00:00","2019-07-01 10:30:00",3588,1091,4679
"2019-06-30 10:10:15","2019-07-01 11:00:00","2019-07-01 11:30:00",3623,1097,4720
"2019-06-30 10:10:15","2019-07-01 12:00:00","2019-07-01 12:30:00",3695,1093,4788
"2019-06-30 10:10:15","2019-07-01 13:00:00","2019-07-01 13:30:00",3712,1076,4788
"2019-06-30 10:10:15","2019-07-01 14:00:00","2019-07-01 14:30:00",3635,1020,4655
"2019-06-30 10:10:15","2019-07-01 15:00:00","2019-07-01 15:30:00",3658,1042,4700
"2019-06-30 10:10:15","2019-07-01 16:00:00","2019-07-01 16:30:00",3664,1045,4709
"2019-06-30 10:10:15","2019-07-01 17:00:00","2019-07-01 17:30:00",3725,1129,4854
"2019-06-30 10:10:15","2019-07-01 18:00:00","2019-07-01 18:30:00",3710,1104,4814
"2019-06-30 10:10:15","2019-07-01 19:00:00","2019-07-01 19:30:00",3530,1027,4557
"2019-06-30 10:10:15","2019-07-01 20:00:00","2019-07-01 20:30:00",3373,982,4355
"2019-06-30 10:10:15","2019-07-01 21:00:00","2019-07-01 21:30:00",3186,960,4146
"2019-06-30 10:10:15","2019-07-01 22:00:00","2019-07-01 22:30:00",3058,895,3953
"2019-07-01 10:10:31","2019-07-01 23:00:00","2019-07-01 23:30:00",3021,849,3870
"2019-07-01 10:10:31","2019-07-02 00:00:00","2019-07-02 00:30:00",2764,706,3470
"2019-07-01 10:10:31","2019-07-02 01:00:00","2019-07-02 01:30:00",2587,629,3216
"2019-07-01 10:10:31","2019-07-02 02:00:00","2019-07-02 02:30:00",2487,603,3090
"2019-07-01 10:10:31","2019-07-02 03:00:00","2019-07-02 03:30:00",2463,588,3051
"2019-07-01 10:10:31","2019-07-02 04:00:00","2019-07-02 04:30:00",2459,580,3039
"2019-07-01 10:10:31","2019-07-02 05:00:00","2019-07-02 05:30:00",2444,556,3000
"2019-07-01 10:10:31","2019-07-02 06:00:00","2019-07-02 06:30:00",2595,618,3213
"2019-07-01 10:10:31","2019-07-02 07:00:00","2019-07-02 07:30:00",3045,790,3835
"2019-07-01 10:10:31","2019-07-02 08:00:00","2019-07-02 08:30:00",3504,971,4475
"2019-07-01 10:10:31","2019-07-02 09:00:00","2019-07-02 09:30:00",3655,1040,4695
"2019-07-01 10:10:31","2019-07-02 10:00:00","2019-07-02 10:30:00",3651,1048,4699
"2019-07-01 10:10:31","2019-07-02 11:00:00","2019-07-02 11:30:00",3641,1052,4693
"2019-07-01 10:10:31","2019-07-02 12:00:00","2019-07-02 12:30:00",3653,1035,4688
"2019-07-01 10:10:31","2019-07-02 13:00:00","2019-07-02 13:30:00",3666,1021,4687
"2019-07-01 10:10:31","2019-07-02 14:00:00","2019-07-02 14:30:00",3586,969,4555
"2019-07-01 10:10:31","2019-07-02 15:00:00","2019-07-02 15:30:00",3576,967,4543
"2019-07-01 10:10:31","2019-07-02 16:00:00","2019-07-02 16:30:00",3607,978,4585
"2019-07-01 10:10:31","2019-07-02 17:00:00","2019-07-02 17:30:00",3648,1042,4690
"2019-07-01 10:10:31","2019-07-02 18:00:00","2019-07-02 18:30:00",3698,1041,4739
"2019-07-01 10:10:31","2019-07-02 19:00:00","2019-07-02 19:30:00",3586,1005,4591
"2019-07-01 10:10:31","2019-07-02 20:00:00","2019-07-02 20:30:00",3441,974,4415
"2019-07-01 10:10:31","2019-07-02 21:00:00","2019-07-02 21:30:00",3345,947,4292
"2019-07-01 10:10:31","2019-07-02 22:00:00","2019-07-02 22:30:00",3134,884,4018
"2019-07-02 10:10:16","2019-07-02 23:00:00","2019-07-02 23:30:00",3057,864,3921
"2019-07-02 10:10:16","2019-07-03 00:00:00","2019-07-03 00:30:00",2757,721,3478
"2019-07-02 10:10:16","2019-07-03 01:00:00","2019-07-03 01:30:00",2569,643,3212
"2019-07-02 10:10:16","2019-07-03 02:00:00","2019-07-03 02:30:00",2463,626,3089
"2019-07-02 10:10:16","2019-07-03 03:00:00","2019-07-03 03:30:00",2434,610,3044
"2019-07-02 10:10:16","2019-07-03 04:00:00","2019-07-03 04:30:00",2426,601,3027
"2019-07-02 10:10:16","2019-07-03 05:00:00","2019-07-03 05:30:00",2415,574,2989
"2019-07-02 10:10:16","2019-07-03 06:00:00","2019-07-03 06:30:00",2567,634,3201
"2019-07-02 10:10:16","2019-07-03 07:00:00","2019-07-03 07:30:00",3015,798,3813
"2019-07-02 10:10:16","2019-07-03 08:00:00","2019-07-03 08:30:00",3471,992,4463
"2019-07-02 10:10:16","2019-07-03 09:00:00","2019-07-03 09:30:00",3640,1051,4691
"2019-07-02 10:10:16","2019-07-03 10:00:00","2019-07-03 10:30:00",3638,1061,4699
"2019-07-02 10:10:16","2019-07-03 11:00:00","2019-07-03 11:30:00",3629,1063,4692
"2019-07-02 10:10:16","2019-07-03 12:00:00","2019-07-03 12:30:00",3644,1043,4687
"2019-07-02 10:10:16","2019-07-03 13:00:00","2019-07-03 13:30:00",3655,1038,4693
"2019-07-02 10:10:16","2019-07-03 14:00:00","2019-07-03 14:30:00",3581,975,4556
"2019-07-02 10:10:16","2019-07-03 15:00:00","2019-07-03 15:30:00",3568,982,4550
"2019-07-02 10:10:16","2019-07-03 16:00:00","2019-07-03 16:30:00",3600,993,4593
"2019-07-02 10:10:16","2019-07-03 17:00:00","2019-07-03 17:30:00",3638,1046,4684
"2019-07-02 10:10:16","2019-07-03 18:00:00","2019-07-03 18:30:00",3687,1041,4728
"2019-07-02 10:10:16","2019-07-03 19:00:00","2019-07-03 19:30:00",3577,991,4568
"2019-07-02 10:10:16","2019-07-03 20:00:00","2019-07-03 20:30:00",3435,950,4385
"2019-07-02 10:10:16","2019-07-03 21:00:00","2019-07-03 21:30:00",3344,936,4280
"2019-07-02 10:10:16","2019-07-03 22:00:00","2019-07-03 22:30:00",3134,867,4001
"2019-07-03 10:10:30","2019-07-03 23:00:00","2019-07-03 23:30:00",3066,819,3885
"2019-07-03 10:10:30","2019-07-04 00:00:00","2019-07-04 00:30:00",2726,713,3439
"2019-07-03 10:10:30","2019-07-04 01:00:00","2019-07-04 01:30:00",2544,628,3172
"2019-07-03 10:10:30","2019-07-04 02:00:00","2019-07-04 02:30:00",2434,603,3037
"2019-07-03 10:10:30","2019-07-04 03:00:00","2019-07-04 03:30:00",2401,598,2999
"2019-07-03 10:10:30","2019-07-04 04:00:00","2019-07-04 04:30:00",2381,580,2961
"2019-07-03 10:10:30","2019-07-04 05:00:00","2019-07-04 05:30:00",2371,560,2931
"2019-07-03 10:10:30","2019-07-04 06:00:00","2019-07-04 06:30:00",2469,610,3079
"2019-07-03 10:10:30","2019-07-04 07:00:00","2019-07-04 07:30:00",2865,748,3613
"2019-07-03 10:10:30","2019-07-04 08:00:00","2019-07-04 08:30:00",3325,927,4252
"2019-07-03 10:10:30","2019-07-04 09:00:00","2019-07-04 09:30:00",3574,992,4566
"2019-07-03 10:10:30","2019-07-04 10:00:00","2019-07-04 10:30:00",3603,1003,4606
"2019-07-03 10:10:30","2019-07-04 11:00:00","2019-07-04 11:30:00",3625,1010,4635
"2019-07-03 10:10:30","2019-07-04 12:00:00","2019-07-04 12:30:00",3625,999,4624
"2019-07-03 10:10:30","2019-07-04 13:00:00","2019-07-04 13:30:00",3628,989,4617
"2019-07-03 10:10:30","2019-07-04 14:00:00","2019-07-04 14:30:00",3546,950,4496
"2019-07-03 10:10:30","2019-07-04 15:00:00","2019-07-04 15:30:00",3537,942,4479
"2019-07-03 10:10:30","2019-07-04 16:00:00","2019-07-04 16:30:00",3563,970,4533
"2019-07-03 10:10:30","2019-07-04 17:00:00","2019-07-04 17:30:00",3633,1012,4645
"2019-07-03 10:10:30","2019-07-04 18:00:00","2019-07-04 18:30:00",3682,1020,4702
"2019-07-03 10:10:30","2019-07-04 19:00:00","2019-07-04 19:30:00",3539,944,4483
"2019-07-03 10:10:30","2019-07-04 20:00:00","2019-07-04 20:30:00",3393,920,4313
"2019-07-03 10:10:30","2019-07-04 21:00:00","2019-07-04 21:30:00",3284,886,4170
"2019-07-03 10:10:30","2019-07-04 22:00:00","2019-07-04 22:30:00",3104,822,3926
"2019-07-04 10:10:15","2019-07-04 23:00:00","2019-07-04 23:30:00",3058,819,3877
"2019-07-04 10:10:15","2019-07-05 00:00:00","2019-07-05 00:30:00",2779,748,3527
"2019-07-04 10:10:15","2019-07-05 01:00:00","2019-07-05 01:30:00",2551,648,3199
"2019-07-04 10:10:15","2019-07-05 02:00:00","2019-07-05 02:30:00",2483,615,3098
"2019-07-04 10:10:15","2019-07-05 03:00:00","2019-07-05 03:30:00",2422,586,3008
"2019-07-04 10:10:15","2019-07-05 04:00:00","2019-07-05 04:30:00",2405,568,2973
"2019-07-04 10:10:15","2019-07-05 05:00:00","2019-07-05 05:30:00",2380,550,2930
"2019-07-04 10:10:15","2019-07-05 06:00:00","2019-07-05 06:30:00",2507,613,3120
"2019-07-04 10:10:15","2019-07-05 07:00:00","2019-07-05 07:30:00",2866,747,3613
"2019-07-04 10:10:15","2019-07-05 08:00:00","2019-07-05 08:30:00",3318,923,4241
"2019-07-04 10:10:15","2019-07-05 09:00:00","2019-07-05 09:30:00",3541,982,4523
"2019-07-04 10:10:15","2019-07-05 10:00:00","2019-07-05 10:30:00",3610,989,4599
"2019-07-04 10:10:15","2019-07-05 11:00:00","2019-07-05 11:30:00",3608,969,4577
"2019-07-04 10:10:15","2019-07-05 12:00:00","2019-07-05 12:30:00",3626,950,4576
"2019-07-04 10:10:15","2019-07-05 13:00:00","2019-07-05 13:30:00",3644,946,4590
"2019-07-04 10:10:15","2019-07-05 14:00:00","2019-07-05 14:30:00",3593,905,4498
"2019-07-04 10:10:15","2019-07-05 15:00:00","2019-07-05 15:30:00",3504,906,4410
"2019-07-04 10:10:15","2019-07-05 16:00:00","2019-07-05 16:30:00",3505,919,4424
"2019-07-04 10:10:15","2019-07-05 17:00:00","2019-07-05 17:30:00",3570,969,4539
"2019-07-04 10:10:15","2019-07-05 18:00:00","2019-07-05 18:30:00",3642,992,4634
"2019-07-04 10:10:15","2019-07-05 19:00:00","2019-07-05 19:30:00",3516,945,4461
"2019-07-04 10:10:15","2019-07-05 20:00:00","2019-07-05 20:30:00",3355,900,4255
"2019-07-04 10:10:15","2019-07-05 21:00:00","2019-07-05 21:30:00",3251,878,4129
"2019-07-04 10:10:15","2019-07-05 22:00:00","2019-07-05 22:30:00",3063,831,3894
"2019-07-05 10:10:30","2019-07-05 23:00:00","2019-07-05 23:30:00",2966,817,3783
"2019-07-05 10:10:30","2019-07-06 00:00:00","2019-07-06 00:30:00",2706,707,3413
"2019-07-05 10:10:30","2019-07-06 01:00:00","2019-07-06 01:30:00",2531,633,3164
"2019-07-05 10:10:30","2019-07-06 02:00:00","2019-07-06 02:30:00",2422,603,3025
"2019-07-05 10:10:30","2019-07-06 03:00:00","2019-07-06 03:30:00",2340,577,2917
"2019-07-05 10:10:30","2019-07-06 04:00:00","2019-07-06 04:30:00",2305,572,2877
"2019-07-05 10:10:30","2019-07-06 05:00:00","2019-07-06 05:30:00",2272,549,2821
"2019-07-05 10:10:30","2019-07-06 06:00:00","2019-07-06 06:30:00",2276,572,2848
"2019-07-05 10:10:30","2019-07-06 07:00:00","2019-07-06 07:30:00",2445,654,3099
"2019-07-05 10:10:30","2019-07-06 08:00:00","2019-07-06 08:30:00",2744,728,3472
"2019-07-05 10:10:30","2019-07-06 09:00:00","2019-07-06 09:30:00",3079,836,3915
"2019-07-05 10:10:30","2019-07-06 10:00:00","2019-07-06 10:30:00",3259,891,4150
"2019-07-05 10:10:30","2019-07-06 11:00:00","2019-07-06 11:30:00",3325,864,4189
"2019-07-05 10:10:30","2019-07-06 12:00:00","2019-07-06 12:30:00",3323,869,4192
"2019-07-05 10:10:30","2019-07-06 13:00:00","2019-07-06 13:30:00",3318,854,4172
"2019-07-05 10:10:30","2019-07-06 14:00:00","2019-07-06 14:30:00",3203,810,4013
"2019-07-05 10:10:30","2019-07-06 15:00:00","2019-07-06 15:30:00",3121,785,3906
"2019-07-05 10:10:30","2019-07-06 16:00:00","2019-07-06 16:30:00",3119,799,3918
"2019-07-05 10:10:30","2019-07-06 17:00:00","2019-07-06 17:30:00",3195,850,4045
"2019-07-05 10:10:30","2019-07-06 18:00:00","2019-07-06 18:30:00",3270,884,4154
"2019-07-05 10:10:30","2019-07-06 19:00:00","2019-07-06 19:30:00",3167,852,4019
"2019-07-05 10:10:30","2019-07-06 20:00:00","2019-07-06 20:30:00",3036,811,3847
"2019-07-05 10:10:30","2019-07-06 21:00:00","2019-07-06 21:30:00",2944,780,3724
"2019-07-05 10:10:30","2019-07-06 22:00:00","2019-07-06 22:30:00",2828,759,3587
"2019-07-06 10:10:20","2019-07-06 23:00:00","2019-07-06 23:30:00",2825,771,3596
"2019-07-06 10:10:20","2019-07-07 00:00:00","2019-07-07 00:30:00",2630,674,3304
"2019-07-06 10:10:20","2019-07-07 01:00:00","2019-07-07 01:30:00",2423,606,3029
"2019-07-06 10:10:20","2019-07-07 02:00:00","2019-07-07 02:30:00",2300,560,2860
"2019-07-06 10:10:20","2019-07-07 03:00:00","2019-07-07 03:30:00",2267,532,2799
"2019-07-06 10:10:20","2019-07-07 04:00:00","2019-07-07 04:30:00",2242,516,2758
"2019-07-06 10:10:20","2019-07-07 05:00:00","2019-07-07 05:30:00",2206,478,2684
"2019-07-06 10:10:20","2019-07-07 06:00:00","2019-07-07 06:30:00",2166,480,2646
"2019-07-06 10:10:20","2019-07-07 07:00:00","2019-07-07 07:30:00",2280,530,2810
"2019-07-06 10:10:20","2019-07-07 08:00:00","2019-07-07 08:30:00",2543,595,3138
"2019-07-06 10:10:20","2019-07-07 09:00:00","2019-07-07 09:30:00",2781,719,3500
"2019-07-06 10:10:20","2019-07-07 10:00:00","2019-07-07 10:30:00",3015,758,3773
"2019-07-06 10:10:20","2019-07-07 11:00:00","2019-07-07 11:30:00",3115,790,3905
"2019-07-06 10:10:20","2019-07-07 12:00:00","2019-07-07 12:30:00",3189,814,4003
"2019-07-06 10:10:20","2019-07-07 13:00:00","2019-07-07 13:30:00",3195,833,4028
"2019-07-06 10:10:20","2019-07-07 14:00:00","2019-07-07 14:30:00",3105,790,3895
"2019-07-06 10:10:20","2019-07-07 15:00:00","2019-07-07 15:30:00",2972,738,3710
"2019-07-06 10:10:20","2019-07-07 16:00:00","2019-07-07 16:30:00",3003,763,3766
"2019-07-06 10:10:20","2019-07-07 17:00:00","2019-07-07 17:30:00",3114,819,3933
"2019-07-06 10:10:20","2019-07-07 18:00:00","2019-07-07 18:30:00",3165,825,3990
"2019-07-06 10:10:20","2019-07-07 19:00:00","2019-07-07 19:30:00",3103,817,3920
"2019-07-06 10:10:20","2019-07-07 20:00:00","2019-07-07 20:30:00",2978,808,3786
"2019-07-06 10:10:20","2019-07-07 21:00:00","2019-07-07 21:30:00",2914,788,3702
"2019-07-06 10:10:20","2019-07-07 22:00:00","2019-07-07 22:30:00",2799,762,3561
"2019-07-07 10:10:36","2019-07-07 23:00:00","2019-07-07 23:30:00",2748,734,3482
"2019-07-07 10:10:36","2019-07-08 00:00:00","2019-07-08 00:30:00",2489,648,3137
"2019-07-07 10:10:36","2019-07-08 01:00:00","2019-07-08 01:30:00",2338,566,2904
"2019-07-07 10:10:36","2019-07-08 02:00:00","2019-07-08 02:30:00",2207,532,2739
"2019-07-07 10:10:36","2019-07-08 03:00:00","2019-07-08 03:30:00",2163,531,2694
"2019-07-07 10:10:36","2019-07-08 04:00:00","2019-07-08 04:30:00",2166,511,2677
"2019-07-07 10:10:36","2019-07-08 05:00:00","2019-07-08 05:30:00",2193,506,2699
"2019-07-07 10:10:36","2019-07-08 06:00:00","2019-07-08 06:30:00",2296,560,2856
"2019-07-07 10:10:36","2019-07-08 07:00:00","2019-07-08 07:30:00",2724,724,3448
"2019-07-07 10:10:36","2019-07-08 08:00:00","2019-07-08 08:30:00",3151,867,4018
"2019-07-07 10:10:36","2019-07-08 09:00:00","2019-07-08 09:30:00",3454,923,4377
"2019-07-07 10:10:36","2019-07-08 10:00:00","2019-07-08 10:30:00",3486,966,4452
"2019-07-07 10:10:36","2019-07-08 11:00:00","2019-07-08 11:30:00",3523,965,4488
"2019-07-07 10:10:36","2019-07-08 12:00:00","2019-07-08 12:30:00",3561,943,4504
"2019-07-07 10:10:36","2019-07-08 13:00:00","2019-07-08 13:30:00",3608,925,4533
"2019-07-07 10:10:36","2019-07-08 14:00:00","2019-07-08 14:30:00",3563,905,4468
"2019-07-07 10:10:36","2019-07-08 15:00:00","2019-07-08 15:30:00",3550,920,4470
"2019-07-07 10:10:36","2019-07-08 16:00:00","2019-07-08 16:30:00",3554,919,4473
"2019-07-07 10:10:36","2019-07-08 17:00:00","2019-07-08 17:30:00",3637,997,4634
"2019-07-07 10:10:36","2019-07-08 18:00:00","2019-07-08 18:30:00",3638,972,4610
"2019-07-07 10:10:36","2019-07-08 19:00:00","2019-07-08 19:30:00",3500,934,4434
"2019-07-07 10:10:36","2019-07-08 20:00:00","2019-07-08 20:30:00",3340,908,4248
"2019-07-07 10:10:36","2019-07-08 21:00:00","2019-07-08 21:30:00",3243,893,4136
"2019-07-07 10:10:36","2019-07-08 22:00:00","2019-07-08 22:30:00",3078,836,3914
"2019-07-08 10:10:26","2019-07-08 23:00:00","2019-07-08 23:30:00",3084,812,3896
"2019-07-08 10:10:26","2019-07-09 00:00:00","2019-07-09 00:30:00",2690,672,3362
"2019-07-08 10:10:26","2019-07-09 01:00:00","2019-07-09 01:30:00",2502,608,3110
"2019-07-08 10:10:26","2019-07-09 02:00:00","2019-07-09 02:30:00",2376,573,2949
"2019-07-08 10:10:26","2019-07-09 03:00:00","2019-07-09 03:30:00",2328,548,2876
"2019-07-08 10:10:26","2019-07-09 04:00:00","2019-07-09 04:30:00",2307,545,2852
"2019-07-08 10:10:26","2019-07-09 05:00:00","2019-07-09 05:30:00",2315,529,2844
"2019-07-08 10:10:26","2019-07-09 06:00:00","2019-07-09 06:30:00",2409,592,3001
"2019-07-08 10:10:26","2019-07-09 07:00:00","2019-07-09 07:30:00",2810,731,3541
"2019-07-08 10:10:26","2019-07-09 08:00:00","2019-07-09 08:30:00",3280,881,4161
"2019-07-08 10:10:26","2019-07-09 09:00:00","2019-07-09 09:30:00",3581,975,4556
"2019-07-08 10:10:26","2019-07-09 10:00:00","2019-07-09 10:30:00",3623,991,4614
"2019-07-08 10:10:26","2019-07-09 11:00:00","2019-07-09 11:30:00",3659,984,4643
"2019-07-08 10:10:26","2019-07-09 12:00:00","2019-07-09 12:30:00",3660,989,4649
"2019-07-08 10:10:26","2019-07-09 13:00:00","2019-07-09 13:30:00",3671,979,4650
"2019-07-08 10:10:26","2019-07-09 14:00:00","2019-07-09 14:30:00",3586,950,4536
"2019-07-08 10:10:26","2019-07-09 15:00:00","2019-07-09 15:30:00",3579,937,4516
"2019-07-08 10:10:26","2019-07-09 16:00:00","2019-07-09 16:30:00",3605,950,4555
"2019-07-08 10:10:26","2019-07-09 17:00:00","2019-07-09 17:30:00",3690,995,4685
"2019-07-08 10:10:26","2019-07-09 18:00:00","2019-07-09 18:30:00",3732,992,4724
"2019-07-08 10:10:26","2019-07-09 19:00:00","2019-07-09 19:30:00",3569,918,4487
"2019-07-08 10:10:26","2019-07-09 20:00:00","2019-07-09 20:30:00",3412,871,4283
"2019-07-08 10:10:26","2019-07-09 21:00:00","2019-07-09 21:30:00",3289,848,4137
"2019-07-08 10:10:26","2019-07-09 22:00:00","2019-07-09 22:30:00",3114,790,3904
"2019-07-09 10:10:11","2019-07-09 23:00:00","2019-07-09 23:30:00",3056,828,3884
"2019-07-09 10:10:11","2019-07-10 00:00:00","2019-07-10 00:30:00",2703,661,3364
"2019-07-09 10:10:11","2019-07-10 01:00:00","2019-07-10 01:30:00",2512,601,3113
"2019-07-09 10:10:11","2019-07-10 02:00:00","2019-07-10 02:30:00",2367,568,2935
"2019-07-09 10:10:11","2019-07-10 03:00:00","2019-07-10 03:30:00",2319,545,2864
"2019-07-09 10:10:11","2019-07-10 04:00:00","2019-07-10 04:30:00",2302,544,2846
"2019-07-09 10:10:11","2019-07-10 05:00:00","2019-07-10 05:30:00",2288,529,2817
"2019-07-09 10:10:11","2019-07-10 06:00:00","2019-07-10 06:30:00",2423,593,3016
"2019-07-09 10:10:11","2019-07-10 07:00:00","2019-07-10 07:30:00",2825,729,3554
"2019-07-09 10:10:11","2019-07-10 08:00:00","2019-07-10 08:30:00",3280,891,4171
"2019-07-09 10:10:11","2019-07-10 09:00:00","2019-07-10 09:30:00",3581,985,4566
"2019-07-09 10:10:11","2019-07-10 10:00:00","2019-07-10 10:30:00",3623,1004,4627
"2019-07-09 10:10:11","2019-07-10 11:00:00","2019-07-10 11:30:00",3657,996,4653
"2019-07-09 10:10:11","2019-07-10 12:00:00","2019-07-10 12:30:00",3659,1002,4661
"2019-07-09 10:10:11","2019-07-10 13:00:00","2019-07-10 13:30:00",3672,993,4665
"2019-07-09 10:10:11","2019-07-10 14:00:00","2019-07-10 14:30:00",3594,942,4536
"2019-07-09 10:10:11","2019-07-10 15:00:00","2019-07-10 15:30:00",3575,915,4490
"2019-07-09 10:10:11","2019-07-10 16:00:00","2019-07-10 16:30:00",3579,944,4523
"2019-07-09 10:10:11","2019-07-10 17:00:00","2019-07-10 17:30:00",3661,1001,4662
"2019-07-09 10:10:11","2019-07-10 18:00:00","2019-07-10 18:30:00",3716,995,4711
"2019-07-09 10:10:11","2019-07-10 19:00:00","2019-07-10 19:30:00",3545,918,4463
"2019-07-09 10:10:11","2019-07-10 20:00:00","2019-07-10 20:30:00",3381,875,4256
"2019-07-09 10:10:11","2019-07-10 21:00:00","2019-07-10 21:30:00",3277,853,4130
"2019-07-09 10:10:11","2019-07-10 22:00:00","2019-07-10 22:30:00",3118,790,3908
"2019-07-11 10:10:11","2019-07-10 23:00:00","2019-07-10 23:30:00",3025,828,3853
"2019-07-11 10:10:11","2019-07-11 00:00:00","2019-07-11 00:30:00",2718,707,3425
"2019-07-11 10:10:11","2019-07-11 01:00:00","2019-07-11 01:30:00",2521,645,3166
"2019-07-11 10:10:11","2019-07-11 02:00:00","2019-07-11 02:30:00",2386,612,2998
"2019-07-11 10:10:11","2019-07-11 03:00:00","2019-07-11 03:30:00",2310,594,2904
"2019-07-11 10:10:11","2019-07-11 04:00:00","2019-07-11 04:30:00",2298,585,2883
"2019-07-11 10:10:11","2019-07-11 05:00:00","2019-07-11 05:30:00",2324,570,2894
"2019-07-11 10:10:11","2019-07-11 06:00:00","2019-07-11 06:30:00",2432,610,3042
"2019-07-11 10:10:11","2019-07-11 07:00:00","2019-07-11 07:30:00",2814,736,3550
"2019-07-11 10:10:11","2019-07-11 08:00:00","2019-07-11 08:30:00",3287,896,4183
"2019-07-11 10:10:11","2019-07-11 09:00:00","2019-07-11 09:30:00",3611,996,4607
"2019-07-11 10:10:11","2019-07-11 10:00:00","2019-07-11 10:30:00",3685,1017,4702
"2019-07-11 10:10:11","2019-07-11 11:00:00","2019-07-11 11:30:00",3714,1022,4736
"2019-07-11 10:10:11","2019-07-11 12:00:00","2019-07-11 12:30:00",3719,1048,4767
"2019-07-11 10:10:11","2019-07-11 13:00:00","2019-07-11 13:30:00",3728,1032,4760
"2019-07-11 10:10:11","2019-07-11 14:00:00","2019-07-11 14:30:00",3654,978,4632
"2019-07-11 10:10:11","2019-07-11 15:00:00","2019-07-11 15:30:00",3628,969,4597
"2019-07-11 10:10:11","2019-07-11 16:00:00","2019-07-11 16:30:00",3618,970,4588
"2019-07-11 10:10:11","2019-07-11 17:00:00","2019-07-11 17:30:00",3723,1020,4743
"2019-07-11 10:10:11","2019-07-11 18:00:00","2019-07-11 18:30:00",3764,1020,4784
"2019-07-11 10:10:11","2019-07-11 19:00:00","2019-07-11 19:30:00",3606,914,4520
"2019-07-11 10:10:11","2019-07-11 20:00:00","2019-07-11 20:30:00",3421,843,4264
"2019-07-11 10:10:11","2019-07-11 21:00:00","2019-07-11 21:30:00",3321,800,4121
"2019-07-11 10:10:11","2019-07-11 22:00:00","2019-07-11 22:30:00",3192,800,3992
"2019-07-11 10:10:11","2019-07-11 23:00:00","2019-07-11 23:30:00",3009,742,3751
"2019-07-11 10:10:11","2019-07-12 00:00:00","2019-07-12 00:30:00",2729,642,3371
"2019-07-11 10:10:11","2019-07-12 01:00:00","2019-07-12 01:30:00",2533,581,3114
"2019-07-11 10:10:11","2019-07-12 02:00:00","2019-07-12 02:30:00",2415,549,2964
"2019-07-11 10:10:11","2019-07-12 03:00:00","2019-07-12 03:30:00",2353,534,2887
"2019-07-11 10:10:11","2019-07-12 04:00:00","2019-07-12 04:30:00",2339,527,2866
"2019-07-11 10:10:11","2019-07-12 05:00:00","2019-07-12 05:30:00",2337,503,2840
"2019-07-11 10:10:11","2019-07-12 06:00:00","2019-07-12 06:30:00",2423,529,2952
"2019-07-11 10:10:11","2019-07-12 07:00:00","2019-07-12 07:30:00",2804,597,3401
"2019-07-11 10:10:11","2019-07-12 08:00:00","2019-07-12 08:30:00",3253,685,3938
"2019-07-11 10:10:11","2019-07-12 09:00:00","2019-07-12 09:30:00",3588,763,4351
"2019-07-11 10:10:11","2019-07-12 10:00:00","2019-07-12 10:30:00",3648,800,4448
"2019-07-11 10:10:11","2019-07-12 11:00:00","2019-07-12 11:30:00",3657,822,4479
"2019-07-11 10:10:11","2019-07-12 12:00:00","2019-07-12 12:30:00",3669,821,4490
"2019-07-11 10:10:11","2019-07-12 13:00:00","2019-07-12 13:30:00",3687,817,4504
"2019-07-11 10:10:11","2019-07-12 14:00:00","2019-07-12 14:30:00",3599,788,4387
"2019-07-11 10:10:11","2019-07-12 15:00:00","2019-07-12 15:30:00",3590,765,4355
"2019-07-11 10:10:11","2019-07-12 16:00:00","2019-07-12 16:30:00",3517,775,4292
"2019-07-11 10:10:11","2019-07-12 17:00:00","2019-07-12 17:30:00",3551,817,4368
"2019-07-11 10:10:11","2019-07-12 18:00:00","2019-07-12 18:30:00",3598,841,4439
"2019-07-11 10:10:11","2019-07-12 19:00:00","2019-07-12 19:30:00",3518,814,4332
"2019-07-11 10:10:11","2019-07-12 20:00:00","2019-07-12 20:30:00",3345,777,4122
"2019-07-11 10:10:11","2019-07-12 21:00:00","2019-07-12 21:30:00",3237,758,3995
"2019-07-11 10:10:11","2019-07-12 22:00:00","2019-07-12 22:30:00",3090,736,3826
"2019-07-12 10:10:25","2019-07-12 23:00:00","2019-07-12 23:30:00",3013,725,3738
"2019-07-12 10:10:25","2019-07-13 00:00:00","2019-07-13 00:30:00",2749,649,3398
"2019-07-12 10:10:25","2019-07-13 01:00:00","2019-07-13 01:30:00",2551,590,3141
"2019-07-12 10:10:25","2019-07-13 02:00:00","2019-07-13 02:30:00",2422,550,2972
"2019-07-12 10:10:25","2019-07-13 03:00:00","2019-07-13 03:30:00",2337,545,2882
"2019-07-12 10:10:25","2019-07-13 04:00:00","2019-07-13 04:30:00",2313,517,2830
"2019-07-12 10:10:25","2019-07-13 05:00:00","2019-07-13 05:30:00",2305,494,2799
"2019-07-12 10:10:25","2019-07-13 06:00:00","2019-07-13 06:30:00",2323,510,2833
"2019-07-12 10:10:25","2019-07-13 07:00:00","2019-07-13 07:30:00",2497,580,3077
"2019-07-12 10:10:25","2019-07-13 08:00:00","2019-07-13 08:30:00",2810,678,3488
"2019-07-12 10:10:25","2019-07-13 09:00:00","2019-07-13 09:30:00",3116,765,3881
"2019-07-12 10:10:25","2019-07-13 10:00:00","2019-07-13 10:30:00",3288,807,4095
"2019-07-12 10:10:25","2019-07-13 11:00:00","2019-07-13 11:30:00",3353,808,4161
"2019-07-12 10:10:25","2019-07-13 12:00:00","2019-07-13 12:30:00",3363,797,4160
"2019-07-12 10:10:25","2019-07-13 13:00:00","2019-07-13 13:30:00",3340,771,4111
"2019-07-12 10:10:25","2019-07-13 14:00:00","2019-07-13 14:30:00",3235,720,3955
"2019-07-12 10:10:25","2019-07-13 15:00:00","2019-07-13 15:30:00",3172,714,3886
"2019-07-12 10:10:25","2019-07-13 16:00:00","2019-07-13 16:30:00",3148,706,3854
"2019-07-12 10:10:25","2019-07-13 17:00:00","2019-07-13 17:30:00",3233,751,3984
"2019-07-12 10:10:25","2019-07-13 18:00:00","2019-07-13 18:30:00",3314,774,4088
"2019-07-12 10:10:25","2019-07-13 19:00:00","2019-07-13 19:30:00",3206,761,3967
"2019-07-12 10:10:25","2019-07-13 20:00:00","2019-07-13 20:30:00",3051,719,3770
"2019-07-12 10:10:25","2019-07-13 21:00:00","2019-07-13 21:30:00",2920,700,3620
"2019-07-12 10:10:25","2019-07-13 22:00:00","2019-07-13 22:30:00",2835,682,3517
"2019-07-13 10:10:16","2019-07-13 23:00:00","2019-07-13 23:30:00",2756,691,3447
"2019-07-13 10:10:16","2019-07-14 00:00:00","2019-07-14 00:30:00",2564,588,3152
"2019-07-13 10:10:16","2019-07-14 01:00:00","2019-07-14 01:30:00",2420,533,2953
"2019-07-13 10:10:16","2019-07-14 02:00:00","2019-07-14 02:30:00",2307,497,2804
"2019-07-13 10:10:16","2019-07-14 03:00:00","2019-07-14 03:30:00",2232,472,2704
"2019-07-13 10:10:16","2019-07-14 04:00:00","2019-07-14 04:30:00",2196,473,2669
"2019-07-13 10:10:16","2019-07-14 05:00:00","2019-07-14 05:30:00",2161,452,2613
"2019-07-13 10:10:16","2019-07-14 06:00:00","2019-07-14 06:30:00",2131,462,2593
"2019-07-13 10:10:16","2019-07-14 07:00:00","2019-07-14 07:30:00",2244,498,2742
"2019-07-13 10:10:16","2019-07-14 08:00:00","2019-07-14 08:30:00",2487,546,3033
"2019-07-13 10:10:16","2019-07-14 09:00:00","2019-07-14 09:30:00",2732,641,3373
"2019-07-13 10:10:16","2019-07-14 10:00:00","2019-07-14 10:30:00",2969,681,3650
"2019-07-13 10:10:16","2019-07-14 11:00:00","2019-07-14 11:30:00",3115,722,3837
"2019-07-13 10:10:16","2019-07-14 12:00:00","2019-07-14 12:30:00",3157,761,3918
"2019-07-13 10:10:16","2019-07-14 13:00:00","2019-07-14 13:30:00",3190,773,3963
"2019-07-13 10:10:16","2019-07-14 14:00:00","2019-07-14 14:30:00",3118,732,3850
"2019-07-13 10:10:16","2019-07-14 15:00:00","2019-07-14 15:30:00",3030,685,3715
"2019-07-13 10:10:16","2019-07-14 16:00:00","2019-07-14 16:30:00",2994,709,3703
"2019-07-13 10:10:16","2019-07-14 17:00:00","2019-07-14 17:30:00",3068,784,3852
"2019-07-13 10:10:16","2019-07-14 18:00:00","2019-07-14 18:30:00",3149,780,3929
"2019-07-13 10:10:16","2019-07-14 19:00:00","2019-07-14 19:30:00",3098,757,3855
"2019-07-13 10:10:16","2019-07-14 20:00:00","2019-07-14 20:30:00",3007,751,3758
"2019-07-13 10:10:16","2019-07-14 21:00:00","2019-07-14 21:30:00",2932,727,3659
"2019-07-13 10:10:16","2019-07-14 22:00:00","2019-07-14 22:30:00",2858,716,3574
"2019-07-14 10:10:30","2019-07-14 23:00:00","2019-07-14 23:30:00",2756,733,3489
"2019-07-14 10:10:30","2019-07-15 00:00:00","2019-07-15 00:30:00",2531,610,3141
"2019-07-14 10:10:30","2019-07-15 01:00:00","2019-07-15 01:30:00",2368,559,2927
"2019-07-14 10:10:30","2019-07-15 02:00:00","2019-07-15 02:30:00",2260,509,2769
"2019-07-14 10:10:30","2019-07-15 03:00:00","2019-07-15 03:30:00",2204,512,2716
"2019-07-14 10:10:30","2019-07-15 04:00:00","2019-07-15 04:30:00",2198,497,2695
"2019-07-14 10:10:30","2019-07-15 05:00:00","2019-07-15 05:30:00",2232,510,2742
"2019-07-14 10:10:30","2019-07-15 06:00:00","2019-07-15 06:30:00",2342,590,2932
"2019-07-14 10:10:30","2019-07-15 07:00:00","2019-07-15 07:30:00",2731,720,3451
"2019-07-14 10:10:30","2019-07-15 08:00:00","2019-07-15 08:30:00",3214,850,4064
"2019-07-14 10:10:30","2019-07-15 09:00:00","2019-07-15 09:30:00",3543,910,4453
"2019-07-14 10:10:30","2019-07-15 10:00:00","2019-07-15 10:30:00",3613,930,4543
"2019-07-14 10:10:30","2019-07-15 11:00:00","2019-07-15 11:30:00",3655,941,4596
"2019-07-14 10:10:30","2019-07-15 12:00:00","2019-07-15 12:30:00",3689,956,4645
"2019-07-14 10:10:30","2019-07-15 13:00:00","2019-07-15 13:30:00",3714,950,4664
"2019-07-14 10:10:30","2019-07-15 14:00:00","2019-07-15 14:30:00",3641,928,4569
"2019-07-14 10:10:30","2019-07-15 15:00:00","2019-07-15 15:30:00",3617,925,4542
"2019-07-14 10:10:30","2019-07-15 16:00:00","2019-07-15 16:30:00",3641,950,4591
"2019-07-14 10:10:30","2019-07-15 17:00:00","2019-07-15 17:30:00",3732,1015,4747
"2019-07-14 10:10:30","2019-07-15 18:00:00","2019-07-15 18:30:00",3799,1000,4799
"2019-07-14 10:10:30","2019-07-15 19:00:00","2019-07-15 19:30:00",3613,925,4538
"2019-07-14 10:10:30","2019-07-15 20:00:00","2019-07-15 20:30:00",3435,880,4315
"2019-07-14 10:10:30","2019-07-15 21:00:00","2019-07-15 21:30:00",3324,830,4154
"2019-07-14 10:10:30","2019-07-15 22:00:00","2019-07-15 22:30:00",3173,767,3940
"2019-07-15 10:10:20","2019-07-15 23:00:00","2019-07-15 23:30:00",3010,761,3771
"2019-07-15 10:10:20","2019-07-16 00:00:00","2019-07-16 00:30:00",2699,698,3397
"2019-07-15 10:10:20","2019-07-16 01:00:00","2019-07-16 01:30:00",2497,642,3139
"2019-07-15 10:10:20","2019-07-16 02:00:00","2019-07-16 02:30:00",2361,615,2976
"2019-07-15 10:10:20","2019-07-16 03:00:00","2019-07-16 03:30:00",2312,592,2904
"2019-07-15 10:10:20","2019-07-16 04:00:00","2019-07-16 04:30:00",2305,583,2888
"2019-07-15 10:10:20","2019-07-16 05:00:00","2019-07-16 05:30:00",2347,571,2918
"2019-07-15 10:10:20","2019-07-16 06:00:00","2019-07-16 06:30:00",2450,606,3056
"2019-07-15 10:10:20","2019-07-16 07:00:00","2019-07-16 07:30:00",2851,725,3576
"2019-07-15 10:10:20","2019-07-16 08:00:00","2019-07-16 08:30:00",3334,876,4210
"2019-07-15 10:10:20","2019-07-16 09:00:00","2019-07-16 09:30:00",3633,967,4600
"2019-07-15 10:10:20","2019-07-16 10:00:00","2019-07-16 10:30:00",3686,989,4675
"2019-07-15 10:10:20","2019-07-16 11:00:00","2019-07-16 11:30:00",3691,987,4678
"2019-07-15 10:10:20","2019-07-16 12:00:00","2019-07-16 12:30:00",3720,999,4719
"2019-07-15 10:10:20","2019-07-16 13:00:00","2019-07-16 13:30:00",3742,999,4741
"2019-07-15 10:10:20","2019-07-16 14:00:00","2019-07-16 14:30:00",3664,972,4636
"2019-07-15 10:10:20","2019-07-16 15:00:00","2019-07-16 15:30:00",3641,966,4607
"2019-07-15 10:10:20","2019-07-16 16:00:00","2019-07-16 16:30:00",3663,980,4643
"2019-07-15 10:10:20","2019-07-16 17:00:00","2019-07-16 17:30:00",3728,1052,4780
"2019-07-15 10:10:20","2019-07-16 18:00:00","2019-07-16 18:30:00",3771,1065,4836
"2019-07-15 10:10:20","2019-07-16 19:00:00","2019-07-16 19:30:00",3598,982,4580
"2019-07-15 10:10:20","2019-07-16 20:00:00","2019-07-16 20:30:00",3429,929,4358
"2019-07-15 10:10:20","2019-07-16 21:00:00","2019-07-16 21:30:00",3328,907,4235
"2019-07-15 10:10:20","2019-07-16 22:00:00","2019-07-16 22:30:00",3213,890,4103
"2019-07-16 10:10:36","2019-07-16 23:00:00","2019-07-16 23:30:00",3047,827,3874
"2019-07-16 10:10:36","2019-07-17 00:00:00","2019-07-17 00:30:00",2698,693,3391
"2019-07-16 10:10:36","2019-07-17 01:00:00","2019-07-17 01:30:00",2497,629,3126
"2019-07-16 10:10:36","2019-07-17 02:00:00","2019-07-17 02:30:00",2361,603,2964
"2019-07-16 10:10:36","2019-07-17 03:00:00","2019-07-17 03:30:00",2312,587,2899
"2019-07-16 10:10:36","2019-07-17 04:00:00","2019-07-17 04:30:00",2305,576,2881
"2019-07-16 10:10:36","2019-07-17 05:00:00","2019-07-17 05:30:00",2346,567,2913
"2019-07-16 10:10:36","2019-07-17 06:00:00","2019-07-17 06:30:00",2449,611,3060
"2019-07-16 10:10:36","2019-07-17 07:00:00","2019-07-17 07:30:00",2849,735,3584
"2019-07-16 10:10:36","2019-07-17 08:00:00","2019-07-17 08:30:00",3333,881,4214
"2019-07-16 10:10:36","2019-07-17 09:00:00","2019-07-17 09:30:00",3634,979,4613
"2019-07-16 10:10:36","2019-07-17 10:00:00","2019-07-17 10:30:00",3689,1001,4690
"2019-07-16 10:10:36","2019-07-17 11:00:00","2019-07-17 11:30:00",3696,1009,4705
"2019-07-16 10:10:36","2019-07-17 12:00:00","2019-07-17 12:30:00",3726,1029,4755
"2019-07-16 10:10:36","2019-07-17 13:00:00","2019-07-17 13:30:00",3747,1014,4761
"2019-07-16 10:10:36","2019-07-17 14:00:00","2019-07-17 14:30:00",3667,1000,4667
"2019-07-16 10:10:36","2019-07-17 15:00:00","2019-07-17 15:30:00",3644,1000,4644
"2019-07-16 10:10:36","2019-07-17 16:00:00","2019-07-17 16:30:00",3665,1000,4665
"2019-07-16 10:10:36","2019-07-17 17:00:00","2019-07-17 17:30:00",3733,1075,4808
"2019-07-16 10:10:36","2019-07-17 18:00:00","2019-07-17 18:30:00",3774,1080,4854
"2019-07-16 10:10:36","2019-07-17 19:00:00","2019-07-17 19:30:00",3599,1012,4611
"2019-07-16 10:10:36","2019-07-17 20:00:00","2019-07-17 20:30:00",3428,958,4386
"2019-07-16 10:10:36","2019-07-17 21:00:00","2019-07-17 21:30:00",3325,934,4259
"2019-07-16 10:10:36","2019-07-17 22:00:00","2019-07-17 22:30:00",3212,870,4082
"2019-07-17 10:10:21","2019-07-17 23:00:00","2019-07-17 23:30:00",3043,802,3845
"2019-07-17 10:10:21","2019-07-18 00:00:00","2019-07-18 00:30:00",2698,691,3389
"2019-07-17 10:10:21","2019-07-18 01:00:00","2019-07-18 01:30:00",2511,622,3133
"2019-07-17 10:10:21","2019-07-18 02:00:00","2019-07-18 02:30:00",2390,601,2991
"2019-07-17 10:10:21","2019-07-18 03:00:00","2019-07-18 03:30:00",2348,588,2936
"2019-07-17 10:10:21","2019-07-18 04:00:00","2019-07-18 04:30:00",2339,574,2913
"2019-07-17 10:10:21","2019-07-18 05:00:00","2019-07-18 05:30:00",2390,560,2950
"2019-07-17 10:10:21","2019-07-18 06:00:00","2019-07-18 06:30:00",2471,615,3086
"2019-07-17 10:10:21","2019-07-18 07:00:00","2019-07-18 07:30:00",2857,760,3617
"2019-07-17 10:10:21","2019-07-18 08:00:00","2019-07-18 08:30:00",3330,890,4220
"2019-07-17 10:10:21","2019-07-18 09:00:00","2019-07-18 09:30:00",3631,980,4611
"2019-07-17 10:10:21","2019-07-18 10:00:00","2019-07-18 10:30:00",3681,999,4680
"2019-07-17 10:10:21","2019-07-18 11:00:00","2019-07-18 11:30:00",3700,997,4697
"2019-07-17 10:10:21","2019-07-18 12:00:00","2019-07-18 12:30:00",3735,995,4730
"2019-07-17 10:10:21","2019-07-18 13:00:00","2019-07-18 13:30:00",3737,985,4722
"2019-07-17 10:10:21","2019-07-18 14:00:00","2019-07-18 14:30:00",3677,968,4645
"2019-07-17 10:10:21","2019-07-18 15:00:00","2019-07-18 15:30:00",3649,959,4608
"2019-07-17 10:10:21","2019-07-18 16:00:00","2019-07-18 16:30:00",3665,991,4656
"2019-07-17 10:10:21","2019-07-18 17:00:00","2019-07-18 17:30:00",3730,1075,4805
"2019-07-17 10:10:21","2019-07-18 18:00:00","2019-07-18 18:30:00",3769,1060,4829
"2019-07-17 10:10:21","2019-07-18 19:00:00","2019-07-18 19:30:00",3597,990,4587
"2019-07-17 10:10:21","2019-07-18 20:00:00","2019-07-18 20:30:00",3438,924,4362
"2019-07-17 10:10:21","2019-07-18 21:00:00","2019-07-18 21:30:00",3334,900,4234
"2019-07-17 10:10:21","2019-07-18 22:00:00","2019-07-18 22:30:00",3235,872,4107
"2019-07-18 10:10:36","2019-07-18 23:00:00","2019-07-18 23:30:00",3000,783,3783
"2019-07-18 10:10:36","2019-07-19 00:00:00","2019-07-19 00:30:00",2804,642,3446
"2019-07-18 10:10:36","2019-07-19 01:00:00","2019-07-19 01:30:00",2570,577,3147
"2019-07-18 10:10:36","2019-07-19 02:00:00","2019-07-19 02:30:00",2425,556,2981
"2019-07-18 10:10:36","2019-07-19 03:00:00","2019-07-19 03:30:00",2361,546,2907
"2019-07-18 10:10:36","2019-07-19 04:00:00","2019-07-19 04:30:00",2371,539,2910
"2019-07-18 10:10:36","2019-07-19 05:00:00","2019-07-19 05:30:00",2392,535,2927
"2019-07-18 10:10:36","2019-07-19 06:00:00","2019-07-19 06:30:00",2470,600,3070
"2019-07-18 10:10:36","2019-07-19 07:00:00","2019-07-19 07:30:00",2828,720,3548
"2019-07-18 10:10:36","2019-07-19 08:00:00","2019-07-19 08:30:00",3246,860,4106
"2019-07-18 10:10:36","2019-07-19 09:00:00","2019-07-19 09:30:00",3530,960,4490
"2019-07-18 10:10:36","2019-07-19 10:00:00","2019-07-19 10:30:00",3598,980,4578
"2019-07-18 10:10:36","2019-07-19 11:00:00","2019-07-19 11:30:00",3631,979,4610
"2019-07-18 10:10:36","2019-07-19 12:00:00","2019-07-19 12:30:00",3655,990,4645
"2019-07-18 10:10:36","2019-07-19 13:00:00","2019-07-19 13:30:00",3634,972,4606
"2019-07-18 10:10:36","2019-07-19 14:00:00","2019-07-19 14:30:00",3548,948,4496
"2019-07-18 10:10:36","2019-07-19 15:00:00","2019-07-19 15:30:00",3499,943,4442
"2019-07-18 10:10:36","2019-07-19 16:00:00","2019-07-19 16:30:00",3485,961,4446
"2019-07-18 10:10:36","2019-07-19 17:00:00","2019-07-19 17:30:00",3525,997,4522
"2019-07-18 10:10:36","2019-07-19 18:00:00","2019-07-19 18:30:00",3575,980,4555
"2019-07-18 10:10:36","2019-07-19 19:00:00","2019-07-19 19:30:00",3447,940,4387
"2019-07-18 10:10:36","2019-07-19 20:00:00","2019-07-19 20:30:00",3309,877,4186
"2019-07-18 10:10:36","2019-07-19 21:00:00","2019-07-19 21:30:00",3179,848,4027
"2019-07-18 10:10:36","2019-07-19 22:00:00","2019-07-19 22:30:00",3086,822,3908
"2019-07-19 10:10:21","2019-07-19 23:00:00","2019-07-19 23:30:00",2931,827,3758
"2019-07-19 10:10:21","2019-07-20 00:00:00","2019-07-20 00:30:00",2673,673,3346
"2019-07-19 10:10:21","2019-07-20 01:00:00","2019-07-20 01:30:00",2490,604,3094
"2019-07-19 10:10:21","2019-07-20 02:00:00","2019-07-20 02:30:00",2338,575,2913
"2019-07-19 10:10:21","2019-07-20 03:00:00","2019-07-20 03:30:00",2251,554,2805
"2019-07-19 10:10:21","2019-07-20 04:00:00","2019-07-20 04:30:00",2236,539,2775
"2019-07-19 10:10:21","2019-07-20 05:00:00","2019-07-20 05:30:00",2239,531,2770
"2019-07-19 10:10:21","2019-07-20 06:00:00","2019-07-20 06:30:00",2221,540,2761
"2019-07-19 10:10:21","2019-07-20 07:00:00","2019-07-20 07:30:00",2410,619,3029
"2019-07-19 10:10:21","2019-07-20 08:00:00","2019-07-20 08:30:00",2736,733,3469
"2019-07-19 10:10:21","2019-07-20 09:00:00","2019-07-20 09:30:00",3051,857,3908
"2019-07-19 10:10:21","2019-07-20 10:00:00","2019-07-20 10:30:00",3217,907,4124
"2019-07-19 10:10:21","2019-07-20 11:00:00","2019-07-20 11:30:00",3276,930,4206
"2019-07-19 10:10:21","2019-07-20 12:00:00","2019-07-20 12:30:00",3298,928,4226
"2019-07-19 10:10:21","2019-07-20 13:00:00","2019-07-20 13:30:00",3292,901,4193
"2019-07-19 10:10:21","2019-07-20 14:00:00","2019-07-20 14:30:00",3189,858,4047
"2019-07-19 10:10:21","2019-07-20 15:00:00","2019-07-20 15:30:00",3113,828,3941
"2019-07-19 10:10:21","2019-07-20 16:00:00","2019-07-20 16:30:00",3120,829,3949
"2019-07-19 10:10:21","2019-07-20 17:00:00","2019-07-20 17:30:00",3192,886,4078
"2019-07-19 10:10:21","2019-07-20 18:00:00","2019-07-20 18:30:00",3257,912,4169
"2019-07-19 10:10:21","2019-07-20 19:00:00","2019-07-20 19:30:00",3185,881,4066
"2019-07-19 10:10:21","2019-07-20 20:00:00","2019-07-20 20:30:00",3049,827,3876
"2019-07-19 10:10:21","2019-07-20 21:00:00","2019-07-20 21:30:00",2939,798,3737
"2019-07-19 10:10:21","2019-07-20 22:00:00","2019-07-20 22:30:00",2836,787,3623
"2019-07-20 10:10:10","2019-07-20 23:00:00","2019-07-20 23:30:00",2804,740,3544
"2019-07-20 10:10:10","2019-07-21 00:00:00","2019-07-21 00:30:00",2590,665,3255
"2019-07-20 10:10:10","2019-07-21 01:00:00","2019-07-21 01:30:00",2425,601,3026
"2019-07-20 10:10:10","2019-07-21 02:00:00","2019-07-21 02:30:00",2298,570,2868
"2019-07-20 10:10:10","2019-07-21 03:00:00","2019-07-21 03:30:00",2235,551,2786
"2019-07-20 10:10:10","2019-07-21 04:00:00","2019-07-21 04:30:00",2197,538,2735
"2019-07-20 10:10:10","2019-07-21 05:00:00","2019-07-21 05:30:00",2158,518,2676
"2019-07-20 10:10:10","2019-07-21 06:00:00","2019-07-21 06:30:00",2144,514,2658
"2019-07-20 10:10:10","2019-07-21 07:00:00","2019-07-21 07:30:00",2255,551,2806
"2019-07-20 10:10:10","2019-07-21 08:00:00","2019-07-21 08:30:00",2502,622,3124
"2019-07-20 10:10:10","2019-07-21 09:00:00","2019-07-21 09:30:00",2794,714,3508
"2019-07-20 10:10:10","2019-07-21 10:00:00","2019-07-21 10:30:00",3007,804,3811
"2019-07-20 10:10:10","2019-07-21 11:00:00","2019-07-21 11:30:00",3119,838,3957
"2019-07-20 10:10:10","2019-07-21 12:00:00","2019-07-21 12:30:00",3160,884,4044
"2019-07-20 10:10:10","2019-07-21 13:00:00","2019-07-21 13:30:00",3159,915,4074
"2019-07-20 10:10:10","2019-07-21 14:00:00","2019-07-21 14:30:00",3089,862,3951
"2019-07-20 10:10:10","2019-07-21 15:00:00","2019-07-21 15:30:00",3004,806,3810
"2019-07-20 10:10:10","2019-07-21 16:00:00","2019-07-21 16:30:00",2978,798,3776
"2019-07-20 10:10:10","2019-07-21 17:00:00","2019-07-21 17:30:00",3018,842,3860
"2019-07-20 10:10:10","2019-07-21 18:00:00","2019-07-21 18:30:00",3093,867,3960
"2019-07-20 10:10:10","2019-07-21 19:00:00","2019-07-21 19:30:00",3027,843,3870
"2019-07-20 10:10:10","2019-07-21 20:00:00","2019-07-21 20:30:00",3008,823,3831
"2019-07-20 10:10:10","2019-07-21 21:00:00","2019-07-21 21:30:00",2930,813,3743
"2019-07-20 10:10:10","2019-07-21 22:00:00","2019-07-21 22:30:00",2843,824,3667
"2019-07-21 10:10:25","2019-07-21 23:00:00","2019-07-21 23:30:00",2765,780,3545
"2019-07-21 10:10:25","2019-07-22 00:00:00","2019-07-22 00:30:00",2463,684,3147
"2019-07-21 10:10:25","2019-07-22 01:00:00","2019-07-22 01:30:00",2277,614,2891
"2019-07-21 10:10:25","2019-07-22 02:00:00","2019-07-22 02:30:00",2164,587,2751
"2019-07-21 10:10:25","2019-07-22 03:00:00","2019-07-22 03:30:00",2129,567,2696
"2019-07-21 10:10:25","2019-07-22 04:00:00","2019-07-22 04:30:00",2131,553,2684
"2019-07-21 10:10:25","2019-07-22 05:00:00","2019-07-22 05:30:00",2172,551,2723
"2019-07-21 10:10:25","2019-07-22 06:00:00","2019-07-22 06:30:00",2289,582,2871
"2019-07-21 10:10:25","2019-07-22 07:00:00","2019-07-22 07:30:00",2669,720,3389
"2019-07-21 10:10:25","2019-07-22 08:00:00","2019-07-22 08:30:00",3154,877,4031
"2019-07-21 10:10:25","2019-07-22 09:00:00","2019-07-22 09:30:00",3490,986,4476
"2019-07-21 10:10:25","2019-07-22 10:00:00","2019-07-22 10:30:00",3582,1007,4589
"2019-07-21 10:10:25","2019-07-22 11:00:00","2019-07-22 11:30:00",3612,1021,4633
"2019-07-21 10:10:25","2019-07-22 12:00:00","2019-07-22 12:30:00",3656,1035,4691
"2019-07-21 10:10:25","2019-07-22 13:00:00","2019-07-22 13:30:00",3649,1037,4686
"2019-07-21 10:10:25","2019-07-22 14:00:00","2019-07-22 14:30:00",3606,1035,4641
"2019-07-21 10:10:25","2019-07-22 15:00:00","2019-07-22 15:30:00",3585,1024,4609
"2019-07-21 10:10:25","2019-07-22 16:00:00","2019-07-22 16:30:00",3599,1042,4641
"2019-07-21 10:10:25","2019-07-22 17:00:00","2019-07-22 17:30:00",3674,1120,4794
"2019-07-21 10:10:25","2019-07-22 18:00:00","2019-07-22 18:30:00",3721,1115,4836
"2019-07-21 10:10:25","2019-07-22 19:00:00","2019-07-22 19:30:00",3547,1021,4568
"2019-07-21 10:10:25","2019-07-22 20:00:00","2019-07-22 20:30:00",3369,956,4325
"2019-07-21 10:10:25","2019-07-22 21:00:00","2019-07-22 21:30:00",3300,939,4239
"2019-07-21 10:10:25","2019-07-22 22:00:00","2019-07-22 22:30:00",3203,919,4122
"2019-07-22 10:10:10","2019-07-22 23:00:00","2019-07-22 23:30:00",3031,836,3867
"2019-07-22 10:10:10","2019-07-23 00:00:00","2019-07-23 00:30:00",2654,652,3306
"2019-07-22 10:10:10","2019-07-23 01:00:00","2019-07-23 01:30:00",2452,578,3030
"2019-07-22 10:10:10","2019-07-23 02:00:00","2019-07-23 02:30:00",2351,549,2900
"2019-07-22 10:10:10","2019-07-23 03:00:00","2019-07-23 03:30:00",2275,535,2810
"2019-07-22 10:10:10","2019-07-23 04:00:00","2019-07-23 04:30:00",2280,533,2813
"2019-07-22 10:10:10","2019-07-23 05:00:00","2019-07-23 05:30:00",2312,527,2839
"2019-07-22 10:10:10","2019-07-23 06:00:00","2019-07-23 06:30:00",2409,571,2980
"2019-07-22 10:10:10","2019-07-23 07:00:00","2019-07-23 07:30:00",2775,676,3451
"2019-07-22 10:10:10","2019-07-23 08:00:00","2019-07-23 08:30:00",3229,808,4037
"2019-07-22 10:10:10","2019-07-23 09:00:00","2019-07-23 09:30:00",3522,915,4437
"2019-07-22 10:10:10","2019-07-23 10:00:00","2019-07-23 10:30:00",3566,920,4486
"2019-07-22 10:10:10","2019-07-23 11:00:00","2019-07-23 11:30:00",3586,923,4509
"2019-07-22 10:10:10","2019-07-23 12:00:00","2019-07-23 12:30:00",3602,929,4531
"2019-07-22 10:10:10","2019-07-23 13:00:00","2019-07-23 13:30:00",3621,912,4533
"2019-07-22 10:10:10","2019-07-23 14:00:00","2019-07-23 14:30:00",3552,883,4435
"2019-07-22 10:10:10","2019-07-23 15:00:00","2019-07-23 15:30:00",3542,885,4427
"2019-07-22 10:10:10","2019-07-23 16:00:00","2019-07-23 16:30:00",3560,879,4439
"2019-07-22 10:10:10","2019-07-23 17:00:00","2019-07-23 17:30:00",3661,956,4617
"2019-07-22 10:10:10","2019-07-23 18:00:00","2019-07-23 18:30:00",3672,945,4617
"2019-07-22 10:10:10","2019-07-23 19:00:00","2019-07-23 19:30:00",3532,882,4414
"2019-07-22 10:10:10","2019-07-23 20:00:00","2019-07-23 20:30:00",3372,871,4243
"2019-07-22 10:10:10","2019-07-23 21:00:00","2019-07-23 21:30:00",3274,861,4135
"2019-07-22 10:10:10","2019-07-23 22:00:00","2019-07-23 22:30:00",3203,828,4031
"2019-07-23 10:10:20","2019-07-23 23:00:00","2019-07-23 23:30:00",3107,801,3908
"2019-07-23 10:10:20","2019-07-24 00:00:00","2019-07-24 00:30:00",2757,691,3448
"2019-07-23 10:10:20","2019-07-24 01:00:00","2019-07-24 01:30:00",2565,613,3178
"2019-07-23 10:10:20","2019-07-24 02:00:00","2019-07-24 02:30:00",2437,571,3008
"2019-07-23 10:10:20","2019-07-24 03:00:00","2019-07-24 03:30:00",2391,551,2942
"2019-07-23 10:10:20","2019-07-24 04:00:00","2019-07-24 04:30:00",2380,554,2934
"2019-07-23 10:10:20","2019-07-24 05:00:00","2019-07-24 05:30:00",2437,546,2983
"2019-07-23 10:10:20","2019-07-24 06:00:00","2019-07-24 06:30:00",2505,597,3102
"2019-07-23 10:10:20","2019-07-24 07:00:00","2019-07-24 07:30:00",2915,699,3614
"2019-07-23 10:10:20","2019-07-24 08:00:00","2019-07-24 08:30:00",3399,822,4221
"2019-07-23 10:10:20","2019-07-24 09:00:00","2019-07-24 09:30:00",3741,927,4668
"2019-07-23 10:10:20","2019-07-24 10:00:00","2019-07-24 10:30:00",3807,935,4742
"2019-07-23 10:10:20","2019-07-24 11:00:00","2019-07-24 11:30:00",3834,951,4785
"2019-07-23 10:10:20","2019-07-24 12:00:00","2019-07-24 12:30:00",3860,969,4829
"2019-07-23 10:10:20","2019-07-24 13:00:00","2019-07-24 13:30:00",3870,946,4816
"2019-07-23 10:10:20","2019-07-24 14:00:00","2019-07-24 14:30:00",3789,935,4724
"2019-07-23 10:10:20","2019-07-24 15:00:00","2019-07-24 15:30:00",3771,942,4713
"2019-07-23 10:10:20","2019-07-24 16:00:00","2019-07-24 16:30:00",3785,951,4736
"2019-07-23 10:10:20","2019-07-24 17:00:00","2019-07-24 17:30:00",3848,1022,4870
"2019-07-23 10:10:20","2019-07-24 18:00:00","2019-07-24 18:30:00",3877,1020,4897
"2019-07-23 10:10:20","2019-07-24 19:00:00","2019-07-24 19:30:00",3698,949,4647
"2019-07-23 10:10:20","2019-07-24 20:00:00","2019-07-24 20:30:00",3525,913,4438
"2019-07-23 10:10:20","2019-07-24 21:00:00","2019-07-24 21:30:00",3409,885,4294
"2019-07-23 10:10:20","2019-07-24 22:00:00","2019-07-24 22:30:00",3305,846,4151
"2019-07-24 10:10:36","2019-07-24 23:00:00","2019-07-24 23:30:00",2982,858,3840
"2019-07-24 10:10:36","2019-07-25 00:00:00","2019-07-25 00:30:00",2667,693,3360
"2019-07-24 10:10:36","2019-07-25 01:00:00","2019-07-25 01:30:00",2484,623,3107
"2019-07-24 10:10:36","2019-07-25 02:00:00","2019-07-25 02:30:00",2360,596,2956
"2019-07-24 10:10:36","2019-07-25 03:00:00","2019-07-25 03:30:00",2283,579,2862
"2019-07-24 10:10:36","2019-07-25 04:00:00","2019-07-25 04:30:00",2270,566,2836
"2019-07-24 10:10:36","2019-07-25 05:00:00","2019-07-25 05:30:00",2357,556,2913
"2019-07-24 10:10:36","2019-07-25 06:00:00","2019-07-25 06:30:00",2442,611,3053
"2019-07-24 10:10:36","2019-07-25 07:00:00","2019-07-25 07:30:00",2829,736,3565
"2019-07-24 10:10:36","2019-07-25 08:00:00","2019-07-25 08:30:00",3265,866,4131
"2019-07-24 10:10:36","2019-07-25 09:00:00","2019-07-25 09:30:00",3599,996,4595
"2019-07-24 10:10:36","2019-07-25 10:00:00","2019-07-25 10:30:00",3650,979,4629
"2019-07-24 10:10:36","2019-07-25 11:00:00","2019-07-25 11:30:00",3705,974,4679
"2019-07-24 10:10:36","2019-07-25 12:00:00","2019-07-25 12:30:00",3723,962,4685
"2019-07-24 10:10:36","2019-07-25 13:00:00","2019-07-25 13:30:00",3735,962,4697
"2019-07-24 10:10:36","2019-07-25 14:00:00","2019-07-25 14:30:00",3640,914,4554
"2019-07-24 10:10:36","2019-07-25 15:00:00","2019-07-25 15:30:00",3598,930,4528
"2019-07-24 10:10:36","2019-07-25 16:00:00","2019-07-25 16:30:00",3628,920,4548
"2019-07-24 10:10:36","2019-07-25 17:00:00","2019-07-25 17:30:00",3689,1008,4697
"2019-07-24 10:10:36","2019-07-25 18:00:00","2019-07-25 18:30:00",3731,1008,4739
"2019-07-24 10:10:36","2019-07-25 19:00:00","2019-07-25 19:30:00",3534,935,4469
"2019-07-24 10:10:36","2019-07-25 20:00:00","2019-07-25 20:30:00",3348,908,4256
"2019-07-24 10:10:36","2019-07-25 21:00:00","2019-07-25 21:30:00",3261,871,4132
"2019-07-24 10:10:36","2019-07-25 22:00:00","2019-07-25 22:30:00",3199,854,4053
"2019-07-25 10:10:16","2019-07-25 23:00:00","2019-07-25 23:30:00",2982,785,3767
"2019-07-25 10:10:16","2019-07-26 00:00:00","2019-07-26 00:30:00",2730,662,3392
"2019-07-25 10:10:16","2019-07-26 01:00:00","2019-07-26 01:30:00",2522,590,3112
"2019-07-25 10:10:16","2019-07-26 02:00:00","2019-07-26 02:30:00",2394,568,2962
"2019-07-25 10:10:16","2019-07-26 03:00:00","2019-07-26 03:30:00",2344,565,2909
"2019-07-25 10:10:16","2019-07-26 04:00:00","2019-07-26 04:30:00",2300,554,2854
"2019-07-25 10:10:16","2019-07-26 05:00:00","2019-07-26 05:30:00",2365,536,2901
"2019-07-25 10:10:16","2019-07-26 06:00:00","2019-07-26 06:30:00",2421,581,3002
"2019-07-25 10:10:16","2019-07-26 07:00:00","2019-07-26 07:30:00",2802,690,3492
"2019-07-25 10:10:16","2019-07-26 08:00:00","2019-07-26 08:30:00",3306,820,4126
"2019-07-25 10:10:16","2019-07-26 09:00:00","2019-07-26 09:30:00",3629,956,4585
"2019-07-25 10:10:16","2019-07-26 10:00:00","2019-07-26 10:30:00",3694,985,4679
"2019-07-25 10:10:16","2019-07-26 11:00:00","2019-07-26 11:30:00",3722,999,4721
"2019-07-25 10:10:16","2019-07-26 12:00:00","2019-07-26 12:30:00",3720,1003,4723
"2019-07-25 10:10:16","2019-07-26 13:00:00","2019-07-26 13:30:00",3718,975,4693
"2019-07-25 10:10:16","2019-07-26 14:00:00","2019-07-26 14:30:00",3660,962,4622
"2019-07-25 10:10:16","2019-07-26 15:00:00","2019-07-26 15:30:00",3582,928,4510
"2019-07-25 10:10:16","2019-07-26 16:00:00","2019-07-26 16:30:00",3595,918,4513
"2019-07-25 10:10:16","2019-07-26 17:00:00","2019-07-26 17:30:00",3685,966,4651
"2019-07-25 10:10:16","2019-07-26 18:00:00","2019-07-26 18:30:00",3696,1012,4708
"2019-07-25 10:10:16","2019-07-26 19:00:00","2019-07-26 19:30:00",3537,944,4481
"2019-07-25 10:10:16","2019-07-26 20:00:00","2019-07-26 20:30:00",3359,863,4222
"2019-07-25 10:10:16","2019-07-26 21:00:00","2019-07-26 21:30:00",3228,859,4087
"2019-07-25 10:10:16","2019-07-26 22:00:00","2019-07-26 22:30:00",3177,856,4033
"2019-07-26 10:10:41","2019-07-26 23:00:00","2019-07-26 23:30:00",2932,792,3724
"2019-07-26 10:10:41","2019-07-27 00:00:00","2019-07-27 00:30:00",2733,664,3397
"2019-07-26 10:10:41","2019-07-27 01:00:00","2019-07-27 01:30:00",2551,604,3155
"2019-07-26 10:10:41","2019-07-27 02:00:00","2019-07-27 02:30:00",2422,566,2988
"2019-07-26 10:10:41","2019-07-27 03:00:00","2019-07-27 03:30:00",2353,555,2908
"2019-07-26 10:10:41","2019-07-27 04:00:00","2019-07-27 04:30:00",2316,543,2859
"2019-07-26 10:10:41","2019-07-27 05:00:00","2019-07-27 05:30:00",2334,543,2877
"2019-07-26 10:10:41","2019-07-27 06:00:00","2019-07-27 06:30:00",2324,537,2861
"2019-07-26 10:10:41","2019-07-27 07:00:00","2019-07-27 07:30:00",2502,601,3103
"2019-07-26 10:10:41","2019-07-27 08:00:00","2019-07-27 08:30:00",2803,713,3516
"2019-07-26 10:10:41","2019-07-27 09:00:00","2019-07-27 09:30:00",3099,795,3894
"2019-07-26 10:10:41","2019-07-27 10:00:00","2019-07-27 10:30:00",3273,873,4146
"2019-07-26 10:10:41","2019-07-27 11:00:00","2019-07-27 11:30:00",3329,856,4185
"2019-07-26 10:10:41","2019-07-27 12:00:00","2019-07-27 12:30:00",3327,867,4194
"2019-07-26 10:10:41","2019-07-27 13:00:00","2019-07-27 13:30:00",3300,859,4159
"2019-07-26 10:10:41","2019-07-27 14:00:00","2019-07-27 14:30:00",3197,825,4022
"2019-07-26 10:10:41","2019-07-27 15:00:00","2019-07-27 15:30:00",3134,815,3949
"2019-07-26 10:10:41","2019-07-27 16:00:00","2019-07-27 16:30:00",3118,805,3923
"2019-07-26 10:10:41","2019-07-27 17:00:00","2019-07-27 17:30:00",3201,869,4070
"2019-07-26 10:10:41","2019-07-27 18:00:00","2019-07-27 18:30:00",3243,917,4160
"2019-07-26 10:10:41","2019-07-27 19:00:00","2019-07-27 19:30:00",3182,864,4046
"2019-07-26 10:10:41","2019-07-27 20:00:00","2019-07-27 20:30:00",3021,824,3845
"2019-07-26 10:10:41","2019-07-27 21:00:00","2019-07-27 21:30:00",2906,805,3711
"2019-07-26 10:10:41","2019-07-27 22:00:00","2019-07-27 22:30:00",2933,805,3738
"2019-07-27 10:10:21","2019-07-27 23:00:00","2019-07-27 23:30:00",2753,769,3522
"2019-07-27 10:10:21","2019-07-28 00:00:00","2019-07-28 00:30:00",2552,675,3227
"2019-07-27 10:10:21","2019-07-28 01:00:00","2019-07-28 01:30:00",2413,603,3016
"2019-07-27 10:10:21","2019-07-28 02:00:00","2019-07-28 02:30:00",2296,563,2859
"2019-07-27 10:10:21","2019-07-28 03:00:00","2019-07-28 03:30:00",2213,546,2759
"2019-07-27 10:10:21","2019-07-28 04:00:00","2019-07-28 04:30:00",2192,529,2721
"2019-07-27 10:10:21","2019-07-28 05:00:00","2019-07-28 05:30:00",2174,527,2701
"2019-07-27 10:10:21","2019-07-28 06:00:00","2019-07-28 06:30:00",2165,518,2683
"2019-07-27 10:10:21","2019-07-28 07:00:00","2019-07-28 07:30:00",2284,572,2856
"2019-07-27 10:10:21","2019-07-28 08:00:00","2019-07-28 08:30:00",2500,649,3149
"2019-07-27 10:10:21","2019-07-28 09:00:00","2019-07-28 09:30:00",2798,760,3558
"2019-07-27 10:10:21","2019-07-28 10:00:00","2019-07-28 10:30:00",3014,818,3832
"2019-07-27 10:10:21","2019-07-28 11:00:00","2019-07-28 11:30:00",3193,880,4073
"2019-07-27 10:10:21","2019-07-28 12:00:00","2019-07-28 12:30:00",3278,915,4193
"2019-07-27 10:10:21","2019-07-28 13:00:00","2019-07-28 13:30:00",3316,977,4293
"2019-07-27 10:10:21","2019-07-28 14:00:00","2019-07-28 14:30:00",3231,895,4126
"2019-07-27 10:10:21","2019-07-28 15:00:00","2019-07-28 15:30:00",3218,886,4104
"2019-07-27 10:10:21","2019-07-28 16:00:00","2019-07-28 16:30:00",3243,890,4133
"2019-07-27 10:10:21","2019-07-28 17:00:00","2019-07-28 17:30:00",3306,941,4247
"2019-07-27 10:10:21","2019-07-28 18:00:00","2019-07-28 18:30:00",3377,933,4310
"2019-07-27 10:10:21","2019-07-28 19:00:00","2019-07-28 19:30:00",3304,903,4207
"2019-07-27 10:10:21","2019-07-28 20:00:00","2019-07-28 20:30:00",3115,874,3989
"2019-07-27 10:10:21","2019-07-28 21:00:00","2019-07-28 21:30:00",2999,866,3865
"2019-07-27 10:10:21","2019-07-28 22:00:00","2019-07-28 22:30:00",2972,835,3807
"2019-07-28 10:10:11","2019-07-28 23:00:00","2019-07-28 23:30:00",2730,754,3484
"2019-07-28 10:10:11","2019-07-29 00:00:00","2019-07-29 00:30:00",2559,646,3205
"2019-07-28 10:10:11","2019-07-29 01:00:00","2019-07-29 01:30:00",2382,585,2967
"2019-07-28 10:10:11","2019-07-29 02:00:00","2019-07-29 02:30:00",2303,559,2862
"2019-07-28 10:10:11","2019-07-29 03:00:00","2019-07-29 03:30:00",2276,546,2822
"2019-07-28 10:10:11","2019-07-29 04:00:00","2019-07-29 04:30:00",2258,531,2789
"2019-07-28 10:10:11","2019-07-29 05:00:00","2019-07-29 05:30:00",2316,535,2851
"2019-07-28 10:10:11","2019-07-29 06:00:00","2019-07-29 06:30:00",2441,576,3017
"2019-07-28 10:10:11","2019-07-29 07:00:00","2019-07-29 07:30:00",2775,717,3492
"2019-07-28 10:10:11","2019-07-29 08:00:00","2019-07-29 08:30:00",3256,873,4129
"2019-07-28 10:10:11","2019-07-29 09:00:00","2019-07-29 09:30:00",3599,989,4588
"2019-07-28 10:10:11","2019-07-29 10:00:00","2019-07-29 10:30:00",3683,1027,4710
"2019-07-28 10:10:11","2019-07-29 11:00:00","2019-07-29 11:30:00",3737,1029,4766
"2019-07-28 10:10:11","2019-07-29 12:00:00","2019-07-29 12:30:00",3773,999,4772
"2019-07-28 10:10:11","2019-07-29 13:00:00","2019-07-29 13:30:00",3794,999,4793
"2019-07-28 10:10:11","2019-07-29 14:00:00","2019-07-29 14:30:00",3750,982,4732
"2019-07-28 10:10:11","2019-07-29 15:00:00","2019-07-29 15:30:00",3714,972,4686
"2019-07-28 10:10:11","2019-07-29 16:00:00","2019-07-29 16:30:00",3757,974,4731
"2019-07-28 10:10:11","2019-07-29 17:00:00","2019-07-29 17:30:00",3851,1062,4913
"2019-07-28 10:10:11","2019-07-29 18:00:00","2019-07-29 18:30:00",3854,1063,4917
"2019-07-28 10:10:11","2019-07-29 19:00:00","2019-07-29 19:30:00",3640,1029,4669
"2019-07-28 10:10:11","2019-07-29 20:00:00","2019-07-29 20:30:00",3455,990,4445
"2019-07-28 10:10:11","2019-07-29 21:00:00","2019-07-29 21:30:00",3371,949,4320
"2019-07-28 10:10:11","2019-07-29 22:00:00","2019-07-29 22:30:00",3277,942,4219
"2019-07-29 10:10:35","2019-07-29 23:00:00","2019-07-29 23:30:00",3008,830,3838
"2019-07-29 10:10:35","2019-07-30 00:00:00","2019-07-30 00:30:00",2656,750,3406
"2019-07-29 10:10:35","2019-07-30 01:00:00","2019-07-30 01:30:00",2476,662,3138
"2019-07-29 10:10:35","2019-07-30 02:00:00","2019-07-30 02:30:00",2418,635,3053
"2019-07-29 10:10:35","2019-07-30 03:00:00","2019-07-30 03:30:00",2356,614,2970
"2019-07-29 10:10:35","2019-07-30 04:00:00","2019-07-30 04:30:00",2319,598,2917
"2019-07-29 10:10:35","2019-07-30 05:00:00","2019-07-30 05:30:00",2381,592,2973
"2019-07-29 10:10:35","2019-07-30 06:00:00","2019-07-30 06:30:00",2449,631,3080
"2019-07-29 10:10:35","2019-07-30 07:00:00","2019-07-30 07:30:00",2869,765,3634
"2019-07-29 10:10:35","2019-07-30 08:00:00","2019-07-30 08:30:00",3269,909,4178
"2019-07-29 10:10:35","2019-07-30 09:00:00","2019-07-30 09:30:00",3587,1037,4624
"2019-07-29 10:10:35","2019-07-30 10:00:00","2019-07-30 10:30:00",3661,1037,4698
"2019-07-29 10:10:35","2019-07-30 11:00:00","2019-07-30 11:30:00",3685,1015,4700
"2019-07-29 10:10:35","2019-07-30 12:00:00","2019-07-30 12:30:00",3703,1008,4711
"2019-07-29 10:10:35","2019-07-30 13:00:00","2019-07-30 13:30:00",3717,1005,4722
"2019-07-29 10:10:35","2019-07-30 14:00:00","2019-07-30 14:30:00",3645,982,4627
"2019-07-29 10:10:35","2019-07-30 15:00:00","2019-07-30 15:30:00",3615,963,4578
"2019-07-29 10:10:35","2019-07-30 16:00:00","2019-07-30 16:30:00",3646,975,4621
"2019-07-29 10:10:35","2019-07-30 17:00:00","2019-07-30 17:30:00",3703,1073,4776
"2019-07-29 10:10:35","2019-07-30 18:00:00","2019-07-30 18:30:00",3718,1077,4795
"2019-07-29 10:10:35","2019-07-30 19:00:00","2019-07-30 19:30:00",3555,1017,4572
"2019-07-29 10:10:35","2019-07-30 20:00:00","2019-07-30 20:30:00",3399,985,4384
"2019-07-29 10:10:35","2019-07-30 21:00:00","2019-07-30 21:30:00",3251,937,4188
"2019-07-29 10:10:35","2019-07-30 22:00:00","2019-07-30 22:30:00",3186,929,4115
"2019-07-30 10:10:20","2019-07-30 23:00:00","2019-07-30 23:30:00",2922,858,3780
"2019-07-30 10:10:20","2019-07-31 00:00:00","2019-07-31 00:30:00",2665,749,3414
"2019-07-30 10:10:20","2019-07-31 01:00:00","2019-07-31 01:30:00",2492,659,3151
"2019-07-30 10:10:20","2019-07-31 02:00:00","2019-07-31 02:30:00",2441,631,3072
"2019-07-30 10:10:20","2019-07-31 03:00:00","2019-07-31 03:30:00",2389,606,2995
"2019-07-30 10:10:20","2019-07-31 04:00:00","2019-07-31 04:30:00",2358,580,2938
"2019-07-30 10:10:20","2019-07-31 05:00:00","2019-07-31 05:30:00",2425,582,3007
"2019-07-30 10:10:20","2019-07-31 06:00:00","2019-07-31 06:30:00",2496,628,3124
"2019-07-30 10:10:20","2019-07-31 07:00:00","2019-07-31 07:30:00",2904,759,3663
"2019-07-30 10:10:20","2019-07-31 08:00:00","2019-07-31 08:30:00",3288,902,4190
"2019-07-30 10:10:20","2019-07-31 09:00:00","2019-07-31 09:30:00",3588,1041,4629
"2019-07-30 10:10:20","2019-07-31 10:00:00","2019-07-31 10:30:00",3648,1043,4691
"2019-07-30 10:10:20","2019-07-31 11:00:00","2019-07-31 11:30:00",3663,1028,4691
"2019-07-30 10:10:20","2019-07-31 12:00:00","2019-07-31 12:30:00",3681,1025,4706
"2019-07-30 10:10:20","2019-07-31 13:00:00","2019-07-31 13:30:00",3697,1018,4715
"2019-07-30 10:10:20","2019-07-31 14:00:00","2019-07-31 14:30:00",3625,979,4604
"2019-07-30 10:10:20","2019-07-31 15:00:00","2019-07-31 15:30:00",3596,962,4558
"2019-07-30 10:10:20","2019-07-31 16:00:00","2019-07-31 16:30:00",3625,968,4593
"2019-07-30 10:10:20","2019-07-31 17:00:00","2019-07-31 17:30:00",3679,1066,4745
"2019-07-30 10:10:20","2019-07-31 18:00:00","2019-07-31 18:30:00",3691,1076,4767
"2019-07-30 10:10:20","2019-07-31 19:00:00","2019-07-31 19:30:00",3528,1013,4541
"2019-07-30 10:10:20","2019-07-31 20:00:00","2019-07-31 20:30:00",3368,978,4346
"2019-07-30 10:10:20","2019-07-31 21:00:00","2019-07-31 21:30:00",3220,946,4166
"2019-07-30 10:10:20","2019-07-31 22:00:00","2019-07-31 22:30:00",3161,937,4098
"2019-07-31 10:10:35","2019-07-31 23:00:00","2019-07-31 23:30:00",2932,858,3790
"2019-07-31 10:10:35","2019-08-01 00:00:00","2019-08-01 00:30:00",2585,719,3304
"2019-07-31 10:10:35","2019-08-01 01:00:00","2019-08-01 01:30:00",2427,651,3078
"2019-07-31 10:10:35","2019-08-01 02:00:00","2019-08-01 02:30:00",2338,616,2954
"2019-07-31 10:10:35","2019-08-01 03:00:00","2019-08-01 03:30:00",2290,606,2896
"2019-07-31 10:10:35","2019-08-01 04:00:00","2019-08-01 04:30:00",2282,585,2867
"2019-07-31 10:10:35","2019-08-01 05:00:00","2019-08-01 05:30:00",2323,591,2914
"2019-07-31 10:10:35","2019-08-01 06:00:00","2019-08-01 06:30:00",2402,626,3028
"2019-07-31 10:10:35","2019-08-01 07:00:00","2019-08-01 07:30:00",2783,740,3523
"2019-07-31 10:10:35","2019-08-01 08:00:00","2019-08-01 08:30:00",3188,872,4060
"2019-07-31 10:10:35","2019-08-01 09:00:00","2019-08-01 09:30:00",3489,1001,4490
"2019-07-31 10:10:35","2019-08-01 10:00:00","2019-08-01 10:30:00",3539,998,4537
"2019-07-31 10:10:35","2019-08-01 11:00:00","2019-08-01 11:30:00",3574,1014,4588
"2019-07-31 10:10:35","2019-08-01 12:00:00","2019-08-01 12:30:00",3594,1013,4607
"2019-07-31 10:10:35","2019-08-01 13:00:00","2019-08-01 13:30:00",3631,999,4630
"2019-07-31 10:10:35","2019-08-01 14:00:00","2019-08-01 14:30:00",3563,974,4537
"2019-07-31 10:10:35","2019-08-01 15:00:00","2019-08-01 15:30:00",3537,955,4492
"2019-07-31 10:10:35","2019-08-01 16:00:00","2019-08-01 16:30:00",3544,962,4506
"2019-07-31 10:10:35","2019-08-01 17:00:00","2019-08-01 17:30:00",3638,1025,4663
"2019-07-31 10:10:35","2019-08-01 18:00:00","2019-08-01 18:30:00",3682,1017,4699
"2019-07-31 10:10:35","2019-08-01 19:00:00","2019-08-01 19:30:00",3530,964,4494
"2019-07-31 10:10:35","2019-08-01 20:00:00","2019-08-01 20:30:00",3368,916,4284
"2019-07-31 10:10:35","2019-08-01 21:00:00","2019-08-01 21:30:00",3215,905,4120
"2019-07-31 10:10:35","2019-08-01 22:00:00","2019-08-01 22:30:00",3207,916,4123
"2019-08-01 10:10:20","2019-08-01 23:00:00","2019-08-01 23:30:00",2916,784,3700
"2019-08-01 10:10:20","2019-08-02 00:00:00","2019-08-02 00:30:00",2725,708,3433
"2019-08-01 10:10:20","2019-08-02 01:00:00","2019-08-02 01:30:00",2493,655,3148
"2019-08-01 10:10:20","2019-08-02 02:00:00","2019-08-02 02:30:00",2320,629,2949
"2019-08-01 10:10:20","2019-08-02 03:00:00","2019-08-02 03:30:00",2263,624,2887
"2019-08-01 10:10:20","2019-08-02 04:00:00","2019-08-02 04:30:00",2249,581,2830
"2019-08-01 10:10:20","2019-08-02 05:00:00","2019-08-02 05:30:00",2329,583,2912
"2019-08-01 10:10:20","2019-08-02 06:00:00","2019-08-02 06:30:00",2396,611,3007
"2019-08-01 10:10:20","2019-08-02 07:00:00","2019-08-02 07:30:00",2782,741,3523
"2019-08-01 10:10:20","2019-08-02 08:00:00","2019-08-02 08:30:00",3204,883,4087
"2019-08-01 10:10:20","2019-08-02 09:00:00","2019-08-02 09:30:00",3531,978,4509
"2019-08-01 10:10:20","2019-08-02 10:00:00","2019-08-02 10:30:00",3607,975,4582
"2019-08-01 10:10:20","2019-08-02 11:00:00","2019-08-02 11:30:00",3613,961,4574
"2019-08-01 10:10:20","2019-08-02 12:00:00","2019-08-02 12:30:00",3645,958,4603
"2019-08-01 10:10:20","2019-08-02 13:00:00","2019-08-02 13:30:00",3643,938,4581
"2019-08-01 10:10:20","2019-08-02 14:00:00","2019-08-02 14:30:00",3566,896,4462
"2019-08-01 10:10:20","2019-08-02 15:00:00","2019-08-02 15:30:00",3500,866,4366
"2019-08-01 10:10:20","2019-08-02 16:00:00","2019-08-02 16:30:00",3503,888,4391
"2019-08-01 10:10:20","2019-08-02 17:00:00","2019-08-02 17:30:00",3537,909,4446
"2019-08-01 10:10:20","2019-08-02 18:00:00","2019-08-02 18:30:00",3556,938,4494
"2019-08-01 10:10:20","2019-08-02 19:00:00","2019-08-02 19:30:00",3423,898,4321
"2019-08-01 10:10:20","2019-08-02 20:00:00","2019-08-02 20:30:00",3263,866,4129
"2019-08-01 10:10:20","2019-08-02 21:00:00","2019-08-02 21:30:00",3137,849,3986
"2019-08-01 10:10:20","2019-08-02 22:00:00","2019-08-02 22:30:00",3117,855,3972
"2019-08-02 10:10:35","2019-08-02 23:00:00","2019-08-02 23:30:00",2904,836,3740
"2019-08-02 10:10:35","2019-08-03 00:00:00","2019-08-03 00:30:00",2636,685,3321
"2019-08-02 10:10:35","2019-08-03 01:00:00","2019-08-03 01:30:00",2415,608,3023
"2019-08-02 10:10:35","2019-08-03 02:00:00","2019-08-03 02:30:00",2278,578,2856
"2019-08-02 10:10:35","2019-08-03 03:00:00","2019-08-03 03:30:00",2211,551,2762
"2019-08-02 10:10:35","2019-08-03 04:00:00","2019-08-03 04:30:00",2176,534,2710
"2019-08-02 10:10:35","2019-08-03 05:00:00","2019-08-03 05:30:00",2202,536,2738
"2019-08-02 10:10:35","2019-08-03 06:00:00","2019-08-03 06:30:00",2169,550,2719
"2019-08-02 10:10:35","2019-08-03 07:00:00","2019-08-03 07:30:00",2370,592,2962
"2019-08-02 10:10:35","2019-08-03 08:00:00","2019-08-03 08:30:00",2718,694,3412
"2019-08-02 10:10:35","2019-08-03 09:00:00","2019-08-03 09:30:00",3061,817,3878
"2019-08-02 10:10:35","2019-08-03 10:00:00","2019-08-03 10:30:00",3243,850,4093
"2019-08-02 10:10:35","2019-08-03 11:00:00","2019-08-03 11:30:00",3275,864,4139
"2019-08-02 10:10:35","2019-08-03 12:00:00","2019-08-03 12:30:00",3290,850,4140
"2019-08-02 10:10:35","2019-08-03 13:00:00","2019-08-03 13:30:00",3253,840,4093
"2019-08-02 10:10:35","2019-08-03 14:00:00","2019-08-03 14:30:00",3145,781,3926
"2019-08-02 10:10:35","2019-08-03 15:00:00","2019-08-03 15:30:00",3087,782,3869
"2019-08-02 10:10:35","2019-08-03 16:00:00","2019-08-03 16:30:00",3080,762,3842
"2019-08-02 10:10:35","2019-08-03 17:00:00","2019-08-03 17:30:00",3171,808,3979
"2019-08-02 10:10:35","2019-08-03 18:00:00","2019-08-03 18:30:00",3233,833,4066
"2019-08-02 10:10:35","2019-08-03 19:00:00","2019-08-03 19:30:00",3126,810,3936
"2019-08-02 10:10:35","2019-08-03 20:00:00","2019-08-03 20:30:00",2992,761,3753
"2019-08-02 10:10:35","2019-08-03 21:00:00","2019-08-03 21:30:00",2877,741,3618
"2019-08-02 10:10:35","2019-08-03 22:00:00","2019-08-03 22:30:00",2920,769,3689
"2019-08-03 10:10:11","2019-08-03 23:00:00","2019-08-03 23:30:00",2723,759,3482
"2019-08-03 10:10:11","2019-08-04 00:00:00","2019-08-04 00:30:00",2558,636,3194
"2019-08-03 10:10:11","2019-08-04 01:00:00","2019-08-04 01:30:00",2383,579,2962
"2019-08-03 10:10:11","2019-08-04 02:00:00","2019-08-04 02:30:00",2256,552,2808
"2019-08-03 10:10:11","2019-08-04 03:00:00","2019-08-04 03:30:00",2170,540,2710
"2019-08-03 10:10:11","2019-08-04 04:00:00","2019-08-04 04:30:00",2137,521,2658
"2019-08-03 10:10:11","2019-08-04 05:00:00","2019-08-04 05:30:00",2147,514,2661
"2019-08-03 10:10:11","2019-08-04 06:00:00","2019-08-04 06:30:00",2090,501,2591
"2019-08-03 10:10:11","2019-08-04 07:00:00","2019-08-04 07:30:00",2187,531,2718
"2019-08-03 10:10:11","2019-08-04 08:00:00","2019-08-04 08:30:00",2420,596,3016
"2019-08-03 10:10:11","2019-08-04 09:00:00","2019-08-04 09:30:00",2686,696,3382
"2019-08-03 10:10:11","2019-08-04 10:00:00","2019-08-04 10:30:00",2945,762,3707
"2019-08-03 10:10:11","2019-08-04 11:00:00","2019-08-04 11:30:00",3065,809,3874
"2019-08-03 10:10:11","2019-08-04 12:00:00","2019-08-04 12:30:00",3112,846,3958
"2019-08-03 10:10:11","2019-08-04 13:00:00","2019-08-04 13:30:00",3144,867,4011
"2019-08-03 10:10:11","2019-08-04 14:00:00","2019-08-04 14:30:00",3059,808,3867
"2019-08-03 10:10:11","2019-08-04 15:00:00","2019-08-04 15:30:00",2966,792,3758
"2019-08-03 10:10:11","2019-08-04 16:00:00","2019-08-04 16:30:00",2953,792,3745
"2019-08-03 10:10:11","2019-08-04 17:00:00","2019-08-04 17:30:00",2956,836,3792
"2019-08-03 10:10:11","2019-08-04 18:00:00","2019-08-04 18:30:00",3012,867,3879
"2019-08-03 10:10:11","2019-08-04 19:00:00","2019-08-04 19:30:00",2950,839,3789
"2019-08-03 10:10:11","2019-08-04 20:00:00","2019-08-04 20:30:00",2831,813,3644
"2019-08-03 10:10:11","2019-08-04 21:00:00","2019-08-04 21:30:00",2751,804,3555
"2019-08-03 10:10:11","2019-08-04 22:00:00","2019-08-04 22:30:00",2813,794,3607
"2019-08-04 10:10:31","2019-08-04 23:00:00","2019-08-04 23:30:00",2640,731,3371
"2019-08-04 10:10:31","2019-08-05 00:00:00","2019-08-05 00:30:00",2425,644,3069
"2019-08-04 10:10:31","2019-08-05 01:00:00","2019-08-05 01:30:00",2279,589,2868
"2019-08-04 10:10:31","2019-08-05 02:00:00","2019-08-05 02:30:00",2160,560,2720
"2019-08-04 10:10:31","2019-08-05 03:00:00","2019-08-05 03:30:00",2091,555,2646
"2019-08-04 10:10:31","2019-08-05 04:00:00","2019-08-05 04:30:00",2060,544,2604
"2019-08-04 10:10:31","2019-08-05 05:00:00","2019-08-05 05:30:00",2105,570,2675
"2019-08-04 10:10:31","2019-08-05 06:00:00","2019-08-05 06:30:00",2114,585,2699
"2019-08-04 10:10:31","2019-08-05 07:00:00","2019-08-05 07:30:00",2227,713,2940
"2019-08-04 10:10:31","2019-08-05 08:00:00","2019-08-05 08:30:00",2469,855,3324
"2019-08-04 10:10:31","2019-08-05 09:00:00","2019-08-05 09:30:00",2725,968,3693
"2019-08-04 10:10:31","2019-08-05 10:00:00","2019-08-05 10:30:00",2974,987,3961
"2019-08-04 10:10:31","2019-08-05 11:00:00","2019-08-05 11:30:00",3103,1001,4104
"2019-08-04 10:10:31","2019-08-05 12:00:00","2019-08-05 12:30:00",3171,1028,4199
"2019-08-04 10:10:31","2019-08-05 13:00:00","2019-08-05 13:30:00",3217,1012,4229
"2019-08-04 10:10:31","2019-08-05 14:00:00","2019-08-05 14:30:00",3130,972,4102
"2019-08-04 10:10:31","2019-08-05 15:00:00","2019-08-05 15:30:00",3077,983,4060
"2019-08-04 10:10:31","2019-08-05 16:00:00","2019-08-05 16:30:00",3074,961,4035
"2019-08-04 10:10:31","2019-08-05 17:00:00","2019-08-05 17:30:00",3164,1056,4220
"2019-08-04 10:10:31","2019-08-05 18:00:00","2019-08-05 18:30:00",3270,1030,4300
"2019-08-04 10:10:31","2019-08-05 19:00:00","2019-08-05 19:30:00",3212,961,4173
"2019-08-04 10:10:31","2019-08-05 20:00:00","2019-08-05 20:30:00",3066,908,3974
"2019-08-04 10:10:31","2019-08-05 21:00:00","2019-08-05 21:30:00",3036,925,3961
"2019-08-04 10:10:31","2019-08-05 22:00:00","2019-08-05 22:30:00",3021,910,3931
"2019-08-05 10:10:25","2019-08-05 23:00:00","2019-08-05 23:30:00",2807,828,3635
"2019-08-05 10:10:25","2019-08-06 00:00:00","2019-08-06 00:30:00",2449,671,3120
"2019-08-05 10:10:25","2019-08-06 01:00:00","2019-08-06 01:30:00",2288,617,2905
"2019-08-05 10:10:25","2019-08-06 02:00:00","2019-08-06 02:30:00",2190,587,2777
"2019-08-05 10:10:25","2019-08-06 03:00:00","2019-08-06 03:30:00",2142,576,2718
"2019-08-05 10:10:25","2019-08-06 04:00:00","2019-08-06 04:30:00",2135,559,2694
"2019-08-05 10:10:25","2019-08-06 05:00:00","2019-08-06 05:30:00",2181,568,2749
"2019-08-05 10:10:25","2019-08-06 06:00:00","2019-08-06 06:30:00",2253,600,2853
"2019-08-05 10:10:25","2019-08-06 07:00:00","2019-08-06 07:30:00",2624,742,3366
"2019-08-05 10:10:25","2019-08-06 08:00:00","2019-08-06 08:30:00",3088,885,3973
"2019-08-05 10:10:25","2019-08-06 09:00:00","2019-08-06 09:30:00",3413,996,4409
"2019-08-05 10:10:25","2019-08-06 10:00:00","2019-08-06 10:30:00",3511,1010,4521
"2019-08-05 10:10:25","2019-08-06 11:00:00","2019-08-06 11:30:00",3541,1018,4559
"2019-08-05 10:10:25","2019-08-06 12:00:00","2019-08-06 12:30:00",3566,1037,4603
"2019-08-05 10:10:25","2019-08-06 13:00:00","2019-08-06 13:30:00",3596,1029,4625
"2019-08-05 10:10:25","2019-08-06 14:00:00","2019-08-06 14:30:00",3524,1001,4525
"2019-08-05 10:10:25","2019-08-06 15:00:00","2019-08-06 15:30:00",3520,981,4501
"2019-08-05 10:10:25","2019-08-06 16:00:00","2019-08-06 16:30:00",3544,985,4529
"2019-08-05 10:10:25","2019-08-06 17:00:00","2019-08-06 17:30:00",3652,1052,4704
"2019-08-05 10:10:25","2019-08-06 18:00:00","2019-08-06 18:30:00",3690,1056,4746
"2019-08-05 10:10:25","2019-08-06 19:00:00","2019-08-06 19:30:00",3544,970,4514
"2019-08-05 10:10:25","2019-08-06 20:00:00","2019-08-06 20:30:00",3370,931,4301
"2019-08-05 10:10:25","2019-08-06 21:00:00","2019-08-06 21:30:00",3239,894,4133
"2019-08-05 10:10:25","2019-08-06 22:00:00","2019-08-06 22:30:00",3160,913,4073
"2019-08-06 10:10:16","2019-08-06 23:00:00","2019-08-06 23:30:00",2867,836,3703
"2019-08-06 10:10:16","2019-08-07 00:00:00","2019-08-07 00:30:00",2539,685,3224
"2019-08-06 10:10:16","2019-08-07 01:00:00","2019-08-07 01:30:00",2365,630,2995
"2019-08-06 10:10:16","2019-08-07 02:00:00","2019-08-07 02:30:00",2254,597,2851
"2019-08-06 10:10:16","2019-08-07 03:00:00","2019-08-07 03:30:00",2207,587,2794
"2019-08-06 10:10:16","2019-08-07 04:00:00","2019-08-07 04:30:00",2194,569,2763
"2019-08-06 10:10:16","2019-08-07 05:00:00","2019-08-07 05:30:00",2234,577,2811
"2019-08-06 10:10:16","2019-08-07 06:00:00","2019-08-07 06:30:00",2298,600,2898
"2019-08-06 10:10:16","2019-08-07 07:00:00","2019-08-07 07:30:00",2659,742,3401
"2019-08-06 10:10:16","2019-08-07 08:00:00","2019-08-07 08:30:00",3107,873,3980
"2019-08-06 10:10:16","2019-08-07 09:00:00","2019-08-07 09:30:00",3403,983,4386
"2019-08-06 10:10:16","2019-08-07 10:00:00","2019-08-07 10:30:00",3466,995,4461
"2019-08-06 10:10:16","2019-08-07 11:00:00","2019-08-07 11:30:00",3490,998,4488
"2019-08-06 10:10:16","2019-08-07 12:00:00","2019-08-07 12:30:00",3499,1012,4511
"2019-08-06 10:10:16","2019-08-07 13:00:00","2019-08-07 13:30:00",3521,1003,4524
"2019-08-06 10:10:16","2019-08-07 14:00:00","2019-08-07 14:30:00",3440,987,4427
"2019-08-06 10:10:16","2019-08-07 15:00:00","2019-08-07 15:30:00",3417,965,4382
"2019-08-06 10:10:16","2019-08-07 16:00:00","2019-08-07 16:30:00",3424,961,4385
"2019-08-06 10:10:16","2019-08-07 17:00:00","2019-08-07 17:30:00",3512,1053,4565
"2019-08-06 10:10:16","2019-08-07 18:00:00","2019-08-07 18:30:00",3566,1052,4618
"2019-08-06 10:10:16","2019-08-07 19:00:00","2019-08-07 19:30:00",3414,966,4380
"2019-08-06 10:10:16","2019-08-07 20:00:00","2019-08-07 20:30:00",3267,928,4195
"2019-08-06 10:10:16","2019-08-07 21:00:00","2019-08-07 21:30:00",3153,896,4049
"2019-08-06 10:10:16","2019-08-07 22:00:00","2019-08-07 22:30:00",3178,909,4087
"2019-08-07 10:10:11","2019-08-07 23:00:00","2019-08-07 23:30:00",2894,856,3750
"2019-08-07 10:10:11","2019-08-08 00:00:00","2019-08-08 00:30:00",2509,669,3178
"2019-08-07 10:10:11","2019-08-08 01:00:00","2019-08-08 01:30:00",2362,613,2975
"2019-08-07 10:10:11","2019-08-08 02:00:00","2019-08-08 02:30:00",2272,581,2853
"2019-08-07 10:10:11","2019-08-08 03:00:00","2019-08-08 03:30:00",2230,572,2802
"2019-08-07 10:10:11","2019-08-08 04:00:00","2019-08-08 04:30:00",2216,564,2780
"2019-08-07 10:10:11","2019-08-08 05:00:00","2019-08-08 05:30:00",2277,583,2860
"2019-08-07 10:10:11","2019-08-08 06:00:00","2019-08-08 06:30:00",2358,602,2960
"2019-08-07 10:10:11","2019-08-08 07:00:00","2019-08-08 07:30:00",2717,753,3470
"2019-08-07 10:10:11","2019-08-08 08:00:00","2019-08-08 08:30:00",3145,881,4026
"2019-08-07 10:10:11","2019-08-08 09:00:00","2019-08-08 09:30:00",3472,993,4465
"2019-08-07 10:10:11","2019-08-08 10:00:00","2019-08-08 10:30:00",3557,1018,4575
"2019-08-07 10:10:11","2019-08-08 11:00:00","2019-08-08 11:30:00",3571,1010,4581
"2019-08-07 10:10:11","2019-08-08 12:00:00","2019-08-08 12:30:00",3584,1027,4611
"2019-08-07 10:10:11","2019-08-08 13:00:00","2019-08-08 13:30:00",3556,1013,4569
"2019-08-07 10:10:11","2019-08-08 14:00:00","2019-08-08 14:30:00",3478,987,4465
"2019-08-07 10:10:11","2019-08-08 15:00:00","2019-08-08 15:30:00",3484,967,4451
"2019-08-07 10:10:11","2019-08-08 16:00:00","2019-08-08 16:30:00",3482,977,4459
"2019-08-07 10:10:11","2019-08-08 17:00:00","2019-08-08 17:30:00",3572,1044,4616
"2019-08-07 10:10:11","2019-08-08 18:00:00","2019-08-08 18:30:00",3650,1036,4686
"2019-08-07 10:10:11","2019-08-08 19:00:00","2019-08-08 19:30:00",3450,945,4395
"2019-08-07 10:10:11","2019-08-08 20:00:00","2019-08-08 20:30:00",3301,892,4193
"2019-08-07 10:10:11","2019-08-08 21:00:00","2019-08-08 21:30:00",3227,870,4097
"2019-08-07 10:10:11","2019-08-08 22:00:00","2019-08-08 22:30:00",3233,878,4111
"2019-08-08 10:10:35","2019-08-08 23:00:00","2019-08-08 23:30:00",2926,771,3697
"2019-08-08 10:10:35","2019-08-09 00:00:00","2019-08-09 00:30:00",2669,689,3358
"2019-08-08 10:10:35","2019-08-09 01:00:00","2019-08-09 01:30:00",2489,621,3110
"2019-08-08 10:10:35","2019-08-09 02:00:00","2019-08-09 02:30:00",2361,595,2956
"2019-08-08 10:10:35","2019-08-09 03:00:00","2019-08-09 03:30:00",2271,577,2848
"2019-08-08 10:10:35","2019-08-09 04:00:00","2019-08-09 04:30:00",2271,573,2844
"2019-08-08 10:10:35","2019-08-09 05:00:00","2019-08-09 05:30:00",2326,582,2908
"2019-08-08 10:10:35","2019-08-09 06:00:00","2019-08-09 06:30:00",2412,617,3029
"2019-08-08 10:10:35","2019-08-09 07:00:00","2019-08-09 07:30:00",2743,749,3492
"2019-08-08 10:10:35","2019-08-09 08:00:00","2019-08-09 08:30:00",3176,899,4075
"2019-08-08 10:10:35","2019-08-09 09:00:00","2019-08-09 09:30:00",3528,998,4526
"2019-08-08 10:10:35","2019-08-09 10:00:00","2019-08-09 10:30:00",3596,1040,4636
"2019-08-08 10:10:35","2019-08-09 11:00:00","2019-08-09 11:30:00",3626,1048,4674
"2019-08-08 10:10:35","2019-08-09 12:00:00","2019-08-09 12:30:00",3620,1044,4664
"2019-08-08 10:10:35","2019-08-09 13:00:00","2019-08-09 13:30:00",3636,1038,4674
"2019-08-08 10:10:35","2019-08-09 14:00:00","2019-08-09 14:30:00",3542,1016,4558
"2019-08-08 10:10:35","2019-08-09 15:00:00","2019-08-09 15:30:00",3491,995,4486
"2019-08-08 10:10:35","2019-08-09 16:00:00","2019-08-09 16:30:00",3467,990,4457
"2019-08-08 10:10:35","2019-08-09 17:00:00","2019-08-09 17:30:00",3553,1030,4583
"2019-08-08 10:10:35","2019-08-09 18:00:00","2019-08-09 18:30:00",3593,1028,4621
"2019-08-08 10:10:35","2019-08-09 19:00:00","2019-08-09 19:30:00",3476,958,4434
"2019-08-08 10:10:35","2019-08-09 20:00:00","2019-08-09 20:30:00",3299,912,4211
"2019-08-08 10:10:35","2019-08-09 21:00:00","2019-08-09 21:30:00",3200,927,4127
"2019-08-08 10:10:35","2019-08-09 22:00:00","2019-08-09 22:30:00",3246,874,4120
"2019-08-09 10:10:30","2019-08-09 23:00:00","2019-08-09 23:30:00",2972,760,3732
"2019-08-09 10:10:30","2019-08-10 00:00:00","2019-08-10 00:30:00",2609,669,3278
"2019-08-09 10:10:30","2019-08-10 01:00:00","2019-08-10 01:30:00",2440,616,3056
"2019-08-09 10:10:30","2019-08-10 02:00:00","2019-08-10 02:30:00",2317,562,2879
"2019-08-09 10:10:30","2019-08-10 03:00:00","2019-08-10 03:30:00",2235,533,2768
"2019-08-09 10:10:30","2019-08-10 04:00:00","2019-08-10 04:30:00",2224,528,2752
"2019-08-09 10:10:30","2019-08-10 05:00:00","2019-08-10 05:30:00",2255,534,2789
"2019-08-09 10:10:30","2019-08-10 06:00:00","2019-08-10 06:30:00",2247,536,2783
"2019-08-09 10:10:30","2019-08-10 07:00:00","2019-08-10 07:30:00",2374,597,2971
"2019-08-09 10:10:30","2019-08-10 08:00:00","2019-08-10 08:30:00",2699,714,3413
"2019-08-09 10:10:30","2019-08-10 09:00:00","2019-08-10 09:30:00",3031,831,3862
"2019-08-09 10:10:30","2019-08-10 10:00:00","2019-08-10 10:30:00",3214,873,4087
"2019-08-09 10:10:30","2019-08-10 11:00:00","2019-08-10 11:30:00",3256,894,4150
"2019-08-09 10:10:30","2019-08-10 12:00:00","2019-08-10 12:30:00",3303,882,4185
"2019-08-09 10:10:30","2019-08-10 13:00:00","2019-08-10 13:30:00",3253,869,4122
"2019-08-09 10:10:30","2019-08-10 14:00:00","2019-08-10 14:30:00",3179,825,4004
"2019-08-09 10:10:30","2019-08-10 15:00:00","2019-08-10 15:30:00",3112,786,3898
"2019-08-09 10:10:30","2019-08-10 16:00:00","2019-08-10 16:30:00",3099,791,3890
"2019-08-09 10:10:30","2019-08-10 17:00:00","2019-08-10 17:30:00",3199,839,4038
"2019-08-09 10:10:30","2019-08-10 18:00:00","2019-08-10 18:30:00",3242,870,4112
"2019-08-09 10:10:30","2019-08-10 19:00:00","2019-08-10 19:30:00",3151,851,4002
"2019-08-09 10:10:30","2019-08-10 20:00:00","2019-08-10 20:30:00",2995,791,3786
"2019-08-09 10:10:30","2019-08-10 21:00:00","2019-08-10 21:30:00",2908,781,3689
"2019-08-09 10:10:30","2019-08-10 22:00:00","2019-08-10 22:30:00",2932,780,3712
"2019-08-10 10:10:50","2019-08-10 23:00:00","2019-08-10 23:30:00",2710,750,3460
"2019-08-10 10:10:50","2019-08-11 00:00:00","2019-08-11 00:30:00",2583,627,3210
"2019-08-10 10:10:50","2019-08-11 01:00:00","2019-08-11 01:30:00",2425,575,3000
"2019-08-10 10:10:50","2019-08-11 02:00:00","2019-08-11 02:30:00",2317,560,2877
"2019-08-10 10:10:50","2019-08-11 03:00:00","2019-08-11 03:30:00",2216,546,2762
"2019-08-10 10:10:50","2019-08-11 04:00:00","2019-08-11 04:30:00",2179,528,2707
"2019-08-10 10:10:50","2019-08-11 05:00:00","2019-08-11 05:30:00",2189,525,2714
"2019-08-10 10:10:50","2019-08-11 06:00:00","2019-08-11 06:30:00",2130,521,2651
"2019-08-10 10:10:50","2019-08-11 07:00:00","2019-08-11 07:30:00",2229,550,2779
"2019-08-10 10:10:50","2019-08-11 08:00:00","2019-08-11 08:30:00",2471,633,3104
"2019-08-10 10:10:50","2019-08-11 09:00:00","2019-08-11 09:30:00",2791,735,3526
"2019-08-10 10:10:50","2019-08-11 10:00:00","2019-08-11 10:30:00",3039,795,3834
"2019-08-10 10:10:50","2019-08-11 11:00:00","2019-08-11 11:30:00",3112,814,3926
"2019-08-10 10:10:50","2019-08-11 12:00:00","2019-08-11 12:30:00",3127,863,3990
"2019-08-10 10:10:50","2019-08-11 13:00:00","2019-08-11 13:30:00",3172,885,4057
"2019-08-10 10:10:50","2019-08-11 14:00:00","2019-08-11 14:30:00",3065,835,3900
"2019-08-10 10:10:50","2019-08-11 15:00:00","2019-08-11 15:30:00",3019,792,3811
"2019-08-10 10:10:50","2019-08-11 16:00:00","2019-08-11 16:30:00",3012,785,3797
"2019-08-10 10:10:50","2019-08-11 17:00:00","2019-08-11 17:30:00",3104,845,3949
"2019-08-10 10:10:50","2019-08-11 18:00:00","2019-08-11 18:30:00",3200,863,4063
"2019-08-10 10:10:50","2019-08-11 19:00:00","2019-08-11 19:30:00",3103,857,3960
"2019-08-10 10:10:50","2019-08-11 20:00:00","2019-08-11 20:30:00",2999,846,3845
"2019-08-10 10:10:50","2019-08-11 21:00:00","2019-08-11 21:30:00",2904,834,3738
"2019-08-10 10:10:50","2019-08-11 22:00:00","2019-08-11 22:30:00",2864,830,3694
"2019-08-11 10:10:11","2019-08-11 23:00:00","2019-08-11 23:30:00",2822,679,3501
"2019-08-11 10:10:11","2019-08-12 00:00:00","2019-08-12 00:30:00",2521,637,3158
"2019-08-11 10:10:11","2019-08-12 01:00:00","2019-08-12 01:30:00",2360,584,2944
"2019-08-11 10:10:11","2019-08-12 02:00:00","2019-08-12 02:30:00",2252,558,2810
"2019-08-11 10:10:11","2019-08-12 03:00:00","2019-08-12 03:30:00",2194,547,2741
"2019-08-11 10:10:11","2019-08-12 04:00:00","2019-08-12 04:30:00",2189,536,2725
"2019-08-11 10:10:11","2019-08-12 05:00:00","2019-08-12 05:30:00",2229,545,2774
"2019-08-11 10:10:11","2019-08-12 06:00:00","2019-08-12 06:30:00",2317,618,2935
"2019-08-11 10:10:11","2019-08-12 07:00:00","2019-08-12 07:30:00",2655,748,3403
"2019-08-11 10:10:11","2019-08-12 08:00:00","2019-08-12 08:30:00",3083,912,3995
"2019-08-11 10:10:11","2019-08-12 09:00:00","2019-08-12 09:30:00",3407,1020,4427
"2019-08-11 10:10:11","2019-08-12 10:00:00","2019-08-12 10:30:00",3499,1042,4541
"2019-08-11 10:10:11","2019-08-12 11:00:00","2019-08-12 11:30:00",3560,1047,4607
"2019-08-11 10:10:11","2019-08-12 12:00:00","2019-08-12 12:30:00",3611,1062,4673
"2019-08-11 10:10:11","2019-08-12 13:00:00","2019-08-12 13:30:00",3608,1065,4673
"2019-08-11 10:10:11","2019-08-12 14:00:00","2019-08-12 14:30:00",3527,1032,4559
"2019-08-11 10:10:11","2019-08-12 15:00:00","2019-08-12 15:30:00",3512,1030,4542
"2019-08-11 10:10:11","2019-08-12 16:00:00","2019-08-12 16:30:00",3519,1039,4558
"2019-08-11 10:10:11","2019-08-12 17:00:00","2019-08-12 17:30:00",3638,1130,4768
"2019-08-11 10:10:11","2019-08-12 18:00:00","2019-08-12 18:30:00",3708,1116,4824
"2019-08-11 10:10:11","2019-08-12 19:00:00","2019-08-12 19:30:00",3532,1024,4556
"2019-08-11 10:10:11","2019-08-12 20:00:00","2019-08-12 20:30:00",3356,963,4319
"2019-08-11 10:10:11","2019-08-12 21:00:00","2019-08-12 21:30:00",3348,963,4311
"2019-08-11 10:10:11","2019-08-12 22:00:00","2019-08-12 22:30:00",3263,950,4213
"2019-08-12 10:10:20","2019-08-12 23:00:00","2019-08-12 23:30:00",2906,793,3699
"2019-08-12 10:10:20","2019-08-13 00:00:00","2019-08-13 00:30:00",2670,656,3326
"2019-08-12 10:10:20","2019-08-13 01:00:00","2019-08-13 01:30:00",2473,599,3072
"2019-08-12 10:10:20","2019-08-13 02:00:00","2019-08-13 02:30:00",2355,576,2931
"2019-08-12 10:10:20","2019-08-13 03:00:00","2019-08-13 03:30:00",2290,565,2855
"2019-08-12 10:10:20","2019-08-13 04:00:00","2019-08-13 04:30:00",2292,552,2844
"2019-08-12 10:10:20","2019-08-13 05:00:00","2019-08-13 05:30:00",2328,568,2896
"2019-08-12 10:10:20","2019-08-13 06:00:00","2019-08-13 06:30:00",2410,598,3008
"2019-08-12 10:10:20","2019-08-13 07:00:00","2019-08-13 07:30:00",2757,722,3479
"2019-08-12 10:10:20","2019-08-13 08:00:00","2019-08-13 08:30:00",3229,874,4103
"2019-08-12 10:10:20","2019-08-13 09:00:00","2019-08-13 09:30:00",3560,969,4529
"2019-08-12 10:10:20","2019-08-13 10:00:00","2019-08-13 10:30:00",3659,995,4654
"2019-08-12 10:10:20","2019-08-13 11:00:00","2019-08-13 11:30:00",3674,992,4666
"2019-08-12 10:10:20","2019-08-13 12:00:00","2019-08-13 12:30:00",3694,1016,4710
"2019-08-12 10:10:20","2019-08-13 13:00:00","2019-08-13 13:30:00",3689,1011,4700
"2019-08-12 10:10:20","2019-08-13 14:00:00","2019-08-13 14:30:00",3608,973,4581
"2019-08-12 10:10:20","2019-08-13 15:00:00","2019-08-13 15:30:00",3585,963,4548
"2019-08-12 10:10:20","2019-08-13 16:00:00","2019-08-13 16:30:00",3574,985,4559
"2019-08-12 10:10:20","2019-08-13 17:00:00","2019-08-13 17:30:00",3659,1054,4713
"2019-08-12 10:10:20","2019-08-13 18:00:00","2019-08-13 18:30:00",3679,1047,4726
"2019-08-12 10:10:20","2019-08-13 19:00:00","2019-08-13 19:30:00",3577,972,4549
"2019-08-12 10:10:20","2019-08-13 20:00:00","2019-08-13 20:30:00",3432,920,4352
"2019-08-12 10:10:20","2019-08-13 21:00:00","2019-08-13 21:30:00",3388,903,4291
"2019-08-12 10:10:20","2019-08-13 22:00:00","2019-08-13 22:30:00",3273,904,4177
"2019-08-13 10:10:35","2019-08-13 23:00:00","2019-08-13 23:30:00",2930,810,3740
"2019-08-13 10:10:35","2019-08-14 00:00:00","2019-08-14 00:30:00",2670,665,3335
"2019-08-13 10:10:35","2019-08-14 01:00:00","2019-08-14 01:30:00",2473,599,3072
"2019-08-13 10:10:35","2019-08-14 02:00:00","2019-08-14 02:30:00",2355,578,2933
"2019-08-13 10:10:35","2019-08-14 03:00:00","2019-08-14 03:30:00",2290,567,2857
"2019-08-13 10:10:35","2019-08-14 04:00:00","2019-08-14 04:30:00",2292,559,2851
"2019-08-13 10:10:35","2019-08-14 05:00:00","2019-08-14 05:30:00",2328,568,2896
"2019-08-13 10:10:35","2019-08-14 06:00:00","2019-08-14 06:30:00",2410,596,3006
"2019-08-13 10:10:35","2019-08-14 07:00:00","2019-08-14 07:30:00",2757,718,3475
"2019-08-13 10:10:35","2019-08-14 08:00:00","2019-08-14 08:30:00",3229,873,4102
"2019-08-13 10:10:35","2019-08-14 09:00:00","2019-08-14 09:30:00",3560,972,4532
"2019-08-13 10:10:35","2019-08-14 10:00:00","2019-08-14 10:30:00",3659,986,4645
"2019-08-13 10:10:35","2019-08-14 11:00:00","2019-08-14 11:30:00",3674,994,4668
"2019-08-13 10:10:35","2019-08-14 12:00:00","2019-08-14 12:30:00",3694,1008,4702
"2019-08-13 10:10:35","2019-08-14 13:00:00","2019-08-14 13:30:00",3689,1000,4689
"2019-08-13 10:10:35","2019-08-14 14:00:00","2019-08-14 14:30:00",3608,974,4582
"2019-08-13 10:10:35","2019-08-14 15:00:00","2019-08-14 15:30:00",3585,961,4546
"2019-08-13 10:10:35","2019-08-14 16:00:00","2019-08-14 16:30:00",3574,972,4546
"2019-08-13 10:10:35","2019-08-14 17:00:00","2019-08-14 17:30:00",3659,1048,4707
"2019-08-13 10:10:35","2019-08-14 18:00:00","2019-08-14 18:30:00",3679,1047,4726
"2019-08-13 10:10:35","2019-08-14 19:00:00","2019-08-14 19:30:00",3577,963,4540
"2019-08-13 10:10:35","2019-08-14 20:00:00","2019-08-14 20:30:00",3432,907,4339
"2019-08-13 10:10:35","2019-08-14 21:00:00","2019-08-14 21:30:00",3388,895,4283
"2019-08-13 10:10:35","2019-08-14 22:00:00","2019-08-14 22:30:00",3273,885,4158
"2019-08-14 10:10:25","2019-08-14 23:00:00","2019-08-14 23:30:00",3068,864,3932
"2019-08-14 10:10:25","2019-08-15 00:00:00","2019-08-15 00:30:00",2620,664,3284
"2019-08-14 10:10:25","2019-08-15 01:00:00","2019-08-15 01:30:00",2475,595,3070
"2019-08-14 10:10:25","2019-08-15 02:00:00","2019-08-15 02:30:00",2358,568,2926
"2019-08-14 10:10:25","2019-08-15 03:00:00","2019-08-15 03:30:00",2306,558,2864
"2019-08-14 10:10:25","2019-08-15 04:00:00","2019-08-15 04:30:00",2300,552,2852
"2019-08-14 10:10:25","2019-08-15 05:00:00","2019-08-15 05:30:00",2343,564,2907
"2019-08-14 10:10:25","2019-08-15 06:00:00","2019-08-15 06:30:00",2463,596,3059
"2019-08-14 10:10:25","2019-08-15 07:00:00","2019-08-15 07:30:00",2780,733,3513
"2019-08-14 10:10:25","2019-08-15 08:00:00","2019-08-15 08:30:00",3232,906,4138
"2019-08-14 10:10:25","2019-08-15 09:00:00","2019-08-15 09:30:00",3575,996,4571
"2019-08-14 10:10:25","2019-08-15 10:00:00","2019-08-15 10:30:00",3669,1002,4671
"2019-08-14 10:10:25","2019-08-15 11:00:00","2019-08-15 11:30:00",3711,1010,4721
"2019-08-14 10:10:25","2019-08-15 12:00:00","2019-08-15 12:30:00",3746,1011,4757
"2019-08-14 10:10:25","2019-08-15 13:00:00","2019-08-15 13:30:00",3760,1000,4760
"2019-08-14 10:10:25","2019-08-15 14:00:00","2019-08-15 14:30:00",3666,955,4621
"2019-08-14 10:10:25","2019-08-15 15:00:00","2019-08-15 15:30:00",3655,964,4619
"2019-08-14 10:10:25","2019-08-15 16:00:00","2019-08-15 16:30:00",3675,993,4668
"2019-08-14 10:10:25","2019-08-15 17:00:00","2019-08-15 17:30:00",3744,1075,4819
"2019-08-14 10:10:25","2019-08-15 18:00:00","2019-08-15 18:30:00",3786,1085,4871
"2019-08-14 10:10:25","2019-08-15 19:00:00","2019-08-15 19:30:00",3642,993,4635
"2019-08-14 10:10:25","2019-08-15 20:00:00","2019-08-15 20:30:00",3478,944,4422
"2019-08-14 10:10:25","2019-08-15 21:00:00","2019-08-15 21:30:00",3447,948,4395
"2019-08-14 10:10:25","2019-08-15 22:00:00","2019-08-15 22:30:00",3397,938,4335
"2019-08-15 10:10:16","2019-08-15 23:00:00","2019-08-15 23:30:00",2999,818,3817
"2019-08-15 10:10:16","2019-08-16 00:00:00","2019-08-16 00:30:00",2601,654,3255
"2019-08-15 10:10:16","2019-08-16 01:00:00","2019-08-16 01:30:00",2465,564,3029
"2019-08-15 10:10:16","2019-08-16 02:00:00","2019-08-16 02:30:00",2355,519,2874
"2019-08-15 10:10:16","2019-08-16 03:00:00","2019-08-16 03:30:00",2306,487,2793
"2019-08-15 10:10:16","2019-08-16 04:00:00","2019-08-16 04:30:00",2300,467,2767
"2019-08-15 10:10:16","2019-08-16 05:00:00","2019-08-16 05:30:00",2340,494,2834
"2019-08-15 10:10:16","2019-08-16 06:00:00","2019-08-16 06:30:00",2453,532,2985
"2019-08-15 10:10:16","2019-08-16 07:00:00","2019-08-16 07:30:00",2752,658,3410
"2019-08-15 10:10:16","2019-08-16 08:00:00","2019-08-16 08:30:00",3177,820,3997
"2019-08-15 10:10:16","2019-08-16 09:00:00","2019-08-16 09:30:00",3500,957,4457
"2019-08-15 10:10:16","2019-08-16 10:00:00","2019-08-16 10:30:00",3589,976,4565
"2019-08-15 10:10:16","2019-08-16 11:00:00","2019-08-16 11:30:00",3628,972,4600
"2019-08-15 10:10:16","2019-08-16 12:00:00","2019-08-16 12:30:00",3661,975,4636
"2019-08-15 10:10:16","2019-08-16 13:00:00","2019-08-16 13:30:00",3675,990,4665
"2019-08-15 10:10:16","2019-08-16 14:00:00","2019-08-16 14:30:00",3586,939,4525
"2019-08-15 10:10:16","2019-08-16 15:00:00","2019-08-16 15:30:00",3575,899,4474
"2019-08-15 10:10:16","2019-08-16 16:00:00","2019-08-16 16:30:00",3595,907,4502
"2019-08-15 10:10:16","2019-08-16 17:00:00","2019-08-16 17:30:00",3660,947,4607
"2019-08-15 10:10:16","2019-08-16 18:00:00","2019-08-16 18:30:00",3700,957,4657
"2019-08-15 10:10:16","2019-08-16 19:00:00","2019-08-16 19:30:00",3563,926,4489
"2019-08-15 10:10:16","2019-08-16 20:00:00","2019-08-16 20:30:00",3409,871,4280
"2019-08-15 10:10:16","2019-08-16 21:00:00","2019-08-16 21:30:00",3380,846,4226
"2019-08-15 10:10:16","2019-08-16 22:00:00","2019-08-16 22:30:00",3333,831,4164
"2019-08-16 10:10:10","2019-08-16 23:00:00","2019-08-16 23:30:00",3024,749,3773
"2019-08-16 10:10:10","2019-08-17 00:00:00","2019-08-17 00:30:00",2712,657,3369
"2019-08-16 10:10:10","2019-08-17 01:00:00","2019-08-17 01:30:00",2532,602,3134
"2019-08-16 10:10:10","2019-08-17 02:00:00","2019-08-17 02:30:00",2396,560,2956
"2019-08-16 10:10:10","2019-08-17 03:00:00","2019-08-17 03:30:00",2347,554,2901
"2019-08-16 10:10:10","2019-08-17 04:00:00","2019-08-17 04:30:00",2320,540,2860
"2019-08-16 10:10:10","2019-08-17 05:00:00","2019-08-17 05:30:00",2330,552,2882
"2019-08-16 10:10:10","2019-08-17 06:00:00","2019-08-17 06:30:00",2338,547,2885
"2019-08-16 10:10:10","2019-08-17 07:00:00","2019-08-17 07:30:00",2489,606,3095
"2019-08-16 10:10:10","2019-08-17 08:00:00","2019-08-17 08:30:00",2819,709,3528
"2019-08-16 10:10:10","2019-08-17 09:00:00","2019-08-17 09:30:00",3155,815,3970
"2019-08-16 10:10:10","2019-08-17 10:00:00","2019-08-17 10:30:00",3361,871,4232
"2019-08-16 10:10:10","2019-08-17 11:00:00","2019-08-17 11:30:00",3441,901,4342
"2019-08-16 10:10:10","2019-08-17 12:00:00","2019-08-17 12:30:00",3482,894,4376
"2019-08-16 10:10:10","2019-08-17 13:00:00","2019-08-17 13:30:00",3500,874,4374
"2019-08-16 10:10:10","2019-08-17 14:00:00","2019-08-17 14:30:00",3369,827,4196
"2019-08-16 10:10:10","2019-08-17 15:00:00","2019-08-17 15:30:00",3330,794,4124
"2019-08-16 10:10:10","2019-08-17 16:00:00","2019-08-17 16:30:00",3303,792,4095
"2019-08-16 10:10:10","2019-08-17 17:00:00","2019-08-17 17:30:00",3389,846,4235
"2019-08-16 10:10:10","2019-08-17 18:00:00","2019-08-17 18:30:00",3415,859,4274
"2019-08-16 10:10:10","2019-08-17 19:00:00","2019-08-17 19:30:00",3327,823,4150
"2019-08-16 10:10:10","2019-08-17 20:00:00","2019-08-17 20:30:00",3172,774,3946
"2019-08-16 10:10:10","2019-08-17 21:00:00","2019-08-17 21:30:00",3116,757,3873
"2019-08-16 10:10:10","2019-08-17 22:00:00","2019-08-17 22:30:00",3042,747,3789
"2019-08-17 10:10:30","2019-08-17 23:00:00","2019-08-17 23:30:00",2810,768,3578
"2019-08-17 10:10:30","2019-08-18 00:00:00","2019-08-18 00:30:00",2616,573,3189
"2019-08-17 10:10:30","2019-08-18 01:00:00","2019-08-18 01:30:00",2465,513,2978
"2019-08-17 10:10:30","2019-08-18 02:00:00","2019-08-18 02:30:00",2340,478,2818
"2019-08-17 10:10:30","2019-08-18 03:00:00","2019-08-18 03:30:00",2259,461,2720
"2019-08-17 10:10:30","2019-08-18 04:00:00","2019-08-18 04:30:00",2232,450,2682
"2019-08-17 10:10:30","2019-08-18 05:00:00","2019-08-18 05:30:00",2240,458,2698
"2019-08-17 10:10:30","2019-08-18 06:00:00","2019-08-18 06:30:00",2224,456,2680
"2019-08-17 10:10:30","2019-08-18 07:00:00","2019-08-18 07:30:00",2285,487,2772
"2019-08-17 10:10:30","2019-08-18 08:00:00","2019-08-18 08:30:00",2506,561,3067
"2019-08-17 10:10:30","2019-08-18 09:00:00","2019-08-18 09:30:00",2798,658,3456
"2019-08-17 10:10:30","2019-08-18 10:00:00","2019-08-18 10:30:00",3005,737,3742
"2019-08-17 10:10:30","2019-08-18 11:00:00","2019-08-18 11:30:00",3160,764,3924
"2019-08-17 10:10:30","2019-08-18 12:00:00","2019-08-18 12:30:00",3213,806,4019
"2019-08-17 10:10:30","2019-08-18 13:00:00","2019-08-18 13:30:00",3239,828,4067
"2019-08-17 10:10:30","2019-08-18 14:00:00","2019-08-18 14:30:00",3193,787,3980
"2019-08-17 10:10:30","2019-08-18 15:00:00","2019-08-18 15:30:00",3102,746,3848
"2019-08-17 10:10:30","2019-08-18 16:00:00","2019-08-18 16:30:00",3083,729,3812
"2019-08-17 10:10:30","2019-08-18 17:00:00","2019-08-18 17:30:00",3111,790,3901
"2019-08-17 10:10:30","2019-08-18 18:00:00","2019-08-18 18:30:00",3190,831,4021
"2019-08-17 10:10:30","2019-08-18 19:00:00","2019-08-18 19:30:00",3139,804,3943
"2019-08-17 10:10:30","2019-08-18 20:00:00","2019-08-18 20:30:00",3053,787,3840
"2019-08-17 10:10:30","2019-08-18 21:00:00","2019-08-18 21:30:00",2983,789,3772
"2019-08-17 10:10:30","2019-08-18 22:00:00","2019-08-18 22:30:00",2999,798,3797
"2019-08-18 10:10:25","2019-08-18 23:00:00","2019-08-18 23:30:00",2731,750,3481
"2019-08-18 10:10:25","2019-08-19 00:00:00","2019-08-19 00:30:00",2532,674,3206
"2019-08-18 10:10:25","2019-08-19 01:00:00","2019-08-19 01:30:00",2384,578,2962
"2019-08-18 10:10:25","2019-08-19 02:00:00","2019-08-19 02:30:00",2289,539,2828
"2019-08-18 10:10:25","2019-08-19 03:00:00","2019-08-19 03:30:00",2212,493,2705
"2019-08-18 10:10:25","2019-08-19 04:00:00","2019-08-19 04:30:00",2201,483,2684
"2019-08-18 10:10:25","2019-08-19 05:00:00","2019-08-19 05:30:00",2247,540,2787
"2019-08-18 10:10:25","2019-08-19 06:00:00","2019-08-19 06:30:00",2402,640,3042
"2019-08-18 10:10:25","2019-08-19 07:00:00","2019-08-19 07:30:00",2705,790,3495
"2019-08-18 10:10:25","2019-08-19 08:00:00","2019-08-19 08:30:00",3156,945,4101
"2019-08-18 10:10:25","2019-08-19 09:00:00","2019-08-19 09:30:00",3487,1015,4502
"2019-08-18 10:10:25","2019-08-19 10:00:00","2019-08-19 10:30:00",3627,1014,4641
"2019-08-18 10:10:25","2019-08-19 11:00:00","2019-08-19 11:30:00",3701,1016,4717
"2019-08-18 10:10:25","2019-08-19 12:00:00","2019-08-19 12:30:00",3736,1018,4754
"2019-08-18 10:10:25","2019-08-19 13:00:00","2019-08-19 13:30:00",3761,1014,4775
"2019-08-18 10:10:25","2019-08-19 14:00:00","2019-08-19 14:30:00",3692,1016,4708
"2019-08-18 10:10:25","2019-08-19 15:00:00","2019-08-19 15:30:00",3666,1010,4676
"2019-08-18 10:10:25","2019-08-19 16:00:00","2019-08-19 16:30:00",3676,1045,4721
"2019-08-18 10:10:25","2019-08-19 17:00:00","2019-08-19 17:30:00",3745,1110,4855
"2019-08-18 10:10:25","2019-08-19 18:00:00","2019-08-19 18:30:00",3788,1105,4893
"2019-08-18 10:10:25","2019-08-19 19:00:00","2019-08-19 19:30:00",3609,1030,4639
"2019-08-18 10:10:25","2019-08-19 20:00:00","2019-08-19 20:30:00",3473,990,4463
"2019-08-18 10:10:25","2019-08-19 21:00:00","2019-08-19 21:30:00",3520,990,4510
"2019-08-18 10:10:25","2019-08-19 22:00:00","2019-08-19 22:30:00",3313,980,4293
"2019-08-19 10:10:20","2019-08-19 23:00:00","2019-08-19 23:30:00",2989,794,3783
"2019-08-19 10:10:20","2019-08-20 00:00:00","2019-08-20 00:30:00",2645,665,3310
"2019-08-19 10:10:20","2019-08-20 01:00:00","2019-08-20 01:30:00",2481,591,3072
"2019-08-19 10:10:20","2019-08-20 02:00:00","2019-08-20 02:30:00",2365,551,2916
"2019-08-19 10:10:20","2019-08-20 03:00:00","2019-08-20 03:30:00",2301,529,2830
"2019-08-19 10:10:20","2019-08-20 04:00:00","2019-08-20 04:30:00",2309,526,2835
"2019-08-19 10:10:20","2019-08-20 05:00:00","2019-08-20 05:30:00",2343,554,2897
"2019-08-19 10:10:20","2019-08-20 06:00:00","2019-08-20 06:30:00",2497,605,3102
"2019-08-19 10:10:20","2019-08-20 07:00:00","2019-08-20 07:30:00",2799,738,3537
"2019-08-19 10:10:20","2019-08-20 08:00:00","2019-08-20 08:30:00",3280,898,4178
"2019-08-19 10:10:20","2019-08-20 09:00:00","2019-08-20 09:30:00",3618,994,4612
"2019-08-19 10:10:20","2019-08-20 10:00:00","2019-08-20 10:30:00",3694,966,4660
"2019-08-19 10:10:20","2019-08-20 11:00:00","2019-08-20 11:30:00",3736,984,4720
"2019-08-19 10:10:20","2019-08-20 12:00:00","2019-08-20 12:30:00",3765,974,4739
"2019-08-19 10:10:20","2019-08-20 13:00:00","2019-08-20 13:30:00",3769,967,4736
"2019-08-19 10:10:20","2019-08-20 14:00:00","2019-08-20 14:30:00",3628,945,4573
"2019-08-19 10:10:20","2019-08-20 15:00:00","2019-08-20 15:30:00",3640,948,4588
"2019-08-19 10:10:20","2019-08-20 16:00:00","2019-08-20 16:30:00",3679,971,4650
"2019-08-19 10:10:20","2019-08-20 17:00:00","2019-08-20 17:30:00",3770,1039,4809
"2019-08-19 10:10:20","2019-08-20 18:00:00","2019-08-20 18:30:00",3847,1048,4895
"2019-08-19 10:10:20","2019-08-20 19:00:00","2019-08-20 19:30:00",3639,963,4602
"2019-08-19 10:10:20","2019-08-20 20:00:00","2019-08-20 20:30:00",3502,931,4433
"2019-08-19 10:10:20","2019-08-20 21:00:00","2019-08-20 21:30:00",3500,931,4431
"2019-08-19 10:10:20","2019-08-20 22:00:00","2019-08-20 22:30:00",3351,900,4251
"2019-08-20 10:10:05","2019-08-20 23:00:00","2019-08-20 23:30:00",2971,810,3781
"2019-08-20 10:10:05","2019-08-21 00:00:00","2019-08-21 00:30:00",2636,668,3304
"2019-08-20 10:10:05","2019-08-21 01:00:00","2019-08-21 01:30:00",2463,598,3061
"2019-08-20 10:10:05","2019-08-21 02:00:00","2019-08-21 02:30:00",2348,559,2907
"2019-08-20 10:10:05","2019-08-21 03:00:00","2019-08-21 03:30:00",2299,536,2835
"2019-08-20 10:10:05","2019-08-21 04:00:00","2019-08-21 04:30:00",2292,526,2818
"2019-08-20 10:10:05","2019-08-21 05:00:00","2019-08-21 05:30:00",2317,543,2860
"2019-08-20 10:10:05","2019-08-21 06:00:00","2019-08-21 06:30:00",2427,591,3018
"2019-08-20 10:10:05","2019-08-21 07:00:00","2019-08-21 07:30:00",2765,705,3470
"2019-08-20 10:10:05","2019-08-21 08:00:00","2019-08-21 08:30:00",3240,856,4096
"2019-08-20 10:10:05","2019-08-21 09:00:00","2019-08-21 09:30:00",3569,940,4509
"2019-08-20 10:10:05","2019-08-21 10:00:00","2019-08-21 10:30:00",3645,938,4583
"2019-08-20 10:10:05","2019-08-21 11:00:00","2019-08-21 11:30:00",3670,958,4628
"2019-08-20 10:10:05","2019-08-21 12:00:00","2019-08-21 12:30:00",3681,970,4651
"2019-08-20 10:10:05","2019-08-21 13:00:00","2019-08-21 13:30:00",3709,968,4677
"2019-08-20 10:10:05","2019-08-21 14:00:00","2019-08-21 14:30:00",3628,947,4575
"2019-08-20 10:10:05","2019-08-21 15:00:00","2019-08-21 15:30:00",3612,958,4570
"2019-08-20 10:10:05","2019-08-21 16:00:00","2019-08-21 16:30:00",3632,965,4597
"2019-08-20 10:10:05","2019-08-21 17:00:00","2019-08-21 17:30:00",3750,1013,4763
"2019-08-20 10:10:05","2019-08-21 18:00:00","2019-08-21 18:30:00",3820,1030,4850
"2019-08-20 10:10:05","2019-08-21 19:00:00","2019-08-21 19:30:00",3653,959,4612
"2019-08-20 10:10:05","2019-08-21 20:00:00","2019-08-21 20:30:00",3469,945,4414
"2019-08-20 10:10:05","2019-08-21 21:00:00","2019-08-21 21:30:00",3458,949,4407
"2019-08-20 10:10:05","2019-08-21 22:00:00","2019-08-21 22:30:00",3331,919,4250
"2019-08-21 10:10:25","2019-08-21 23:00:00","2019-08-21 23:30:00",3000,801,3801
"2019-08-21 10:10:25","2019-08-22 00:00:00","2019-08-22 00:30:00",2643,663,3306
"2019-08-21 10:10:25","2019-08-22 01:00:00","2019-08-22 01:30:00",2472,605,3077
"2019-08-21 10:10:25","2019-08-22 02:00:00","2019-08-22 02:30:00",2358,568,2926
"2019-08-21 10:10:25","2019-08-22 03:00:00","2019-08-22 03:30:00",2309,551,2860
"2019-08-21 10:10:25","2019-08-22 04:00:00","2019-08-22 04:30:00",2302,545,2847
"2019-08-21 10:10:25","2019-08-22 05:00:00","2019-08-22 05:30:00",2327,557,2884
"2019-08-21 10:10:25","2019-08-22 06:00:00","2019-08-22 06:30:00",2436,603,3039
"2019-08-21 10:10:25","2019-08-22 07:00:00","2019-08-22 07:30:00",2772,737,3509
"2019-08-21 10:10:25","2019-08-22 08:00:00","2019-08-22 08:30:00",3244,899,4143
"2019-08-21 10:10:25","2019-08-22 09:00:00","2019-08-22 09:30:00",3570,986,4556
"2019-08-21 10:10:25","2019-08-22 10:00:00","2019-08-22 10:30:00",3646,964,4610
"2019-08-21 10:10:25","2019-08-22 11:00:00","2019-08-22 11:30:00",3671,968,4639
"2019-08-21 10:10:25","2019-08-22 12:00:00","2019-08-22 12:30:00",3682,959,4641
"2019-08-21 10:10:25","2019-08-22 13:00:00","2019-08-22 13:30:00",3710,964,4674
"2019-08-21 10:10:25","2019-08-22 14:00:00","2019-08-22 14:30:00",3629,950,4579
"2019-08-21 10:10:25","2019-08-22 15:00:00","2019-08-22 15:30:00",3613,943,4556
"2019-08-21 10:10:25","2019-08-22 16:00:00","2019-08-22 16:30:00",3633,943,4576
"2019-08-21 10:10:25","2019-08-22 17:00:00","2019-08-22 17:30:00",3751,1033,4784
"2019-08-21 10:10:25","2019-08-22 18:00:00","2019-08-22 18:30:00",3820,1027,4847
"2019-08-21 10:10:25","2019-08-22 19:00:00","2019-08-22 19:30:00",3654,939,4593
"2019-08-21 10:10:25","2019-08-22 20:00:00","2019-08-22 20:30:00",3471,900,4371
"2019-08-21 10:10:25","2019-08-22 21:00:00","2019-08-22 21:30:00",3460,929,4389
"2019-08-21 10:10:25","2019-08-22 22:00:00","2019-08-22 22:30:00",3334,888,4222
"2019-08-22 10:10:11","2019-08-22 23:00:00","2019-08-22 23:30:00",3014,782,3796
"2019-08-22 10:10:11","2019-08-23 00:00:00","2019-08-23 00:30:00",2728,643,3371
"2019-08-22 10:10:11","2019-08-23 01:00:00","2019-08-23 01:30:00",2514,563,3077
"2019-08-22 10:10:11","2019-08-23 02:00:00","2019-08-23 02:30:00",2390,529,2919
"2019-08-22 10:10:11","2019-08-23 03:00:00","2019-08-23 03:30:00",2319,514,2833
"2019-08-22 10:10:11","2019-08-23 04:00:00","2019-08-23 04:30:00",2292,500,2792
"2019-08-22 10:10:11","2019-08-23 05:00:00","2019-08-23 05:30:00",2341,517,2858
"2019-08-22 10:10:11","2019-08-23 06:00:00","2019-08-23 06:30:00",2472,587,3059
"2019-08-22 10:10:11","2019-08-23 07:00:00","2019-08-23 07:30:00",2763,718,3481
"2019-08-22 10:10:11","2019-08-23 08:00:00","2019-08-23 08:30:00",3255,893,4148
"2019-08-22 10:10:11","2019-08-23 09:00:00","2019-08-23 09:30:00",3590,1025,4615
"2019-08-22 10:10:11","2019-08-23 10:00:00","2019-08-23 10:30:00",3675,1063,4738
"2019-08-22 10:10:11","2019-08-23 11:00:00","2019-08-23 11:30:00",3726,1069,4795
"2019-08-22 10:10:11","2019-08-23 12:00:00","2019-08-23 12:30:00",3749,1069,4818
"2019-08-22 10:10:11","2019-08-23 13:00:00","2019-08-23 13:30:00",3742,1045,4787
"2019-08-22 10:10:11","2019-08-23 14:00:00","2019-08-23 14:30:00",3631,986,4617
"2019-08-22 10:10:11","2019-08-23 15:00:00","2019-08-23 15:30:00",3589,953,4542
"2019-08-22 10:10:11","2019-08-23 16:00:00","2019-08-23 16:30:00",3561,951,4512
"2019-08-22 10:10:11","2019-08-23 17:00:00","2019-08-23 17:30:00",3611,1010,4621
"2019-08-22 10:10:11","2019-08-23 18:00:00","2019-08-23 18:30:00",3678,1033,4711
"2019-08-22 10:10:11","2019-08-23 19:00:00","2019-08-23 19:30:00",3550,979,4529
"2019-08-22 10:10:11","2019-08-23 20:00:00","2019-08-23 20:30:00",3380,939,4319
"2019-08-22 10:10:11","2019-08-23 21:00:00","2019-08-23 21:30:00",3517,974,4491
"2019-08-22 10:10:11","2019-08-23 22:00:00","2019-08-23 22:30:00",3326,893,4219
"2019-08-23 10:10:26","2019-08-23 23:00:00","2019-08-23 23:30:00",2962,782,3744
"2019-08-23 10:10:26","2019-08-24 00:00:00","2019-08-24 00:30:00",2772,641,3413
"2019-08-23 10:10:26","2019-08-24 01:00:00","2019-08-24 01:30:00",2529,589,3118
"2019-08-23 10:10:26","2019-08-24 02:00:00","2019-08-24 02:30:00",2396,555,2951
"2019-08-23 10:10:26","2019-08-24 03:00:00","2019-08-24 03:30:00",2272,549,2821
"2019-08-23 10:10:26","2019-08-24 04:00:00","2019-08-24 04:30:00",2244,529,2773
"2019-08-23 10:10:26","2019-08-24 05:00:00","2019-08-24 05:30:00",2240,524,2764
"2019-08-23 10:10:26","2019-08-24 06:00:00","2019-08-24 06:30:00",2314,517,2831
"2019-08-23 10:10:26","2019-08-24 07:00:00","2019-08-24 07:30:00",2429,571,3000
"2019-08-23 10:10:26","2019-08-24 08:00:00","2019-08-24 08:30:00",2739,683,3422
"2019-08-23 10:10:26","2019-08-24 09:00:00","2019-08-24 09:30:00",3093,777,3870
"2019-08-23 10:10:26","2019-08-24 10:00:00","2019-08-24 10:30:00",3290,812,4102
"2019-08-23 10:10:26","2019-08-24 11:00:00","2019-08-24 11:30:00",3350,818,4168
"2019-08-23 10:10:26","2019-08-24 12:00:00","2019-08-24 12:30:00",3359,810,4169
"2019-08-23 10:10:26","2019-08-24 13:00:00","2019-08-24 13:30:00",3332,780,4112
"2019-08-23 10:10:26","2019-08-24 14:00:00","2019-08-24 14:30:00",3244,756,4000
"2019-08-23 10:10:26","2019-08-24 15:00:00","2019-08-24 15:30:00",3189,718,3907
"2019-08-23 10:10:26","2019-08-24 16:00:00","2019-08-24 16:30:00",3185,725,3910
"2019-08-23 10:10:26","2019-08-24 17:00:00","2019-08-24 17:30:00",3255,795,4050
"2019-08-23 10:10:26","2019-08-24 18:00:00","2019-08-24 18:30:00",3307,835,4142
"2019-08-23 10:10:26","2019-08-24 19:00:00","2019-08-24 19:30:00",3232,808,4040
"2019-08-23 10:10:26","2019-08-24 20:00:00","2019-08-24 20:30:00",3095,783,3878
"2019-08-23 10:10:26","2019-08-24 21:00:00","2019-08-24 21:30:00",3150,782,3932
"2019-08-23 10:10:26","2019-08-24 22:00:00","2019-08-24 22:30:00",2979,755,3734
"2019-08-24 10:10:16","2019-08-24 23:00:00","2019-08-24 23:30:00",2775,753,3528
"2019-08-24 10:10:16","2019-08-25 00:00:00","2019-08-25 00:30:00",2614,612,3226
"2019-08-24 10:10:16","2019-08-25 01:00:00","2019-08-25 01:30:00",2450,550,3000
"2019-08-24 10:10:16","2019-08-25 02:00:00","2019-08-25 02:30:00",2326,525,2851
"2019-08-24 10:10:16","2019-08-25 03:00:00","2019-08-25 03:30:00",2245,519,2764
"2019-08-24 10:10:16","2019-08-25 04:00:00","2019-08-25 04:30:00",2230,517,2747
"2019-08-24 10:10:16","2019-08-25 05:00:00","2019-08-25 05:30:00",2243,524,2767
"2019-08-24 10:10:16","2019-08-25 06:00:00","2019-08-25 06:30:00",2255,528,2783
"2019-08-24 10:10:16","2019-08-25 07:00:00","2019-08-25 07:30:00",2263,618,2881
"2019-08-24 10:10:16","2019-08-25 08:00:00","2019-08-25 08:30:00",2468,688,3156
"2019-08-24 10:10:16","2019-08-25 09:00:00","2019-08-25 09:30:00",2747,786,3533
"2019-08-24 10:10:16","2019-08-25 10:00:00","2019-08-25 10:30:00",3005,852,3857
"2019-08-24 10:10:16","2019-08-25 11:00:00","2019-08-25 11:30:00",3149,889,4038
"2019-08-24 10:10:16","2019-08-25 12:00:00","2019-08-25 12:30:00",3241,922,4163
"2019-08-24 10:10:16","2019-08-25 13:00:00","2019-08-25 13:30:00",3280,908,4188
"2019-08-24 10:10:16","2019-08-25 14:00:00","2019-08-25 14:30:00",3205,861,4066
"2019-08-24 10:10:16","2019-08-25 15:00:00","2019-08-25 15:30:00",3103,805,3908
"2019-08-24 10:10:16","2019-08-25 16:00:00","2019-08-25 16:30:00",3067,789,3856
"2019-08-24 10:10:16","2019-08-25 17:00:00","2019-08-25 17:30:00",3094,851,3945
"2019-08-24 10:10:16","2019-08-25 18:00:00","2019-08-25 18:30:00",3186,922,4108
"2019-08-24 10:10:16","2019-08-25 19:00:00","2019-08-25 19:30:00",3144,864,4008
"2019-08-24 10:10:16","2019-08-25 20:00:00","2019-08-25 20:30:00",3058,853,3911
"2019-08-24 10:10:16","2019-08-25 21:00:00","2019-08-25 21:30:00",3237,867,4104
"2019-08-24 10:10:16","2019-08-25 22:00:00","2019-08-25 22:30:00",3016,871,3887
"2019-08-25 10:10:30","2019-08-25 23:00:00","2019-08-25 23:30:00",2766,763,3529
"2019-08-25 10:10:30","2019-08-26 00:00:00","2019-08-26 00:30:00",2484,671,3155
"2019-08-25 10:10:30","2019-08-26 01:00:00","2019-08-26 01:30:00",2322,612,2934
"2019-08-25 10:10:30","2019-08-26 02:00:00","2019-08-26 02:30:00",2202,580,2782
"2019-08-25 10:10:30","2019-08-26 03:00:00","2019-08-26 03:30:00",2163,567,2730
"2019-08-25 10:10:30","2019-08-26 04:00:00","2019-08-26 04:30:00",2190,556,2746
"2019-08-25 10:10:30","2019-08-26 05:00:00","2019-08-26 05:30:00",2224,569,2793
"2019-08-25 10:10:30","2019-08-26 06:00:00","2019-08-26 06:30:00",2380,611,2991
"2019-08-25 10:10:30","2019-08-26 07:00:00","2019-08-26 07:30:00",2661,681,3342
"2019-08-25 10:10:30","2019-08-26 08:00:00","2019-08-26 08:30:00",3137,810,3947
"2019-08-25 10:10:30","2019-08-26 09:00:00","2019-08-26 09:30:00",3420,937,4357
"2019-08-25 10:10:30","2019-08-26 10:00:00","2019-08-26 10:30:00",3565,985,4550
"2019-08-25 10:10:30","2019-08-26 11:00:00","2019-08-26 11:30:00",3600,991,4591
"2019-08-25 10:10:30","2019-08-26 12:00:00","2019-08-26 12:30:00",3646,985,4631
"2019-08-25 10:10:30","2019-08-26 13:00:00","2019-08-26 13:30:00",3668,975,4643
"2019-08-25 10:10:30","2019-08-26 14:00:00","2019-08-26 14:30:00",3569,959,4528
"2019-08-25 10:10:30","2019-08-26 15:00:00","2019-08-26 15:30:00",3567,966,4533
"2019-08-25 10:10:30","2019-08-26 16:00:00","2019-08-26 16:30:00",3568,997,4565
"2019-08-25 10:10:30","2019-08-26 17:00:00","2019-08-26 17:30:00",3648,1060,4708
"2019-08-25 10:10:30","2019-08-26 18:00:00","2019-08-26 18:30:00",3722,1067,4789
"2019-08-25 10:10:30","2019-08-26 19:00:00","2019-08-26 19:30:00",3568,1020,4588
"2019-08-25 10:10:30","2019-08-26 20:00:00","2019-08-26 20:30:00",3433,973,4406
"2019-08-25 10:10:30","2019-08-26 21:00:00","2019-08-26 21:30:00",3599,1041,4640
"2019-08-25 10:10:30","2019-08-26 22:00:00","2019-08-26 22:30:00",3336,951,4287
"2019-08-26 10:10:15","2019-08-26 23:00:00","2019-08-26 23:30:00",3036,809,3845
"2019-08-26 10:10:15","2019-08-27 00:00:00","2019-08-27 00:30:00",2637,689,3326
"2019-08-26 10:10:15","2019-08-27 01:00:00","2019-08-27 01:30:00",2477,627,3104
"2019-08-26 10:10:15","2019-08-27 02:00:00","2019-08-27 02:30:00",2322,592,2914
"2019-08-26 10:10:15","2019-08-27 03:00:00","2019-08-27 03:30:00",2260,582,2842
"2019-08-26 10:10:15","2019-08-27 04:00:00","2019-08-27 04:30:00",2241,577,2818
"2019-08-26 10:10:15","2019-08-27 05:00:00","2019-08-27 05:30:00",2274,585,2859
"2019-08-26 10:10:15","2019-08-27 06:00:00","2019-08-27 06:30:00",2468,635,3103
"2019-08-26 10:10:15","2019-08-27 07:00:00","2019-08-27 07:30:00",2836,766,3602
"2019-08-26 10:10:15","2019-08-27 08:00:00","2019-08-27 08:30:00",3356,924,4280
"2019-08-26 10:10:15","2019-08-27 09:00:00","2019-08-27 09:30:00",3630,1012,4642
"2019-08-26 10:10:15","2019-08-27 10:00:00","2019-08-27 10:30:00",3702,1043,4745
"2019-08-26 10:10:15","2019-08-27 11:00:00","2019-08-27 11:30:00",3697,1049,4746
"2019-08-26 10:10:15","2019-08-27 12:00:00","2019-08-27 12:30:00",3722,1061,4783
"2019-08-26 10:10:15","2019-08-27 13:00:00","2019-08-27 13:30:00",3759,1055,4814
"2019-08-26 10:10:15","2019-08-27 14:00:00","2019-08-27 14:30:00",3676,1042,4718
"2019-08-26 10:10:15","2019-08-27 15:00:00","2019-08-27 15:30:00",3670,1034,4704
"2019-08-26 10:10:15","2019-08-27 16:00:00","2019-08-27 16:30:00",3689,1064,4753
"2019-08-26 10:10:15","2019-08-27 17:00:00","2019-08-27 17:30:00",3788,1130,4918
"2019-08-26 10:10:15","2019-08-27 18:00:00","2019-08-27 18:30:00",3839,1110,4949
"2019-08-26 10:10:15","2019-08-27 19:00:00","2019-08-27 19:30:00",3706,1020,4726
"2019-08-26 10:10:15","2019-08-27 20:00:00","2019-08-27 20:30:00",3600,1020,4620
"2019-08-26 10:10:15","2019-08-27 21:00:00","2019-08-27 21:30:00",3773,1060,4833
"2019-08-26 10:10:15","2019-08-27 22:00:00","2019-08-27 22:30:00",3410,940,4350
"2019-08-27 10:10:35","2019-08-27 23:00:00","2019-08-27 23:30:00",2992,790,3782
"2019-08-27 10:10:35","2019-08-28 00:00:00","2019-08-28 00:30:00",2637,682,3319
"2019-08-27 10:10:35","2019-08-28 01:00:00","2019-08-28 01:30:00",2477,611,3088
"2019-08-27 10:10:35","2019-08-28 02:00:00","2019-08-28 02:30:00",2322,584,2906
"2019-08-27 10:10:35","2019-08-28 03:00:00","2019-08-28 03:30:00",2260,574,2834
"2019-08-27 10:10:35","2019-08-28 04:00:00","2019-08-28 04:30:00",2241,567,2808
"2019-08-27 10:10:35","2019-08-28 05:00:00","2019-08-28 05:30:00",2274,574,2848
"2019-08-27 10:10:35","2019-08-28 06:00:00","2019-08-28 06:30:00",2468,624,3092
"2019-08-27 10:10:35","2019-08-28 07:00:00","2019-08-28 07:30:00",2836,757,3593
"2019-08-27 10:10:35","2019-08-28 08:00:00","2019-08-28 08:30:00",3356,924,4280
"2019-08-27 10:10:35","2019-08-28 09:00:00","2019-08-28 09:30:00",3630,1018,4648
"2019-08-27 10:10:35","2019-08-28 10:00:00","2019-08-28 10:30:00",3702,1050,4752
"2019-08-27 10:10:35","2019-08-28 11:00:00","2019-08-28 11:30:00",3697,1055,4752
"2019-08-27 10:10:35","2019-08-28 12:00:00","2019-08-28 12:30:00",3722,1070,4792
"2019-08-27 10:10:35","2019-08-28 13:00:00","2019-08-28 13:30:00",3759,1067,4826
"2019-08-27 10:10:35","2019-08-28 14:00:00","2019-08-28 14:30:00",3676,1049,4725
"2019-08-27 10:10:35","2019-08-28 15:00:00","2019-08-28 15:30:00",3670,1038,4708
"2019-08-27 10:10:35","2019-08-28 16:00:00","2019-08-28 16:30:00",3689,1075,4764
"2019-08-27 10:10:35","2019-08-28 17:00:00","2019-08-28 17:30:00",3788,1135,4923
"2019-08-27 10:10:35","2019-08-28 18:00:00","2019-08-28 18:30:00",3839,1120,4959
"2019-08-27 10:10:35","2019-08-28 19:00:00","2019-08-28 19:30:00",3706,1028,4734
"2019-08-27 10:10:35","2019-08-28 20:00:00","2019-08-28 20:30:00",3600,977,4577
"2019-08-27 10:10:35","2019-08-28 21:00:00","2019-08-28 21:30:00",3773,1035,4808
"2019-08-27 10:10:35","2019-08-28 22:00:00","2019-08-28 22:30:00",3410,952,4362
"2019-08-28 10:10:26","2019-08-28 23:00:00","2019-08-28 23:30:00",2992,820,3812
"2019-08-28 10:10:26","2019-08-29 00:00:00","2019-08-29 00:30:00",2685,702,3387
"2019-08-28 10:10:26","2019-08-29 01:00:00","2019-08-29 01:30:00",2515,631,3146
"2019-08-28 10:10:26","2019-08-29 02:00:00","2019-08-29 02:30:00",2403,594,2997
"2019-08-28 10:10:26","2019-08-29 03:00:00","2019-08-29 03:30:00",2351,577,2928
"2019-08-28 10:10:26","2019-08-29 04:00:00","2019-08-29 04:30:00",2341,573,2914
"2019-08-28 10:10:26","2019-08-29 05:00:00","2019-08-29 05:30:00",2391,582,2973
"2019-08-28 10:10:26","2019-08-29 06:00:00","2019-08-29 06:30:00",2533,637,3170
"2019-08-28 10:10:26","2019-08-29 07:00:00","2019-08-29 07:30:00",2912,748,3660
"2019-08-28 10:10:26","2019-08-29 08:00:00","2019-08-29 08:30:00",3448,914,4362
"2019-08-28 10:10:26","2019-08-29 09:00:00","2019-08-29 09:30:00",3601,1008,4609
"2019-08-28 10:10:26","2019-08-29 10:00:00","2019-08-29 10:30:00",3646,1019,4665
"2019-08-28 10:10:26","2019-08-29 11:00:00","2019-08-29 11:30:00",3640,1015,4655
"2019-08-28 10:10:26","2019-08-29 12:00:00","2019-08-29 12:30:00",3643,1011,4654
"2019-08-28 10:10:26","2019-08-29 13:00:00","2019-08-29 13:30:00",3709,1017,4726
"2019-08-28 10:10:26","2019-08-29 14:00:00","2019-08-29 14:30:00",3637,991,4628
"2019-08-28 10:10:26","2019-08-29 15:00:00","2019-08-29 15:30:00",3621,989,4610
"2019-08-28 10:10:26","2019-08-29 16:00:00","2019-08-29 16:30:00",3661,1015,4676
"2019-08-28 10:10:26","2019-08-29 17:00:00","2019-08-29 17:30:00",3748,1090,4838
"2019-08-28 10:10:26","2019-08-29 18:00:00","2019-08-29 18:30:00",3768,1096,4864
"2019-08-28 10:10:26","2019-08-29 19:00:00","2019-08-29 19:30:00",3636,1010,4646
"2019-08-28 10:10:26","2019-08-29 20:00:00","2019-08-29 20:30:00",3505,980,4485
"2019-08-28 10:10:26","2019-08-29 21:00:00","2019-08-29 21:30:00",3677,1030,4707
"2019-08-28 10:10:26","2019-08-29 22:00:00","2019-08-29 22:30:00",3363,930,4293
"2019-08-29 10:10:16","2019-08-29 23:00:00","2019-08-29 23:30:00",2936,768,3704
"2019-08-29 10:10:16","2019-08-30 00:00:00","2019-08-30 00:30:00",2634,662,3296
"2019-08-29 10:10:16","2019-08-30 01:00:00","2019-08-30 01:30:00",2469,605,3074
"2019-08-29 10:10:16","2019-08-30 02:00:00","2019-08-30 02:30:00",2359,574,2933
"2019-08-29 10:10:16","2019-08-30 03:00:00","2019-08-30 03:30:00",2260,561,2821
"2019-08-29 10:10:16","2019-08-30 04:00:00","2019-08-30 04:30:00",2251,541,2792
"2019-08-29 10:10:16","2019-08-30 05:00:00","2019-08-30 05:30:00",2309,572,2881
"2019-08-29 10:10:16","2019-08-30 06:00:00","2019-08-30 06:30:00",2469,623,3092
"2019-08-29 10:10:16","2019-08-30 07:00:00","2019-08-30 07:30:00",2907,742,3649
"2019-08-29 10:10:16","2019-08-30 08:00:00","2019-08-30 08:30:00",3503,875,4378
"2019-08-29 10:10:16","2019-08-30 09:00:00","2019-08-30 09:30:00",3691,976,4667
"2019-08-29 10:10:16","2019-08-30 10:00:00","2019-08-30 10:30:00",3745,990,4735
"2019-08-29 10:10:16","2019-08-30 11:00:00","2019-08-30 11:30:00",3710,985,4695
"2019-08-29 10:10:16","2019-08-30 12:00:00","2019-08-30 12:30:00",3739,955,4694
"2019-08-29 10:10:16","2019-08-30 13:00:00","2019-08-30 13:30:00",3762,966,4728
"2019-08-29 10:10:16","2019-08-30 14:00:00","2019-08-30 14:30:00",3699,950,4649
"2019-08-29 10:10:16","2019-08-30 15:00:00","2019-08-30 15:30:00",3613,941,4554
"2019-08-29 10:10:16","2019-08-30 16:00:00","2019-08-30 16:30:00",3659,939,4598
"2019-08-29 10:10:16","2019-08-30 17:00:00","2019-08-30 17:30:00",3771,985,4756
"2019-08-29 10:10:16","2019-08-30 18:00:00","2019-08-30 18:30:00",3790,1022,4812
"2019-08-29 10:10:16","2019-08-30 19:00:00","2019-08-30 19:30:00",3623,962,4585
"2019-08-29 10:10:16","2019-08-30 20:00:00","2019-08-30 20:30:00",3510,913,4423
"2019-08-29 10:10:16","2019-08-30 21:00:00","2019-08-30 21:30:00",3602,924,4526
"2019-08-29 10:10:16","2019-08-30 22:00:00","2019-08-30 22:30:00",3274,862,4136
"2019-08-30 10:10:25","2019-08-30 23:00:00","2019-08-30 23:30:00",3031,783,3814
"2019-08-30 10:10:25","2019-08-31 00:00:00","2019-08-31 00:30:00",2729,644,3373
"2019-08-30 10:10:25","2019-08-31 01:00:00","2019-08-31 01:30:00",2547,566,3113
"2019-08-30 10:10:25","2019-08-31 02:00:00","2019-08-31 02:30:00",2394,537,2931
"2019-08-30 10:10:25","2019-08-31 03:00:00","2019-08-31 03:30:00",2336,525,2861
"2019-08-30 10:10:25","2019-08-31 04:00:00","2019-08-31 04:30:00",2300,515,2815
"2019-08-30 10:10:25","2019-08-31 05:00:00","2019-08-31 05:30:00",2331,517,2848
"2019-08-30 10:10:25","2019-08-31 06:00:00","2019-08-31 06:30:00",2387,556,2943
"2019-08-30 10:10:25","2019-08-31 07:00:00","2019-08-31 07:30:00",2493,608,3101
"2019-08-30 10:10:25","2019-08-31 08:00:00","2019-08-31 08:30:00",2826,716,3542
"2019-08-30 10:10:25","2019-08-31 09:00:00","2019-08-31 09:30:00",3185,849,4034
"2019-08-30 10:10:25","2019-08-31 10:00:00","2019-08-31 10:30:00",3389,904,4293
"2019-08-30 10:10:25","2019-08-31 11:00:00","2019-08-31 11:30:00",3478,918,4396
"2019-08-30 10:10:25","2019-08-31 12:00:00","2019-08-31 12:30:00",3476,886,4362
"2019-08-30 10:10:25","2019-08-31 13:00:00","2019-08-31 13:30:00",3462,881,4343
"2019-08-30 10:10:25","2019-08-31 14:00:00","2019-08-31 14:30:00",3362,832,4194
"2019-08-30 10:10:25","2019-08-31 15:00:00","2019-08-31 15:30:00",3336,811,4147
"2019-08-30 10:10:25","2019-08-31 16:00:00","2019-08-31 16:30:00",3332,822,4154
"2019-08-30 10:10:25","2019-08-31 17:00:00","2019-08-31 17:30:00",3407,873,4280
"2019-08-30 10:10:25","2019-08-31 18:00:00","2019-08-31 18:30:00",3475,922,4397
"2019-08-30 10:10:25","2019-08-31 19:00:00","2019-08-31 19:30:00",3368,873,4241
"2019-08-30 10:10:25","2019-08-31 20:00:00","2019-08-31 20:30:00",3238,823,4061
"2019-08-30 10:10:25","2019-08-31 21:00:00","2019-08-31 21:30:00",3324,873,4197
"2019-08-30 10:10:25","2019-08-31 22:00:00","2019-08-31 22:30:00",3133,828,3961
"2019-08-31 10:10:16","2019-08-31 23:00:00","2019-08-31 23:30:00",2833,736,3569
"2019-08-31 10:10:16","2019-09-01 00:00:00","2019-09-01 00:30:00",2649,656,3305
"2019-08-31 10:10:16","2019-09-01 01:00:00","2019-09-01 01:30:00",2468,606,3074
"2019-08-31 10:10:16","2019-09-01 02:00:00","2019-09-01 02:30:00",2356,575,2931
"2019-08-31 10:10:16","2019-09-01 03:00:00","2019-09-01 03:30:00",2260,546,2806
"2019-08-31 10:10:16","2019-09-01 04:00:00","2019-09-01 04:30:00",2274,539,2813
"2019-08-31 10:10:16","2019-09-01 05:00:00","2019-09-01 05:30:00",2274,546,2820
"2019-08-31 10:10:16","2019-09-01 06:00:00","2019-09-01 06:30:00",2312,546,2858
"2019-08-31 10:10:16","2019-09-01 07:00:00","2019-09-01 07:30:00",2328,554,2882
"2019-08-31 10:10:16","2019-09-01 08:00:00","2019-09-01 08:30:00",2525,631,3156
"2019-08-31 10:10:16","2019-09-01 09:00:00","2019-09-01 09:30:00",2884,734,3618
"2019-08-31 10:10:16","2019-09-01 10:00:00","2019-09-01 10:30:00",3117,787,3904
"2019-08-31 10:10:16","2019-09-01 11:00:00","2019-09-01 11:30:00",3218,808,4026
"2019-08-31 10:10:16","2019-09-01 12:00:00","2019-09-01 12:30:00",3290,826,4116
"2019-08-31 10:10:16","2019-09-01 13:00:00","2019-09-01 13:30:00",3337,852,4189
"2019-08-31 10:10:16","2019-09-01 14:00:00","2019-09-01 14:30:00",3287,799,4086
"2019-08-31 10:10:16","2019-09-01 15:00:00","2019-09-01 15:30:00",3203,770,3973
"2019-08-31 10:10:16","2019-09-01 16:00:00","2019-09-01 16:30:00",3157,788,3945
"2019-08-31 10:10:16","2019-09-01 17:00:00","2019-09-01 17:30:00",3204,846,4050
"2019-08-31 10:10:16","2019-09-01 18:00:00","2019-09-01 18:30:00",3350,887,4237
"2019-08-31 10:10:16","2019-09-01 19:00:00","2019-09-01 19:30:00",3327,856,4183
"2019-08-31 10:10:16","2019-09-01 20:00:00","2019-09-01 20:30:00",3287,842,4129
"2019-08-31 10:10:16","2019-09-01 21:00:00","2019-09-01 21:30:00",3293,883,4176
"2019-08-31 10:10:16","2019-09-01 22:00:00","2019-09-01 22:30:00",3056,836,3892
"2019-09-01 10:10:31","2019-09-01 23:00:00","2019-09-01 23:30:00",2672,731,3403
"2019-09-01 10:10:31","2019-09-02 00:00:00","2019-09-02 00:30:00",2498,632,3130
"2019-09-01 10:10:31","2019-09-02 01:00:00","2019-09-02 01:30:00",2378,576,2954
"2019-09-01 10:10:31","2019-09-02 02:00:00","2019-09-02 02:30:00",2260,545,2805
"2019-09-01 10:10:31","2019-09-02 03:00:00","2019-09-02 03:30:00",2207,548,2755
"2019-09-01 10:10:31","2019-09-02 04:00:00","2019-09-02 04:30:00",2211,542,2753
"2019-09-01 10:10:31","2019-09-02 05:00:00","2019-09-02 05:30:00",2260,558,2818
"2019-09-01 10:10:31","2019-09-02 06:00:00","2019-09-02 06:30:00",2457,622,3079
"2019-09-01 10:10:31","2019-09-02 07:00:00","2019-09-02 07:30:00",2871,778,3649
"2019-09-01 10:10:31","2019-09-02 08:00:00","2019-09-02 08:30:00",3426,955,4381
"2019-09-01 10:10:31","2019-09-02 09:00:00","2019-09-02 09:30:00",3583,1011,4594
"2019-09-01 10:10:31","2019-09-02 10:00:00","2019-09-02 10:30:00",3646,1007,4653
"2019-09-01 10:10:31","2019-09-02 11:00:00","2019-09-02 11:30:00",3648,999,4647
"2019-09-01 10:10:31","2019-09-02 12:00:00","2019-09-02 12:30:00",3652,994,4646
"2019-09-01 10:10:31","2019-09-02 13:00:00","2019-09-02 13:30:00",3690,990,4680
"2019-09-01 10:10:31","2019-09-02 14:00:00","2019-09-02 14:30:00",3609,951,4560
"2019-09-01 10:10:31","2019-09-02 15:00:00","2019-09-02 15:30:00",3608,959,4567
"2019-09-01 10:10:31","2019-09-02 16:00:00","2019-09-02 16:30:00",3652,999,4651
"2019-09-01 10:10:31","2019-09-02 17:00:00","2019-09-02 17:30:00",3804,1087,4891
"2019-09-01 10:10:31","2019-09-02 18:00:00","2019-09-02 18:30:00",3841,1084,4925
"2019-09-01 10:10:31","2019-09-02 19:00:00","2019-09-02 19:30:00",3647,1005,4652
"2019-09-01 10:10:31","2019-09-02 20:00:00","2019-09-02 20:30:00",3509,979,4488
"2019-09-01 10:10:31","2019-09-02 21:00:00","2019-09-02 21:30:00",3701,1050,4751
"2019-09-01 10:10:31","2019-09-02 22:00:00","2019-09-02 22:30:00",3341,934,4275
"2019-09-02 10:10:15","2019-09-02 23:00:00","2019-09-02 23:30:00",2957,790,3747
"2019-09-02 10:10:15","2019-09-03 00:00:00","2019-09-03 00:30:00",2668,658,3326
"2019-09-02 10:10:15","2019-09-03 01:00:00","2019-09-03 01:30:00",2520,607,3127
"2019-09-02 10:10:15","2019-09-03 02:00:00","2019-09-03 02:30:00",2401,570,2971
"2019-09-02 10:10:15","2019-09-03 03:00:00","2019-09-03 03:30:00",2301,547,2848
"2019-09-02 10:10:15","2019-09-03 04:00:00","2019-09-03 04:30:00",2280,546,2826
"2019-09-02 10:10:15","2019-09-03 05:00:00","2019-09-03 05:30:00",2347,553,2900
"2019-09-02 10:10:15","2019-09-03 06:00:00","2019-09-03 06:30:00",2526,614,3140
"2019-09-02 10:10:15","2019-09-03 07:00:00","2019-09-03 07:30:00",2910,734,3644
"2019-09-02 10:10:15","2019-09-03 08:00:00","2019-09-03 08:30:00",3407,911,4318
"2019-09-02 10:10:15","2019-09-03 09:00:00","2019-09-03 09:30:00",3640,978,4618
"2019-09-02 10:10:15","2019-09-03 10:00:00","2019-09-03 10:30:00",3692,996,4688
"2019-09-02 10:10:15","2019-09-03 11:00:00","2019-09-03 11:30:00",3732,986,4718
"2019-09-02 10:10:15","2019-09-03 12:00:00","2019-09-03 12:30:00",3691,999,4690
"2019-09-02 10:10:15","2019-09-03 13:00:00","2019-09-03 13:30:00",3742,991,4733
"2019-09-02 10:10:15","2019-09-03 14:00:00","2019-09-03 14:30:00",3658,970,4628
"2019-09-02 10:10:15","2019-09-03 15:00:00","2019-09-03 15:30:00",3653,955,4608
"2019-09-02 10:10:15","2019-09-03 16:00:00","2019-09-03 16:30:00",3679,980,4659
"2019-09-02 10:10:15","2019-09-03 17:00:00","2019-09-03 17:30:00",3783,1065,4848
"2019-09-02 10:10:15","2019-09-03 18:00:00","2019-09-03 18:30:00",3831,1039,4870
"2019-09-02 10:10:15","2019-09-03 19:00:00","2019-09-03 19:30:00",3646,1001,4647
"2019-09-02 10:10:15","2019-09-03 20:00:00","2019-09-03 20:30:00",3539,969,4508
"2019-09-02 10:10:15","2019-09-03 21:00:00","2019-09-03 21:30:00",3677,1000,4677
"2019-09-02 10:10:15","2019-09-03 22:00:00","2019-09-03 22:30:00",3388,899,4287
"2019-09-03 10:10:36","2019-09-03 23:00:00","2019-09-03 23:30:00",2994,798,3792
"2019-09-03 10:10:36","2019-09-04 00:00:00","2019-09-04 00:30:00",2668,666,3334
"2019-09-03 10:10:36","2019-09-04 01:00:00","2019-09-04 01:30:00",2520,618,3138
"2019-09-03 10:10:36","2019-09-04 02:00:00","2019-09-04 02:30:00",2401,587,2988
"2019-09-03 10:10:36","2019-09-04 03:00:00","2019-09-04 03:30:00",2301,567,2868
"2019-09-03 10:10:36","2019-09-04 04:00:00","2019-09-04 04:30:00",2280,561,2841
"2019-09-03 10:10:36","2019-09-04 05:00:00","2019-09-04 05:30:00",2347,569,2916
"2019-09-03 10:10:36","2019-09-04 06:00:00","2019-09-04 06:30:00",2526,622,3148
"2019-09-03 10:10:36","2019-09-04 07:00:00","2019-09-04 07:30:00",2910,755,3665
"2019-09-03 10:10:36","2019-09-04 08:00:00","2019-09-04 08:30:00",3407,923,4330
"2019-09-03 10:10:36","2019-09-04 09:00:00","2019-09-04 09:30:00",3640,989,4629
"2019-09-03 10:10:36","2019-09-04 10:00:00","2019-09-04 10:30:00",3692,979,4671
"2019-09-03 10:10:36","2019-09-04 11:00:00","2019-09-04 11:30:00",3732,983,4715
"2019-09-03 10:10:36","2019-09-04 12:00:00","2019-09-04 12:30:00",3691,982,4673
"2019-09-03 10:10:36","2019-09-04 13:00:00","2019-09-04 13:30:00",3742,975,4717
"2019-09-03 10:10:36","2019-09-04 14:00:00","2019-09-04 14:30:00",3658,961,4619
"2019-09-03 10:10:36","2019-09-04 15:00:00","2019-09-04 15:30:00",3653,951,4604
"2019-09-03 10:10:36","2019-09-04 16:00:00","2019-09-04 16:30:00",3679,978,4657
"2019-09-03 10:10:36","2019-09-04 17:00:00","2019-09-04 17:30:00",3783,1056,4839
"2019-09-03 10:10:36","2019-09-04 18:00:00","2019-09-04 18:30:00",3831,1045,4876
"2019-09-03 10:10:36","2019-09-04 19:00:00","2019-09-04 19:30:00",3646,1003,4649
"2019-09-03 10:10:36","2019-09-04 20:00:00","2019-09-04 20:30:00",3539,995,4534
"2019-09-03 10:10:36","2019-09-04 21:00:00","2019-09-04 21:30:00",3677,1025,4702
"2019-09-03 10:10:36","2019-09-04 22:00:00","2019-09-04 22:30:00",3388,927,4315
"2019-09-04 10:10:21","2019-09-04 23:00:00","2019-09-04 23:30:00",2994,798,3792
"2019-09-04 10:10:21","2019-09-05 00:00:00","2019-09-05 00:30:00",2693,671,3364
"2019-09-04 10:10:21","2019-09-05 01:00:00","2019-09-05 01:30:00",2543,613,3156
"2019-09-04 10:10:21","2019-09-05 02:00:00","2019-09-05 02:30:00",2422,588,3010
"2019-09-04 10:10:21","2019-09-05 03:00:00","2019-09-05 03:30:00",2321,581,2902
"2019-09-04 10:10:21","2019-09-05 04:00:00","2019-09-05 04:30:00",2300,573,2873
"2019-09-04 10:10:21","2019-09-05 05:00:00","2019-09-05 05:30:00",2367,585,2952
"2019-09-04 10:10:21","2019-09-05 06:00:00","2019-09-05 06:30:00",2549,651,3200
"2019-09-04 10:10:21","2019-09-05 07:00:00","2019-09-05 07:30:00",2938,793,3731
"2019-09-04 10:10:21","2019-09-05 08:00:00","2019-09-05 08:30:00",3441,972,4413
"2019-09-04 10:10:21","2019-09-05 09:00:00","2019-09-05 09:30:00",3677,1010,4687
"2019-09-04 10:10:21","2019-09-05 10:00:00","2019-09-05 10:30:00",3729,1034,4763
"2019-09-04 10:10:21","2019-09-05 11:00:00","2019-09-05 11:30:00",3771,1039,4810
"2019-09-04 10:10:21","2019-09-05 12:00:00","2019-09-05 12:30:00",3729,1020,4749
"2019-09-04 10:10:21","2019-09-05 13:00:00","2019-09-05 13:30:00",3781,1018,4799
"2019-09-04 10:10:21","2019-09-05 14:00:00","2019-09-05 14:30:00",3695,987,4682
"2019-09-04 10:10:21","2019-09-05 15:00:00","2019-09-05 15:30:00",3691,983,4674
"2019-09-04 10:10:21","2019-09-05 16:00:00","2019-09-05 16:30:00",3717,984,4701
"2019-09-04 10:10:21","2019-09-05 17:00:00","2019-09-05 17:30:00",3822,1057,4879
"2019-09-04 10:10:21","2019-09-05 18:00:00","2019-09-05 18:30:00",3871,1110,4981
"2019-09-04 10:10:21","2019-09-05 19:00:00","2019-09-05 19:30:00",3683,1053,4736
"2019-09-04 10:10:21","2019-09-05 20:00:00","2019-09-05 20:30:00",3575,1012,4587
"2019-09-04 10:10:21","2019-09-05 21:00:00","2019-09-05 21:30:00",3714,1028,4742
"2019-09-04 10:10:21","2019-09-05 22:00:00","2019-09-05 22:30:00",3422,903,4325
"2019-09-05 10:10:10","2019-09-05 23:00:00","2019-09-05 23:30:00",3023,777,3800
"2019-09-05 10:10:10","2019-09-06 00:00:00","2019-09-06 00:30:00",2674,630,3304
"2019-09-05 10:10:10","2019-09-06 01:00:00","2019-09-06 01:30:00",2539,563,3102
"2019-09-05 10:10:10","2019-09-06 02:00:00","2019-09-06 02:30:00",2420,544,2964
"2019-09-05 10:10:10","2019-09-06 03:00:00","2019-09-06 03:30:00",2359,519,2878
"2019-09-05 10:10:10","2019-09-06 04:00:00","2019-09-06 04:30:00",2344,512,2856
"2019-09-05 10:10:10","2019-09-06 05:00:00","2019-09-06 05:30:00",2386,517,2903
"2019-09-05 10:10:10","2019-09-06 06:00:00","2019-09-06 06:30:00",2561,583,3144
"2019-09-05 10:10:10","2019-09-06 07:00:00","2019-09-06 07:30:00",2984,719,3703
"2019-09-05 10:10:10","2019-09-06 08:00:00","2019-09-06 08:30:00",3536,912,4448
"2019-09-05 10:10:10","2019-09-06 09:00:00","2019-09-06 09:30:00",3677,1004,4681
"2019-09-05 10:10:10","2019-09-06 10:00:00","2019-09-06 10:30:00",3730,1033,4763
"2019-09-05 10:10:10","2019-09-06 11:00:00","2019-09-06 11:30:00",3707,1047,4754
"2019-09-05 10:10:10","2019-09-06 12:00:00","2019-09-06 12:30:00",3721,1036,4757
"2019-09-05 10:10:10","2019-09-06 13:00:00","2019-09-06 13:30:00",3723,1022,4745
"2019-09-05 10:10:10","2019-09-06 14:00:00","2019-09-06 14:30:00",3684,996,4680
"2019-09-05 10:10:10","2019-09-06 15:00:00","2019-09-06 15:30:00",3626,998,4624
"2019-09-05 10:10:10","2019-09-06 16:00:00","2019-09-06 16:30:00",3609,990,4599
"2019-09-05 10:10:10","2019-09-06 17:00:00","2019-09-06 17:30:00",3671,1071,4742
"2019-09-05 10:10:10","2019-09-06 18:00:00","2019-09-06 18:30:00",3719,1064,4783
"2019-09-05 10:10:10","2019-09-06 19:00:00","2019-09-06 19:30:00",3594,1016,4610
"2019-09-05 10:10:10","2019-09-06 20:00:00","2019-09-06 20:30:00",3504,951,4455
"2019-09-05 10:10:10","2019-09-06 21:00:00","2019-09-06 21:30:00",3524,968,4492
"2019-09-05 10:10:10","2019-09-06 22:00:00","2019-09-06 22:30:00",3285,899,4184
"2019-09-06 10:10:25","2019-09-06 23:00:00","2019-09-06 23:30:00",3014,751,3765
"2019-09-06 10:10:25","2019-09-07 00:00:00","2019-09-07 00:30:00",2785,691,3476
"2019-09-06 10:10:25","2019-09-07 01:00:00","2019-09-07 01:30:00",2639,614,3253
"2019-09-06 10:10:25","2019-09-07 02:00:00","2019-09-07 02:30:00",2517,576,3093
"2019-09-06 10:10:25","2019-09-07 03:00:00","2019-09-07 03:30:00",2422,571,2993
"2019-09-06 10:10:25","2019-09-07 04:00:00","2019-09-07 04:30:00",2328,552,2880
"2019-09-06 10:10:25","2019-09-07 05:00:00","2019-09-07 05:30:00",2393,553,2946
"2019-09-06 10:10:25","2019-09-07 06:00:00","2019-09-07 06:30:00",2415,597,3012
"2019-09-06 10:10:25","2019-09-07 07:00:00","2019-09-07 07:30:00",2499,650,3149
"2019-09-06 10:10:25","2019-09-07 08:00:00","2019-09-07 08:30:00",2825,771,3596
"2019-09-06 10:10:25","2019-09-07 09:00:00","2019-09-07 09:30:00",3089,885,3974
"2019-09-06 10:10:25","2019-09-07 10:00:00","2019-09-07 10:30:00",3246,924,4170
"2019-09-06 10:10:25","2019-09-07 11:00:00","2019-09-07 11:30:00",3327,933,4260
"2019-09-06 10:10:25","2019-09-07 12:00:00","2019-09-07 12:30:00",3301,938,4239
"2019-09-06 10:10:25","2019-09-07 13:00:00","2019-09-07 13:30:00",3292,935,4227
"2019-09-06 10:10:25","2019-09-07 14:00:00","2019-09-07 14:30:00",3185,913,4098
"2019-09-06 10:10:25","2019-09-07 15:00:00","2019-09-07 15:30:00",3133,870,4003
"2019-09-06 10:10:25","2019-09-07 16:00:00","2019-09-07 16:30:00",3151,873,4024
"2019-09-06 10:10:25","2019-09-07 17:00:00","2019-09-07 17:30:00",3213,930,4143
"2019-09-06 10:10:25","2019-09-07 18:00:00","2019-09-07 18:30:00",3355,982,4337
"2019-09-06 10:10:25","2019-09-07 19:00:00","2019-09-07 19:30:00",3251,953,4204
"2019-09-06 10:10:25","2019-09-07 20:00:00","2019-09-07 20:30:00",3098,931,4029
"2019-09-06 10:10:25","2019-09-07 21:00:00","2019-09-07 21:30:00",3235,918,4153
"2019-09-06 10:10:25","2019-09-07 22:00:00","2019-09-07 22:30:00",3012,820,3832
"2019-09-07 10:10:10","2019-09-07 23:00:00","2019-09-07 23:30:00",2755,736,3491
"2019-09-07 10:10:10","2019-09-08 00:00:00","2019-09-08 00:30:00",2596,707,3303
"2019-09-07 10:10:10","2019-09-08 01:00:00","2019-09-08 01:30:00",2435,638,3073
"2019-09-07 10:10:10","2019-09-08 02:00:00","2019-09-08 02:30:00",2312,606,2918
"2019-09-07 10:10:10","2019-09-08 03:00:00","2019-09-08 03:30:00",2229,589,2818
"2019-09-07 10:10:10","2019-09-08 04:00:00","2019-09-08 04:30:00",2186,567,2753
"2019-09-07 10:10:10","2019-09-08 05:00:00","2019-09-08 05:30:00",2201,566,2767
"2019-09-07 10:10:10","2019-09-08 06:00:00","2019-09-08 06:30:00",2238,581,2819
"2019-09-07 10:10:10","2019-09-08 07:00:00","2019-09-08 07:30:00",2254,606,2860
"2019-09-07 10:10:10","2019-09-08 08:00:00","2019-09-08 08:30:00",2424,679,3103
"2019-09-07 10:10:10","2019-09-08 09:00:00","2019-09-08 09:30:00",2720,786,3506
"2019-09-07 10:10:10","2019-09-08 10:00:00","2019-09-08 10:30:00",3023,867,3890
"2019-09-07 10:10:10","2019-09-08 11:00:00","2019-09-08 11:30:00",3187,906,4093
"2019-09-07 10:10:10","2019-09-08 12:00:00","2019-09-08 12:30:00",3269,927,4196
"2019-09-07 10:10:10","2019-09-08 13:00:00","2019-09-08 13:30:00",3282,952,4234
"2019-09-07 10:10:10","2019-09-08 14:00:00","2019-09-08 14:30:00",3185,890,4075
"2019-09-07 10:10:10","2019-09-08 15:00:00","2019-09-08 15:30:00",3126,862,3988
"2019-09-07 10:10:10","2019-09-08 16:00:00","2019-09-08 16:30:00",3063,873,3936
"2019-09-07 10:10:10","2019-09-08 17:00:00","2019-09-08 17:30:00",3039,938,3977
"2019-09-07 10:10:10","2019-09-08 18:00:00","2019-09-08 18:30:00",3209,979,4188
"2019-09-07 10:10:10","2019-09-08 19:00:00","2019-09-08 19:30:00",3210,958,4168
"2019-09-07 10:10:10","2019-09-08 20:00:00","2019-09-08 20:30:00",3206,1037,4243
"2019-09-07 10:10:10","2019-09-08 21:00:00","2019-09-08 21:30:00",3266,1001,4267
"2019-09-07 10:10:10","2019-09-08 22:00:00","2019-09-08 22:30:00",2970,894,3864
"2019-09-08 10:10:30","2019-09-08 23:00:00","2019-09-08 23:30:00",2733,667,3400
"2019-09-08 10:10:30","2019-09-09 00:00:00","2019-09-09 00:30:00",2430,599,3029
"2019-09-08 10:10:30","2019-09-09 01:00:00","2019-09-09 01:30:00",2298,547,2845
"2019-09-08 10:10:30","2019-09-09 02:00:00","2019-09-09 02:30:00",2194,521,2715
"2019-09-08 10:10:30","2019-09-09 03:00:00","2019-09-09 03:30:00",2156,522,2678
"2019-09-08 10:10:30","2019-09-09 04:00:00","2019-09-09 04:30:00",2133,512,2645
"2019-09-08 10:10:30","2019-09-09 05:00:00","2019-09-09 05:30:00",2190,520,2710
"2019-09-08 10:10:30","2019-09-09 06:00:00","2019-09-09 06:30:00",2411,599,3010
"2019-09-08 10:10:30","2019-09-09 07:00:00","2019-09-09 07:30:00",2819,766,3585
"2019-09-08 10:10:30","2019-09-09 08:00:00","2019-09-09 08:30:00",3353,977,4330
"2019-09-08 10:10:30","2019-09-09 09:00:00","2019-09-09 09:30:00",3513,1041,4554
"2019-09-08 10:10:30","2019-09-09 10:00:00","2019-09-09 10:30:00",3571,1067,4638
"2019-09-08 10:10:30","2019-09-09 11:00:00","2019-09-09 11:30:00",3629,1080,4709
"2019-09-08 10:10:30","2019-09-09 12:00:00","2019-09-09 12:30:00",3635,1086,4721
"2019-09-08 10:10:30","2019-09-09 13:00:00","2019-09-09 13:30:00",3677,1102,4779
"2019-09-08 10:10:30","2019-09-09 14:00:00","2019-09-09 14:30:00",3584,1055,4639
"2019-09-08 10:10:30","2019-09-09 15:00:00","2019-09-09 15:30:00",3604,1038,4642
"2019-09-08 10:10:30","2019-09-09 16:00:00","2019-09-09 16:30:00",3656,1069,4725
"2019-09-08 10:10:30","2019-09-09 17:00:00","2019-09-09 17:30:00",3792,1144,4936
"2019-09-08 10:10:30","2019-09-09 18:00:00","2019-09-09 18:30:00",3749,1127,4876
"2019-09-08 10:10:30","2019-09-09 19:00:00","2019-09-09 19:30:00",3562,1016,4578
"2019-09-08 10:10:30","2019-09-09 20:00:00","2019-09-09 20:30:00",3477,974,4451
"2019-09-08 10:10:30","2019-09-09 21:00:00","2019-09-09 21:30:00",3593,1022,4615
"2019-09-08 10:10:30","2019-09-09 22:00:00","2019-09-09 22:30:00",3274,909,4183
"2019-09-09 10:10:15","2019-09-09 23:00:00","2019-09-09 23:30:00",2893,823,3716
"2019-09-09 10:10:15","2019-09-10 00:00:00","2019-09-10 00:30:00",2625,676,3301
"2019-09-09 10:10:15","2019-09-10 01:00:00","2019-09-10 01:30:00",2504,617,3121
"2019-09-09 10:10:15","2019-09-10 02:00:00","2019-09-10 02:30:00",2398,596,2994
"2019-09-09 10:10:15","2019-09-10 03:00:00","2019-09-10 03:30:00",2322,589,2911
"2019-09-09 10:10:15","2019-09-10 04:00:00","2019-09-10 04:30:00",2300,577,2877
"2019-09-09 10:10:15","2019-09-10 05:00:00","2019-09-10 05:30:00",2306,599,2905
"2019-09-09 10:10:15","2019-09-10 06:00:00","2019-09-10 06:30:00",2492,677,3169
"2019-09-09 10:10:15","2019-09-10 07:00:00","2019-09-10 07:30:00",2963,818,3781
"2019-09-09 10:10:15","2019-09-10 08:00:00","2019-09-10 08:30:00",3490,995,4485
"2019-09-09 10:10:15","2019-09-10 09:00:00","2019-09-10 09:30:00",3619,1054,4673
"2019-09-09 10:10:15","2019-09-10 10:00:00","2019-09-10 10:30:00",3701,1081,4782
"2019-09-09 10:10:15","2019-09-10 11:00:00","2019-09-10 11:30:00",3657,1049,4706
"2019-09-09 10:10:15","2019-09-10 12:00:00","2019-09-10 12:30:00",3641,1045,4686
"2019-09-09 10:10:15","2019-09-10 13:00:00","2019-09-10 13:30:00",3677,1011,4688
"2019-09-09 10:10:15","2019-09-10 14:00:00","2019-09-10 14:30:00",3595,968,4563
"2019-09-09 10:10:15","2019-09-10 15:00:00","2019-09-10 15:30:00",3603,948,4551
"2019-09-09 10:10:15","2019-09-10 16:00:00","2019-09-10 16:30:00",3653,969,4622
"2019-09-09 10:10:15","2019-09-10 17:00:00","2019-09-10 17:30:00",3783,1084,4867
"2019-09-09 10:10:15","2019-09-10 18:00:00","2019-09-10 18:30:00",3900,1052,4952
"2019-09-09 10:10:15","2019-09-10 19:00:00","2019-09-10 19:30:00",3781,996,4777
"2019-09-09 10:10:15","2019-09-10 20:00:00","2019-09-10 20:30:00",3790,1012,4802
"2019-09-09 10:10:15","2019-09-10 21:00:00","2019-09-10 21:30:00",3746,1021,4767
"2019-09-09 10:10:15","2019-09-10 22:00:00","2019-09-10 22:30:00",3345,865,4210
"2019-09-10 10:10:30","2019-09-10 23:00:00","2019-09-10 23:30:00",2932,725,3657
"2019-09-10 10:10:30","2019-09-11 00:00:00","2019-09-11 00:30:00",2625,621,3246
"2019-09-10 10:10:30","2019-09-11 01:00:00","2019-09-11 01:30:00",2504,566,3070
"2019-09-10 10:10:30","2019-09-11 02:00:00","2019-09-11 02:30:00",2398,546,2944
"2019-09-10 10:10:30","2019-09-11 03:00:00","2019-09-11 03:30:00",2322,542,2864
"2019-09-10 10:10:30","2019-09-11 04:00:00","2019-09-11 04:30:00",2300,524,2824
"2019-09-10 10:10:30","2019-09-11 05:00:00","2019-09-11 05:30:00",2306,548,2854
"2019-09-10 10:10:30","2019-09-11 06:00:00","2019-09-11 06:30:00",2492,633,3125
"2019-09-10 10:10:30","2019-09-11 07:00:00","2019-09-11 07:30:00",2963,768,3731
"2019-09-10 10:10:30","2019-09-11 08:00:00","2019-09-11 08:30:00",3490,937,4427
"2019-09-10 10:10:30","2019-09-11 09:00:00","2019-09-11 09:30:00",3619,990,4609
"2019-09-10 10:10:30","2019-09-11 10:00:00","2019-09-11 10:30:00",3701,1020,4721
"2019-09-10 10:10:30","2019-09-11 11:00:00","2019-09-11 11:30:00",3657,995,4652
"2019-09-10 10:10:30","2019-09-11 12:00:00","2019-09-11 12:30:00",3641,1003,4644
"2019-09-10 10:10:30","2019-09-11 13:00:00","2019-09-11 13:30:00",3677,983,4660
"2019-09-10 10:10:30","2019-09-11 14:00:00","2019-09-11 14:30:00",3595,945,4540
"2019-09-10 10:10:30","2019-09-11 15:00:00","2019-09-11 15:30:00",3603,920,4523
"2019-09-10 10:10:30","2019-09-11 16:00:00","2019-09-11 16:30:00",3653,950,4603
"2019-09-10 10:10:30","2019-09-11 17:00:00","2019-09-11 17:30:00",3783,1064,4847
"2019-09-10 10:10:30","2019-09-11 18:00:00","2019-09-11 18:30:00",3900,1048,4948
"2019-09-10 10:10:30","2019-09-11 19:00:00","2019-09-11 19:30:00",3781,1001,4782
"2019-09-10 10:10:30","2019-09-11 20:00:00","2019-09-11 20:30:00",3790,1023,4813
"2019-09-10 10:10:30","2019-09-11 21:00:00","2019-09-11 21:30:00",3746,1043,4789
"2019-09-10 10:10:30","2019-09-11 22:00:00","2019-09-11 22:30:00",3345,907,4252
"2019-09-11 10:10:21","2019-09-11 23:00:00","2019-09-11 23:30:00",2932,790,3722
"2019-09-11 10:10:21","2019-09-12 00:00:00","2019-09-12 00:30:00",2625,657,3282
"2019-09-11 10:10:21","2019-09-12 01:00:00","2019-09-12 01:30:00",2504,598,3102
"2019-09-11 10:10:21","2019-09-12 02:00:00","2019-09-12 02:30:00",2398,572,2970
"2019-09-11 10:10:21","2019-09-12 03:00:00","2019-09-12 03:30:00",2322,572,2894
"2019-09-11 10:10:21","2019-09-12 04:00:00","2019-09-12 04:30:00",2300,562,2862
"2019-09-11 10:10:21","2019-09-12 05:00:00","2019-09-12 05:30:00",2306,575,2881
"2019-09-11 10:10:21","2019-09-12 06:00:00","2019-09-12 06:30:00",2492,651,3143
"2019-09-11 10:10:21","2019-09-12 07:00:00","2019-09-12 07:30:00",2963,789,3752
"2019-09-11 10:10:21","2019-09-12 08:00:00","2019-09-12 08:30:00",3490,971,4461
"2019-09-11 10:10:21","2019-09-12 09:00:00","2019-09-12 09:30:00",3619,1001,4620
"2019-09-11 10:10:21","2019-09-12 10:00:00","2019-09-12 10:30:00",3701,1018,4719
"2019-09-11 10:10:21","2019-09-12 11:00:00","2019-09-12 11:30:00",3657,1013,4670
"2019-09-11 10:10:21","2019-09-12 12:00:00","2019-09-12 12:30:00",3641,998,4639
"2019-09-11 10:10:21","2019-09-12 13:00:00","2019-09-12 13:30:00",3677,993,4670
"2019-09-11 10:10:21","2019-09-12 14:00:00","2019-09-12 14:30:00",3595,943,4538
"2019-09-11 10:10:21","2019-09-12 15:00:00","2019-09-12 15:30:00",3603,930,4533
"2019-09-11 10:10:21","2019-09-12 16:00:00","2019-09-12 16:30:00",3653,957,4610
"2019-09-11 10:10:21","2019-09-12 17:00:00","2019-09-12 17:30:00",3783,1067,4850
"2019-09-11 10:10:21","2019-09-12 18:00:00","2019-09-12 18:30:00",3900,1055,4955
"2019-09-11 10:10:21","2019-09-12 19:00:00","2019-09-12 19:30:00",3781,1012,4793
"2019-09-11 10:10:21","2019-09-12 20:00:00","2019-09-12 20:30:00",3790,1028,4818
"2019-09-11 10:10:21","2019-09-12 21:00:00","2019-09-12 21:30:00",3746,1029,4775
"2019-09-11 10:10:21","2019-09-12 22:00:00","2019-09-12 22:30:00",3345,901,4246
"2019-09-12 10:10:36","2019-09-12 23:00:00","2019-09-12 23:30:00",2932,770,3702
"2019-09-12 10:10:36","2019-09-13 00:00:00","2019-09-13 00:30:00",2641,650,3291
"2019-09-12 10:10:36","2019-09-13 01:00:00","2019-09-13 01:30:00",2518,586,3104
"2019-09-12 10:10:36","2019-09-13 02:00:00","2019-09-13 02:30:00",2421,575,2996
"2019-09-12 10:10:36","2019-09-13 03:00:00","2019-09-13 03:30:00",2354,554,2908
"2019-09-12 10:10:36","2019-09-13 04:00:00","2019-09-13 04:30:00",2330,543,2873
"2019-09-12 10:10:36","2019-09-13 05:00:00","2019-09-13 05:30:00",2396,583,2979
"2019-09-12 10:10:36","2019-09-13 06:00:00","2019-09-13 06:30:00",2577,649,3226
"2019-09-12 10:10:36","2019-09-13 07:00:00","2019-09-13 07:30:00",3018,805,3823
"2019-09-12 10:10:36","2019-09-13 08:00:00","2019-09-13 08:30:00",3538,992,4530
"2019-09-12 10:10:36","2019-09-13 09:00:00","2019-09-13 09:30:00",3671,1051,4722
"2019-09-12 10:10:36","2019-09-13 10:00:00","2019-09-13 10:30:00",3729,1039,4768
"2019-09-12 10:10:36","2019-09-13 11:00:00","2019-09-13 11:30:00",3703,1022,4725
"2019-09-12 10:10:36","2019-09-13 12:00:00","2019-09-13 12:30:00",3726,986,4712
"2019-09-12 10:10:36","2019-09-13 13:00:00","2019-09-13 13:30:00",3688,969,4657
"2019-09-12 10:10:36","2019-09-13 14:00:00","2019-09-13 14:30:00",3595,905,4500
"2019-09-12 10:10:36","2019-09-13 15:00:00","2019-09-13 15:30:00",3594,907,4501
"2019-09-12 10:10:36","2019-09-13 16:00:00","2019-09-13 16:30:00",3629,941,4570
"2019-09-12 10:10:36","2019-09-13 17:00:00","2019-09-13 17:30:00",3686,1000,4686
"2019-09-12 10:10:36","2019-09-13 18:00:00","2019-09-13 18:30:00",3681,1015,4696
"2019-09-12 10:10:36","2019-09-13 19:00:00","2019-09-13 19:30:00",3563,984,4547
"2019-09-12 10:10:36","2019-09-13 20:00:00","2019-09-13 20:30:00",3608,957,4565
"2019-09-12 10:10:36","2019-09-13 21:00:00","2019-09-13 21:30:00",3572,1006,4578
"2019-09-12 10:10:36","2019-09-13 22:00:00","2019-09-13 22:30:00",3277,896,4173
"2019-09-13 10:10:25","2019-09-13 23:00:00","2019-09-13 23:30:00",2971,801,3772
"2019-09-13 10:10:25","2019-09-14 00:00:00","2019-09-14 00:30:00",2683,674,3357
"2019-09-13 10:10:25","2019-09-14 01:00:00","2019-09-14 01:30:00",2530,617,3147
"2019-09-13 10:10:25","2019-09-14 02:00:00","2019-09-14 02:30:00",2352,584,2936
"2019-09-13 10:10:25","2019-09-14 03:00:00","2019-09-14 03:30:00",2308,565,2873
"2019-09-13 10:10:25","2019-09-14 04:00:00","2019-09-14 04:30:00",2274,547,2821
"2019-09-13 10:10:25","2019-09-14 05:00:00","2019-09-14 05:30:00",2277,553,2830
"2019-09-13 10:10:25","2019-09-14 06:00:00","2019-09-14 06:30:00",2380,581,2961
"2019-09-13 10:10:25","2019-09-14 07:00:00","2019-09-14 07:30:00",2521,619,3140
"2019-09-13 10:10:25","2019-09-14 08:00:00","2019-09-14 08:30:00",2835,740,3575
"2019-09-13 10:10:25","2019-09-14 09:00:00","2019-09-14 09:30:00",3190,840,4030
"2019-09-13 10:10:25","2019-09-14 10:00:00","2019-09-14 10:30:00",3346,879,4225
"2019-09-13 10:10:25","2019-09-14 11:00:00","2019-09-14 11:30:00",3385,871,4256
"2019-09-13 10:10:25","2019-09-14 12:00:00","2019-09-14 12:30:00",3384,849,4233
"2019-09-13 10:10:25","2019-09-14 13:00:00","2019-09-14 13:30:00",3388,824,4212
"2019-09-13 10:10:25","2019-09-14 14:00:00","2019-09-14 14:30:00",3259,793,4052
"2019-09-13 10:10:25","2019-09-14 15:00:00","2019-09-14 15:30:00",3225,774,3999
"2019-09-13 10:10:25","2019-09-14 16:00:00","2019-09-14 16:30:00",3195,779,3974
"2019-09-13 10:10:25","2019-09-14 17:00:00","2019-09-14 17:30:00",3340,833,4173
"2019-09-13 10:10:25","2019-09-14 18:00:00","2019-09-14 18:30:00",3474,889,4363
"2019-09-13 10:10:25","2019-09-14 19:00:00","2019-09-14 19:30:00",3400,857,4257
"2019-09-13 10:10:25","2019-09-14 20:00:00","2019-09-14 20:30:00",3519,835,4354
"2019-09-13 10:10:25","2019-09-14 21:00:00","2019-09-14 21:30:00",3396,876,4272
"2019-09-13 10:10:25","2019-09-14 22:00:00","2019-09-14 22:30:00",3121,819,3940
"2019-09-14 10:10:10","2019-09-14 23:00:00","2019-09-14 23:30:00",2850,755,3605
"2019-09-14 10:10:10","2019-09-15 00:00:00","2019-09-15 00:30:00",2608,688,3296
"2019-09-14 10:10:10","2019-09-15 01:00:00","2019-09-15 01:30:00",2521,625,3146
"2019-09-14 10:10:10","2019-09-15 02:00:00","2019-09-15 02:30:00",2379,582,2961
"2019-09-14 10:10:10","2019-09-15 03:00:00","2019-09-15 03:30:00",2308,571,2879
"2019-09-14 10:10:10","2019-09-15 04:00:00","2019-09-15 04:30:00",2259,548,2807
"2019-09-14 10:10:10","2019-09-15 05:00:00","2019-09-15 05:30:00",2242,552,2794
"2019-09-14 10:10:10","2019-09-15 06:00:00","2019-09-15 06:30:00",2210,570,2780
"2019-09-14 10:10:10","2019-09-15 07:00:00","2019-09-15 07:30:00",2280,609,2889
"2019-09-14 10:10:10","2019-09-15 08:00:00","2019-09-15 08:30:00",2481,674,3155
"2019-09-14 10:10:10","2019-09-15 09:00:00","2019-09-15 09:30:00",2889,789,3678
"2019-09-14 10:10:10","2019-09-15 10:00:00","2019-09-15 10:30:00",3076,895,3971
"2019-09-14 10:10:10","2019-09-15 11:00:00","2019-09-15 11:30:00",3220,957,4177
"2019-09-14 10:10:10","2019-09-15 12:00:00","2019-09-15 12:30:00",3278,1020,4298
"2019-09-14 10:10:10","2019-09-15 13:00:00","2019-09-15 13:30:00",3320,1043,4363
"2019-09-14 10:10:10","2019-09-15 14:00:00","2019-09-15 14:30:00",3206,989,4195
"2019-09-14 10:10:10","2019-09-15 15:00:00","2019-09-15 15:30:00",3111,955,4066
"2019-09-14 10:10:10","2019-09-15 16:00:00","2019-09-15 16:30:00",3056,947,4003
"2019-09-14 10:10:10","2019-09-15 17:00:00","2019-09-15 17:30:00",3141,971,4112
"2019-09-14 10:10:10","2019-09-15 18:00:00","2019-09-15 18:30:00",3243,984,4227
"2019-09-14 10:10:10","2019-09-15 19:00:00","2019-09-15 19:30:00",3244,939,4183
"2019-09-14 10:10:10","2019-09-15 20:00:00","2019-09-15 20:30:00",3404,1018,4422
"2019-09-14 10:10:10","2019-09-15 21:00:00","2019-09-15 21:30:00",3324,995,4319
"2019-09-14 10:10:10","2019-09-15 22:00:00","2019-09-15 22:30:00",2986,898,3884
"2019-09-15 10:10:26","2019-09-15 23:00:00","2019-09-15 23:30:00",2647,769,3416
"2019-09-15 10:10:26","2019-09-16 00:00:00","2019-09-16 00:30:00",2479,649,3128
"2019-09-15 10:10:26","2019-09-16 01:00:00","2019-09-16 01:30:00",2373,600,2973
"2019-09-15 10:10:26","2019-09-16 02:00:00","2019-09-16 02:30:00",2280,579,2859
"2019-09-15 10:10:26","2019-09-16 03:00:00","2019-09-16 03:30:00",2228,577,2805
"2019-09-15 10:10:26","2019-09-16 04:00:00","2019-09-16 04:30:00",2202,578,2780
"2019-09-15 10:10:26","2019-09-16 05:00:00","2019-09-16 05:30:00",2283,589,2872
"2019-09-15 10:10:26","2019-09-16 06:00:00","2019-09-16 06:30:00",2494,663,3157
"2019-09-15 10:10:26","2019-09-16 07:00:00","2019-09-16 07:30:00",2929,803,3732
"2019-09-15 10:10:26","2019-09-16 08:00:00","2019-09-16 08:30:00",3390,979,4369
"2019-09-15 10:10:26","2019-09-16 09:00:00","2019-09-16 09:30:00",3524,1024,4548
"2019-09-15 10:10:26","2019-09-16 10:00:00","2019-09-16 10:30:00",3497,1039,4536
"2019-09-15 10:10:26","2019-09-16 11:00:00","2019-09-16 11:30:00",3585,1019,4604
"2019-09-15 10:10:26","2019-09-16 12:00:00","2019-09-16 12:30:00",3582,1016,4598
"2019-09-15 10:10:26","2019-09-16 13:00:00","2019-09-16 13:30:00",3666,1009,4675
"2019-09-15 10:10:26","2019-09-16 14:00:00","2019-09-16 14:30:00",3628,954,4582
"2019-09-15 10:10:26","2019-09-16 15:00:00","2019-09-16 15:30:00",3619,929,4548
"2019-09-15 10:10:26","2019-09-16 16:00:00","2019-09-16 16:30:00",3739,965,4704
"2019-09-15 10:10:26","2019-09-16 17:00:00","2019-09-16 17:30:00",3857,1069,4926
"2019-09-15 10:10:26","2019-09-16 18:00:00","2019-09-16 18:30:00",3868,1040,4908
"2019-09-15 10:10:26","2019-09-16 19:00:00","2019-09-16 19:30:00",3776,980,4756
"2019-09-15 10:10:26","2019-09-16 20:00:00","2019-09-16 20:30:00",3809,963,4772
"2019-09-15 10:10:26","2019-09-16 21:00:00","2019-09-16 21:30:00",3645,1015,4660
"2019-09-15 10:10:26","2019-09-16 22:00:00","2019-09-16 22:30:00",3304,901,4205
"2019-09-16 10:10:16","2019-09-16 23:00:00","2019-09-16 23:30:00",2928,842,3770
"2019-09-16 10:10:16","2019-09-17 00:00:00","2019-09-17 00:30:00",2611,691,3302
"2019-09-16 10:10:16","2019-09-17 01:00:00","2019-09-17 01:30:00",2483,630,3113
"2019-09-16 10:10:16","2019-09-17 02:00:00","2019-09-17 02:30:00",2351,604,2955
"2019-09-16 10:10:16","2019-09-17 03:00:00","2019-09-17 03:30:00",2304,592,2896
"2019-09-16 10:10:16","2019-09-17 04:00:00","2019-09-17 04:30:00",2300,586,2886
"2019-09-16 10:10:16","2019-09-17 05:00:00","2019-09-17 05:30:00",2371,601,2972
"2019-09-16 10:10:16","2019-09-17 06:00:00","2019-09-17 06:30:00",2577,688,3265
"2019-09-16 10:10:16","2019-09-17 07:00:00","2019-09-17 07:30:00",3066,865,3931
"2019-09-16 10:10:16","2019-09-17 08:00:00","2019-09-17 08:30:00",3524,1039,4563
"2019-09-16 10:10:16","2019-09-17 09:00:00","2019-09-17 09:30:00",3638,1096,4734
"2019-09-16 10:10:16","2019-09-17 10:00:00","2019-09-17 10:30:00",3679,1130,4809
"2019-09-16 10:10:16","2019-09-17 11:00:00","2019-09-17 11:30:00",3682,1087,4769
"2019-09-16 10:10:16","2019-09-17 12:00:00","2019-09-17 12:30:00",3701,1064,4765
"2019-09-16 10:10:16","2019-09-17 13:00:00","2019-09-17 13:30:00",3756,1044,4800
"2019-09-16 10:10:16","2019-09-17 14:00:00","2019-09-17 14:30:00",3656,996,4652
"2019-09-16 10:10:16","2019-09-17 15:00:00","2019-09-17 15:30:00",3690,966,4656
"2019-09-16 10:10:16","2019-09-17 16:00:00","2019-09-17 16:30:00",3736,987,4723
"2019-09-16 10:10:16","2019-09-17 17:00:00","2019-09-17 17:30:00",3873,1091,4964
"2019-09-16 10:10:16","2019-09-17 18:00:00","2019-09-17 18:30:00",3835,1091,4926
"2019-09-16 10:10:16","2019-09-17 19:00:00","2019-09-17 19:30:00",3732,1038,4770
"2019-09-16 10:10:16","2019-09-17 20:00:00","2019-09-17 20:30:00",3881,1053,4934
"2019-09-16 10:10:16","2019-09-17 21:00:00","2019-09-17 21:30:00",3752,1066,4818
"2019-09-16 10:10:16","2019-09-17 22:00:00","2019-09-17 22:30:00",3368,929,4297
"2019-09-17 10:10:30","2019-09-17 23:00:00","2019-09-17 23:30:00",3006,842,3848
"2019-09-17 10:10:30","2019-09-18 00:00:00","2019-09-18 00:30:00",2650,714,3364
"2019-09-17 10:10:30","2019-09-18 01:00:00","2019-09-18 01:30:00",2492,650,3142
"2019-09-17 10:10:30","2019-09-18 02:00:00","2019-09-18 02:30:00",2401,624,3025
"2019-09-17 10:10:30","2019-09-18 03:00:00","2019-09-18 03:30:00",2346,613,2959
"2019-09-17 10:10:30","2019-09-18 04:00:00","2019-09-18 04:30:00",2345,606,2951
"2019-09-17 10:10:30","2019-09-18 05:00:00","2019-09-18 05:30:00",2399,622,3021
"2019-09-17 10:10:30","2019-09-18 06:00:00","2019-09-18 06:30:00",2571,700,3271
"2019-09-17 10:10:30","2019-09-18 07:00:00","2019-09-18 07:30:00",3045,873,3918
"2019-09-17 10:10:30","2019-09-18 08:00:00","2019-09-18 08:30:00",3527,1060,4587
"2019-09-17 10:10:30","2019-09-18 09:00:00","2019-09-18 09:30:00",3664,1101,4765
"2019-09-17 10:10:30","2019-09-18 10:00:00","2019-09-18 10:30:00",3715,1100,4815
"2019-09-17 10:10:30","2019-09-18 11:00:00","2019-09-18 11:30:00",3724,1091,4815
"2019-09-17 10:10:30","2019-09-18 12:00:00","2019-09-18 12:30:00",3750,1082,4832
"2019-09-17 10:10:30","2019-09-18 13:00:00","2019-09-18 13:30:00",3764,1055,4819
"2019-09-17 10:10:30","2019-09-18 14:00:00","2019-09-18 14:30:00",3692,1000,4692
"2019-09-17 10:10:30","2019-09-18 15:00:00","2019-09-18 15:30:00",3715,992,4707
"2019-09-17 10:10:30","2019-09-18 16:00:00","2019-09-18 16:30:00",3735,1050,4785
"2019-09-17 10:10:30","2019-09-18 17:00:00","2019-09-18 17:30:00",3875,1160,5035
"2019-09-17 10:10:30","2019-09-18 18:00:00","2019-09-18 18:30:00",3915,1135,5050
"2019-09-17 10:10:30","2019-09-18 19:00:00","2019-09-18 19:30:00",3776,1080,4856
"2019-09-17 10:10:30","2019-09-18 20:00:00","2019-09-18 20:30:00",3804,1118,4922
"2019-09-17 10:10:30","2019-09-18 21:00:00","2019-09-18 21:30:00",3728,1074,4802
"2019-09-17 10:10:30","2019-09-18 22:00:00","2019-09-18 22:30:00",3371,937,4308
"2019-09-18 10:10:15","2019-09-18 23:00:00","2019-09-18 23:30:00",3007,804,3811
"2019-09-18 10:10:15","2019-09-19 00:00:00","2019-09-19 00:30:00",2666,694,3360
"2019-09-18 10:10:15","2019-09-19 01:00:00","2019-09-19 01:30:00",2527,632,3159
"2019-09-18 10:10:15","2019-09-19 02:00:00","2019-09-19 02:30:00",2413,605,3018
"2019-09-18 10:10:15","2019-09-19 03:00:00","2019-09-19 03:30:00",2353,595,2948
"2019-09-18 10:10:15","2019-09-19 04:00:00","2019-09-19 04:30:00",2348,592,2940
"2019-09-18 10:10:15","2019-09-19 05:00:00","2019-09-19 05:30:00",2412,604,3016
"2019-09-18 10:10:15","2019-09-19 06:00:00","2019-09-19 06:30:00",2583,680,3263
"2019-09-18 10:10:15","2019-09-19 07:00:00","2019-09-19 07:30:00",3062,856,3918
"2019-09-18 10:10:15","2019-09-19 08:00:00","2019-09-19 08:30:00",3554,1050,4604
"2019-09-18 10:10:15","2019-09-19 09:00:00","2019-09-19 09:30:00",3680,1078,4758
"2019-09-18 10:10:15","2019-09-19 10:00:00","2019-09-19 10:30:00",3702,1091,4793
"2019-09-18 10:10:15","2019-09-19 11:00:00","2019-09-19 11:30:00",3693,1049,4742
"2019-09-18 10:10:15","2019-09-19 12:00:00","2019-09-19 12:30:00",3697,1038,4735
"2019-09-18 10:10:15","2019-09-19 13:00:00","2019-09-19 13:30:00",3701,1004,4705
"2019-09-18 10:10:15","2019-09-19 14:00:00","2019-09-19 14:30:00",3625,972,4597
"2019-09-18 10:10:15","2019-09-19 15:00:00","2019-09-19 15:30:00",3623,937,4560
"2019-09-18 10:10:15","2019-09-19 16:00:00","2019-09-19 16:30:00",3656,980,4636
"2019-09-18 10:10:15","2019-09-19 17:00:00","2019-09-19 17:30:00",3801,1066,4867
"2019-09-18 10:10:15","2019-09-19 18:00:00","2019-09-19 18:30:00",3841,1058,4899
"2019-09-18 10:10:15","2019-09-19 19:00:00","2019-09-19 19:30:00",3721,1005,4726
"2019-09-18 10:10:15","2019-09-19 20:00:00","2019-09-19 20:30:00",3844,1029,4873
"2019-09-18 10:10:15","2019-09-19 21:00:00","2019-09-19 21:30:00",3808,1035,4843
"2019-09-18 10:10:15","2019-09-19 22:00:00","2019-09-19 22:30:00",3409,914,4323
"2019-09-19 10:10:40","2019-09-19 23:00:00","2019-09-19 23:30:00",3007,809,3816
"2019-09-19 10:10:40","2019-09-20 00:00:00","2019-09-20 00:30:00",2700,682,3382
"2019-09-19 10:10:40","2019-09-20 01:00:00","2019-09-20 01:30:00",2548,609,3157
"2019-09-19 10:10:40","2019-09-20 02:00:00","2019-09-20 02:30:00",2425,597,3022
"2019-09-19 10:10:40","2019-09-20 03:00:00","2019-09-20 03:30:00",2364,583,2947
"2019-09-19 10:10:40","2019-09-20 04:00:00","2019-09-20 04:30:00",2350,572,2922
"2019-09-19 10:10:40","2019-09-20 05:00:00","2019-09-20 05:30:00",2416,591,3007
"2019-09-19 10:10:40","2019-09-20 06:00:00","2019-09-20 06:30:00",2580,657,3237
"2019-09-19 10:10:40","2019-09-20 07:00:00","2019-09-20 07:30:00",3020,809,3829
"2019-09-19 10:10:40","2019-09-20 08:00:00","2019-09-20 08:30:00",3548,987,4535
"2019-09-19 10:10:40","2019-09-20 09:00:00","2019-09-20 09:30:00",3679,1010,4689
"2019-09-19 10:10:40","2019-09-20 10:00:00","2019-09-20 10:30:00",3705,984,4689
"2019-09-19 10:10:40","2019-09-20 11:00:00","2019-09-20 11:30:00",3692,981,4673
"2019-09-19 10:10:40","2019-09-20 12:00:00","2019-09-20 12:30:00",3671,939,4610
"2019-09-19 10:10:40","2019-09-20 13:00:00","2019-09-20 13:30:00",3654,913,4567
"2019-09-19 10:10:40","2019-09-20 14:00:00","2019-09-20 14:30:00",3573,869,4442
"2019-09-19 10:10:40","2019-09-20 15:00:00","2019-09-20 15:30:00",3572,867,4439
"2019-09-19 10:10:40","2019-09-20 16:00:00","2019-09-20 16:30:00",3587,879,4466
"2019-09-19 10:10:40","2019-09-20 17:00:00","2019-09-20 17:30:00",3644,961,4605
"2019-09-19 10:10:40","2019-09-20 18:00:00","2019-09-20 18:30:00",3666,983,4649
"2019-09-19 10:10:40","2019-09-20 19:00:00","2019-09-20 19:30:00",3523,938,4461
"2019-09-19 10:10:40","2019-09-20 20:00:00","2019-09-20 20:30:00",3559,958,4517
"2019-09-19 10:10:40","2019-09-20 21:00:00","2019-09-20 21:30:00",3625,960,4585
"2019-09-19 10:10:40","2019-09-20 22:00:00","2019-09-20 22:30:00",3323,856,4179
"2019-09-20 10:10:20","2019-09-20 23:00:00","2019-09-20 23:30:00",2995,750,3745
"2019-09-20 10:10:20","2019-09-21 00:00:00","2019-09-21 00:30:00",2677,627,3304
"2019-09-20 10:10:20","2019-09-21 01:00:00","2019-09-21 01:30:00",2535,557,3092
"2019-09-20 10:10:20","2019-09-21 02:00:00","2019-09-21 02:30:00",2403,518,2921
"2019-09-20 10:10:20","2019-09-21 03:00:00","2019-09-21 03:30:00",2324,515,2839
"2019-09-20 10:10:20","2019-09-21 04:00:00","2019-09-21 04:30:00",2326,509,2835
"2019-09-20 10:10:20","2019-09-21 05:00:00","2019-09-21 05:30:00",2333,515,2848
"2019-09-20 10:10:20","2019-09-21 06:00:00","2019-09-21 06:30:00",2414,541,2955
"2019-09-20 10:10:20","2019-09-21 07:00:00","2019-09-21 07:30:00",2578,586,3164
"2019-09-20 10:10:20","2019-09-21 08:00:00","2019-09-21 08:30:00",2843,701,3544
"2019-09-20 10:10:20","2019-09-21 09:00:00","2019-09-21 09:30:00",3195,798,3993
"2019-09-20 10:10:20","2019-09-21 10:00:00","2019-09-21 10:30:00",3350,853,4203
"2019-09-20 10:10:20","2019-09-21 11:00:00","2019-09-21 11:30:00",3397,813,4210
"2019-09-20 10:10:20","2019-09-21 12:00:00","2019-09-21 12:30:00",3392,816,4208
"2019-09-20 10:10:20","2019-09-21 13:00:00","2019-09-21 13:30:00",3356,793,4149
"2019-09-20 10:10:20","2019-09-21 14:00:00","2019-09-21 14:30:00",3267,756,4023
"2019-09-20 10:10:20","2019-09-21 15:00:00","2019-09-21 15:30:00",3242,758,4000
"2019-09-20 10:10:20","2019-09-21 16:00:00","2019-09-21 16:30:00",3243,768,4011
"2019-09-20 10:10:20","2019-09-21 17:00:00","2019-09-21 17:30:00",3352,841,4193
"2019-09-20 10:10:20","2019-09-21 18:00:00","2019-09-21 18:30:00",3368,889,4257
"2019-09-20 10:10:20","2019-09-21 19:00:00","2019-09-21 19:30:00",3271,845,4116
"2019-09-20 10:10:20","2019-09-21 20:00:00","2019-09-21 20:30:00",3266,869,4135
"2019-09-20 10:10:20","2019-09-21 21:00:00","2019-09-21 21:30:00",3276,841,4117
"2019-09-20 10:10:20","2019-09-21 22:00:00","2019-09-21 22:30:00",3002,755,3757
"2019-09-21 10:10:10","2019-09-21 23:00:00","2019-09-21 23:30:00",2706,687,3393
"2019-09-21 10:10:10","2019-09-22 00:00:00","2019-09-22 00:30:00",2523,593,3116
"2019-09-21 10:10:10","2019-09-22 01:00:00","2019-09-22 01:30:00",2404,542,2946
"2019-09-21 10:10:10","2019-09-22 02:00:00","2019-09-22 02:30:00",2328,522,2850
"2019-09-21 10:10:10","2019-09-22 03:00:00","2019-09-22 03:30:00",2276,514,2790
"2019-09-21 10:10:10","2019-09-22 04:00:00","2019-09-22 04:30:00",2254,501,2755
"2019-09-21 10:10:10","2019-09-22 05:00:00","2019-09-22 05:30:00",2268,496,2764
"2019-09-21 10:10:10","2019-09-22 06:00:00","2019-09-22 06:30:00",2305,537,2842
"2019-09-21 10:10:10","2019-09-22 07:00:00","2019-09-22 07:30:00",2379,563,2942
"2019-09-21 10:10:10","2019-09-22 08:00:00","2019-09-22 08:30:00",2590,655,3245
"2019-09-21 10:10:10","2019-09-22 09:00:00","2019-09-22 09:30:00",2868,760,3628
"2019-09-21 10:10:10","2019-09-22 10:00:00","2019-09-22 10:30:00",3069,820,3889
"2019-09-21 10:10:10","2019-09-22 11:00:00","2019-09-22 11:30:00",3159,870,4029
"2019-09-21 10:10:10","2019-09-22 12:00:00","2019-09-22 12:30:00",3209,920,4129
"2019-09-21 10:10:10","2019-09-22 13:00:00","2019-09-22 13:30:00",3250,934,4184
"2019-09-21 10:10:10","2019-09-22 14:00:00","2019-09-22 14:30:00",3182,868,4050
"2019-09-21 10:10:10","2019-09-22 15:00:00","2019-09-22 15:30:00",3130,866,3996
"2019-09-21 10:10:10","2019-09-22 16:00:00","2019-09-22 16:30:00",3151,861,4012
"2019-09-21 10:10:10","2019-09-22 17:00:00","2019-09-22 17:30:00",3207,940,4147
"2019-09-21 10:10:10","2019-09-22 18:00:00","2019-09-22 18:30:00",3332,955,4287
"2019-09-21 10:10:10","2019-09-22 19:00:00","2019-09-22 19:30:00",3306,960,4266
"2019-09-21 10:10:10","2019-09-22 20:00:00","2019-09-22 20:30:00",3402,1005,4407
"2019-09-21 10:10:10","2019-09-22 21:00:00","2019-09-22 21:30:00",3258,940,4198
"2019-09-21 10:10:10","2019-09-22 22:00:00","2019-09-22 22:30:00",2958,820,3778
"2019-09-22 10:10:25","2019-09-22 23:00:00","2019-09-22 23:30:00",2821,773,3594
"2019-09-22 10:10:25","2019-09-23 00:00:00","2019-09-23 00:30:00",2605,613,3218
"2019-09-22 10:10:25","2019-09-23 01:00:00","2019-09-23 01:30:00",2449,565,3014
"2019-09-22 10:10:25","2019-09-23 02:00:00","2019-09-23 02:30:00",2344,562,2906
"2019-09-22 10:10:25","2019-09-23 03:00:00","2019-09-23 03:30:00",2291,555,2846
"2019-09-22 10:10:25","2019-09-23 04:00:00","2019-09-23 04:30:00",2283,558,2841
"2019-09-22 10:10:25","2019-09-23 05:00:00","2019-09-23 05:30:00",2342,598,2940
"2019-09-22 10:10:25","2019-09-23 06:00:00","2019-09-23 06:30:00",2527,720,3247
"2019-09-22 10:10:25","2019-09-23 07:00:00","2019-09-23 07:30:00",3054,880,3934
"2019-09-22 10:10:25","2019-09-23 08:00:00","2019-09-23 08:30:00",3590,1075,4665
"2019-09-22 10:10:25","2019-09-23 09:00:00","2019-09-23 09:30:00",3741,1120,4861
"2019-09-22 10:10:25","2019-09-23 10:00:00","2019-09-23 10:30:00",3814,1126,4940
"2019-09-22 10:10:25","2019-09-23 11:00:00","2019-09-23 11:30:00",3795,1115,4910
"2019-09-22 10:10:25","2019-09-23 12:00:00","2019-09-23 12:30:00",3764,1102,4866
"2019-09-22 10:10:25","2019-09-23 13:00:00","2019-09-23 13:30:00",3773,1060,4833
"2019-09-22 10:10:25","2019-09-23 14:00:00","2019-09-23 14:30:00",3671,1027,4698
"2019-09-22 10:10:25","2019-09-23 15:00:00","2019-09-23 15:30:00",3655,1030,4685
"2019-09-22 10:10:25","2019-09-23 16:00:00","2019-09-23 16:30:00",3692,1080,4772
"2019-09-22 10:10:25","2019-09-23 17:00:00","2019-09-23 17:30:00",3841,1160,5001
"2019-09-22 10:10:25","2019-09-23 18:00:00","2019-09-23 18:30:00",3877,1130,5007
"2019-09-22 10:10:25","2019-09-23 19:00:00","2019-09-23 19:30:00",3766,1100,4866
"2019-09-22 10:10:25","2019-09-23 20:00:00","2019-09-23 20:30:00",4000,1163,5163
"2019-09-22 10:10:25","2019-09-23 21:00:00","2019-09-23 21:30:00",3814,1070,4884
"2019-09-22 10:10:25","2019-09-23 22:00:00","2019-09-23 22:30:00",3452,950,4402
"2019-09-23 10:10:10","2019-09-23 23:00:00","2019-09-23 23:30:00",2905,776,3681
"2019-09-23 10:10:10","2019-09-24 00:00:00","2019-09-24 00:30:00",2638,632,3270
"2019-09-23 10:10:10","2019-09-24 01:00:00","2019-09-24 01:30:00",2494,579,3073
"2019-09-23 10:10:10","2019-09-24 02:00:00","2019-09-24 02:30:00",2376,557,2933
"2019-09-23 10:10:10","2019-09-24 03:00:00","2019-09-24 03:30:00",2313,561,2874
"2019-09-23 10:10:10","2019-09-24 04:00:00","2019-09-24 04:30:00",2308,553,2861
"2019-09-23 10:10:10","2019-09-24 05:00:00","2019-09-24 05:30:00",2374,557,2931
"2019-09-23 10:10:10","2019-09-24 06:00:00","2019-09-24 06:30:00",2553,624,3177
"2019-09-23 10:10:10","2019-09-24 07:00:00","2019-09-24 07:30:00",3050,784,3834
"2019-09-23 10:10:10","2019-09-24 08:00:00","2019-09-24 08:30:00",3561,967,4528
"2019-09-23 10:10:10","2019-09-24 09:00:00","2019-09-24 09:30:00",3691,1007,4698
"2019-09-23 10:10:10","2019-09-24 10:00:00","2019-09-24 10:30:00",3715,1026,4741
"2019-09-23 10:10:10","2019-09-24 11:00:00","2019-09-24 11:30:00",3705,1009,4714
"2019-09-23 10:10:10","2019-09-24 12:00:00","2019-09-24 12:30:00",3709,1021,4730
"2019-09-23 10:10:10","2019-09-24 13:00:00","2019-09-24 13:30:00",3713,1008,4721
"2019-09-23 10:10:10","2019-09-24 14:00:00","2019-09-24 14:30:00",3635,960,4595
"2019-09-23 10:10:10","2019-09-24 15:00:00","2019-09-24 15:30:00",3633,952,4585
"2019-09-23 10:10:10","2019-09-24 16:00:00","2019-09-24 16:30:00",3667,990,4657
"2019-09-23 10:10:10","2019-09-24 17:00:00","2019-09-24 17:30:00",3817,1105,4922
"2019-09-23 10:10:10","2019-09-24 18:00:00","2019-09-24 18:30:00",3859,1104,4963
"2019-09-23 10:10:10","2019-09-24 19:00:00","2019-09-24 19:30:00",3734,1058,4792
"2019-09-23 10:10:10","2019-09-24 20:00:00","2019-09-24 20:30:00",3862,1106,4968
"2019-09-23 10:10:10","2019-09-24 21:00:00","2019-09-24 21:30:00",3825,1077,4902
"2019-09-23 10:10:10","2019-09-24 22:00:00","2019-09-24 22:30:00",3410,918,4328
"2019-09-24 10:10:31","2019-09-24 23:00:00","2019-09-24 23:30:00",2992,784,3776
"2019-09-24 10:10:31","2019-09-25 00:00:00","2019-09-25 00:30:00",2638,674,3312
"2019-09-24 10:10:31","2019-09-25 01:00:00","2019-09-25 01:30:00",2494,622,3116
"2019-09-24 10:10:31","2019-09-25 02:00:00","2019-09-25 02:30:00",2376,597,2973
"2019-09-24 10:10:31","2019-09-25 03:00:00","2019-09-25 03:30:00",2313,594,2907
"2019-09-24 10:10:31","2019-09-25 04:00:00","2019-09-25 04:30:00",2308,586,2894
"2019-09-24 10:10:31","2019-09-25 05:00:00","2019-09-25 05:30:00",2374,585,2959
"2019-09-24 10:10:31","2019-09-25 06:00:00","2019-09-25 06:30:00",2553,652,3205
"2019-09-24 10:10:31","2019-09-25 07:00:00","2019-09-25 07:30:00",3050,819,3869
"2019-09-24 10:10:31","2019-09-25 08:00:00","2019-09-25 08:30:00",3561,1008,4569
"2019-09-24 10:10:31","2019-09-25 09:00:00","2019-09-25 09:30:00",3691,1040,4731
"2019-09-24 10:10:31","2019-09-25 10:00:00","2019-09-25 10:30:00",3715,1059,4774
"2019-09-24 10:10:31","2019-09-25 11:00:00","2019-09-25 11:30:00",3705,1046,4751
"2019-09-24 10:10:31","2019-09-25 12:00:00","2019-09-25 12:30:00",3709,1037,4746
"2019-09-24 10:10:31","2019-09-25 13:00:00","2019-09-25 13:30:00",3713,1023,4736
"2019-09-24 10:10:31","2019-09-25 14:00:00","2019-09-25 14:30:00",3635,987,4622
"2019-09-24 10:10:31","2019-09-25 15:00:00","2019-09-25 15:30:00",3633,972,4605
"2019-09-24 10:10:31","2019-09-25 16:00:00","2019-09-25 16:30:00",3667,1019,4686
"2019-09-24 10:10:31","2019-09-25 17:00:00","2019-09-25 17:30:00",3817,1116,4933
"2019-09-24 10:10:31","2019-09-25 18:00:00","2019-09-25 18:30:00",3859,1101,4960
"2019-09-24 10:10:31","2019-09-25 19:00:00","2019-09-25 19:30:00",3734,1061,4795
"2019-09-24 10:10:31","2019-09-25 20:00:00","2019-09-25 20:30:00",3862,1105,4967
"2019-09-24 10:10:31","2019-09-25 21:00:00","2019-09-25 21:30:00",3825,1076,4901
"2019-09-24 10:10:31","2019-09-25 22:00:00","2019-09-25 22:30:00",3410,916,4326
"2019-09-25 10:10:26","2019-09-25 23:00:00","2019-09-25 23:30:00",3055,816,3871
"2019-09-25 10:10:26","2019-09-26 00:00:00","2019-09-26 00:30:00",2634,678,3312
"2019-09-25 10:10:26","2019-09-26 01:00:00","2019-09-26 01:30:00",2529,616,3145
"2019-09-25 10:10:26","2019-09-26 02:00:00","2019-09-26 02:30:00",2421,597,3018
"2019-09-25 10:10:26","2019-09-26 03:00:00","2019-09-26 03:30:00",2351,592,2943
"2019-09-25 10:10:26","2019-09-26 04:00:00","2019-09-26 04:30:00",2350,583,2933
"2019-09-25 10:10:26","2019-09-26 05:00:00","2019-09-26 05:30:00",2390,600,2990
"2019-09-25 10:10:26","2019-09-26 06:00:00","2019-09-26 06:30:00",2574,679,3253
"2019-09-25 10:10:26","2019-09-26 07:00:00","2019-09-26 07:30:00",3074,871,3945
"2019-09-25 10:10:26","2019-09-26 08:00:00","2019-09-26 08:30:00",3527,1038,4565
"2019-09-25 10:10:26","2019-09-26 09:00:00","2019-09-26 09:30:00",3612,1098,4710
"2019-09-25 10:10:26","2019-09-26 10:00:00","2019-09-26 10:30:00",3635,1112,4747
"2019-09-25 10:10:26","2019-09-26 11:00:00","2019-09-26 11:30:00",3590,1101,4691
"2019-09-25 10:10:26","2019-09-26 12:00:00","2019-09-26 12:30:00",3640,1080,4720
"2019-09-25 10:10:26","2019-09-26 13:00:00","2019-09-26 13:30:00",3680,1063,4743
"2019-09-25 10:10:26","2019-09-26 14:00:00","2019-09-26 14:30:00",3620,1028,4648
"2019-09-25 10:10:26","2019-09-26 15:00:00","2019-09-26 15:30:00",3660,1020,4680
"2019-09-25 10:10:26","2019-09-26 16:00:00","2019-09-26 16:30:00",3719,1056,4775
"2019-09-25 10:10:26","2019-09-26 17:00:00","2019-09-26 17:30:00",3858,1159,5017
"2019-09-25 10:10:26","2019-09-26 18:00:00","2019-09-26 18:30:00",3913,1151,5064
"2019-09-25 10:10:26","2019-09-26 19:00:00","2019-09-26 19:30:00",3841,1082,4923
"2019-09-25 10:10:26","2019-09-26 20:00:00","2019-09-26 20:30:00",4000,1149,5149
"2019-09-25 10:10:26","2019-09-26 21:00:00","2019-09-26 21:30:00",3804,1073,4877
"2019-09-25 10:10:26","2019-09-26 22:00:00","2019-09-26 22:30:00",3437,954,4391
"2019-09-26 10:10:11","2019-09-26 23:00:00","2019-09-26 23:30:00",2970,776,3746
"2019-09-26 10:10:11","2019-09-27 00:00:00","2019-09-27 00:30:00",2691,688,3379
"2019-09-26 10:10:11","2019-09-27 01:00:00","2019-09-27 01:30:00",2617,618,3235
"2019-09-26 10:10:11","2019-09-27 02:00:00","2019-09-27 02:30:00",2461,610,3071
"2019-09-26 10:10:11","2019-09-27 03:00:00","2019-09-27 03:30:00",2423,603,3026
"2019-09-26 10:10:11","2019-09-27 04:00:00","2019-09-27 04:30:00",2380,584,2964
"2019-09-26 10:10:11","2019-09-27 05:00:00","2019-09-27 05:30:00",2437,612,3049
"2019-09-26 10:10:11","2019-09-27 06:00:00","2019-09-27 06:30:00",2621,679,3300
"2019-09-26 10:10:11","2019-09-27 07:00:00","2019-09-27 07:30:00",3118,862,3980
"2019-09-26 10:10:11","2019-09-27 08:00:00","2019-09-27 08:30:00",3602,1122,4724
"2019-09-26 10:10:11","2019-09-27 09:00:00","2019-09-27 09:30:00",3714,1170,4884
"2019-09-26 10:10:11","2019-09-27 10:00:00","2019-09-27 10:30:00",3731,1166,4897
"2019-09-26 10:10:11","2019-09-27 11:00:00","2019-09-27 11:30:00",3690,1142,4832
"2019-09-26 10:10:11","2019-09-27 12:00:00","2019-09-27 12:30:00",3673,1110,4783
"2019-09-26 10:10:11","2019-09-27 13:00:00","2019-09-27 13:30:00",3674,1064,4738
"2019-09-26 10:10:11","2019-09-27 14:00:00","2019-09-27 14:30:00",3579,992,4571
"2019-09-26 10:10:11","2019-09-27 15:00:00","2019-09-27 15:30:00",3566,988,4554
"2019-09-26 10:10:11","2019-09-27 16:00:00","2019-09-27 16:30:00",3584,1007,4591
"2019-09-26 10:10:11","2019-09-27 17:00:00","2019-09-27 17:30:00",3660,1057,4717
"2019-09-26 10:10:11","2019-09-27 18:00:00","2019-09-27 18:30:00",3680,1098,4778
"2019-09-26 10:10:11","2019-09-27 19:00:00","2019-09-27 19:30:00",3647,1055,4702
"2019-09-26 10:10:11","2019-09-27 20:00:00","2019-09-27 20:30:00",3850,1130,4980
"2019-09-26 10:10:11","2019-09-27 21:00:00","2019-09-27 21:30:00",3659,1086,4745
"2019-09-26 10:10:11","2019-09-27 22:00:00","2019-09-27 22:30:00",3307,982,4289
"2019-09-27 10:10:26","2019-09-27 23:00:00","2019-09-27 23:30:00",2998,835,3833
"2019-09-27 10:10:26","2019-09-28 00:00:00","2019-09-28 00:30:00",2762,704,3466
"2019-09-27 10:10:26","2019-09-28 01:00:00","2019-09-28 01:30:00",2602,608,3210
"2019-09-27 10:10:26","2019-09-28 02:00:00","2019-09-28 02:30:00",2455,568,3023
"2019-09-27 10:10:26","2019-09-28 03:00:00","2019-09-28 03:30:00",2358,558,2916
"2019-09-27 10:10:26","2019-09-28 04:00:00","2019-09-28 04:30:00",2320,547,2867
"2019-09-27 10:10:26","2019-09-28 05:00:00","2019-09-28 05:30:00",2362,560,2922
"2019-09-27 10:10:26","2019-09-28 06:00:00","2019-09-28 06:30:00",2451,584,3035
"2019-09-27 10:10:26","2019-09-28 07:00:00","2019-09-28 07:30:00",2657,653,3310
"2019-09-27 10:10:26","2019-09-28 08:00:00","2019-09-28 08:30:00",2937,805,3742
"2019-09-27 10:10:26","2019-09-28 09:00:00","2019-09-28 09:30:00",3284,912,4196
"2019-09-27 10:10:26","2019-09-28 10:00:00","2019-09-28 10:30:00",3460,932,4392
"2019-09-27 10:10:26","2019-09-28 11:00:00","2019-09-28 11:30:00",3468,944,4412
"2019-09-27 10:10:26","2019-09-28 12:00:00","2019-09-28 12:30:00",3450,935,4385
"2019-09-27 10:10:26","2019-09-28 13:00:00","2019-09-28 13:30:00",3436,901,4337
"2019-09-27 10:10:26","2019-09-28 14:00:00","2019-09-28 14:30:00",3325,842,4167
"2019-09-27 10:10:26","2019-09-28 15:00:00","2019-09-28 15:30:00",3250,841,4091
"2019-09-27 10:10:26","2019-09-28 16:00:00","2019-09-28 16:30:00",3222,877,4099
"2019-09-27 10:10:26","2019-09-28 17:00:00","2019-09-28 17:30:00",3335,964,4299
"2019-09-27 10:10:26","2019-09-28 18:00:00","2019-09-28 18:30:00",3440,1004,4444
"2019-09-27 10:10:26","2019-09-28 19:00:00","2019-09-28 19:30:00",3478,976,4454
"2019-09-27 10:10:26","2019-09-28 20:00:00","2019-09-28 20:30:00",3531,1014,4545
"2019-09-27 10:10:26","2019-09-28 21:00:00","2019-09-28 21:30:00",3311,942,4253
"2019-09-27 10:10:26","2019-09-28 22:00:00","2019-09-28 22:30:00",3017,876,3893
"2019-09-28 10:10:11","2019-09-28 23:00:00","2019-09-28 23:30:00",2746,802,3548
"2019-09-28 10:10:11","2019-09-29 00:00:00","2019-09-29 00:30:00",2614,675,3289
"2019-09-28 10:10:11","2019-09-29 01:00:00","2019-09-29 01:30:00",2491,612,3103
"2019-09-28 10:10:11","2019-09-29 02:00:00","2019-09-29 02:30:00",2381,595,2976
"2019-09-28 10:10:11","2019-09-29 03:00:00","2019-09-29 03:30:00",2266,578,2844
"2019-09-28 10:10:11","2019-09-29 04:00:00","2019-09-29 04:30:00",2223,557,2780
"2019-09-28 10:10:11","2019-09-29 05:00:00","2019-09-29 05:30:00",2242,567,2809
"2019-09-28 10:10:11","2019-09-29 06:00:00","2019-09-29 06:30:00",2302,587,2889
"2019-09-28 10:10:11","2019-09-29 07:00:00","2019-09-29 07:30:00",2426,640,3066
"2019-09-28 10:10:11","2019-09-29 08:00:00","2019-09-29 08:30:00",2545,753,3298
"2019-09-28 10:10:11","2019-09-29 09:00:00","2019-09-29 09:30:00",2872,880,3752
"2019-09-28 10:10:11","2019-09-29 10:00:00","2019-09-29 10:30:00",3126,942,4068
"2019-09-28 10:10:11","2019-09-29 11:00:00","2019-09-29 11:30:00",3268,959,4227
"2019-09-28 10:10:11","2019-09-29 12:00:00","2019-09-29 12:30:00",3326,993,4319
"2019-09-28 10:10:11","2019-09-29 13:00:00","2019-09-29 13:30:00",3375,1036,4411
"2019-09-28 10:10:11","2019-09-29 14:00:00","2019-09-29 14:30:00",3299,977,4276
"2019-09-28 10:10:11","2019-09-29 15:00:00","2019-09-29 15:30:00",3208,924,4132
"2019-09-28 10:10:11","2019-09-29 16:00:00","2019-09-29 16:30:00",3212,951,4163
"2019-09-28 10:10:11","2019-09-29 17:00:00","2019-09-29 17:30:00",3233,1005,4238
"2019-09-28 10:10:11","2019-09-29 18:00:00","2019-09-29 18:30:00",3387,1067,4454
"2019-09-28 10:10:11","2019-09-29 19:00:00","2019-09-29 19:30:00",3397,1020,4417
"2019-09-28 10:10:11","2019-09-29 20:00:00","2019-09-29 20:30:00",3580,1057,4637
"2019-09-28 10:10:11","2019-09-29 21:00:00","2019-09-29 21:30:00",3370,1020,4390
"2019-09-28 10:10:11","2019-09-29 22:00:00","2019-09-29 22:30:00",3062,878,3940
"2019-09-29 10:10:31","2019-09-29 23:00:00","2019-09-29 23:30:00",2743,763,3506
"2019-09-29 10:10:31","2019-09-30 00:00:00","2019-09-30 00:30:00",2493,666,3159
"2019-09-29 10:10:31","2019-09-30 01:00:00","2019-09-30 01:30:00",2416,614,3030
"2019-09-29 10:10:31","2019-09-30 02:00:00","2019-09-30 02:30:00",2307,600,2907
"2019-09-29 10:10:31","2019-09-30 03:00:00","2019-09-30 03:30:00",2232,605,2837
"2019-09-29 10:10:31","2019-09-30 04:00:00","2019-09-30 04:30:00",2237,593,2830
"2019-09-29 10:10:31","2019-09-30 05:00:00","2019-09-30 05:30:00",2291,606,2897
"2019-09-29 10:10:31","2019-09-30 06:00:00","2019-09-30 06:30:00",2492,674,3166
"2019-09-29 10:10:31","2019-09-30 07:00:00","2019-09-30 07:30:00",3015,858,3873
"2019-09-29 10:10:31","2019-09-30 08:00:00","2019-09-30 08:30:00",3524,1028,4552
"2019-09-29 10:10:31","2019-09-30 09:00:00","2019-09-30 09:30:00",3692,1090,4782
"2019-09-29 10:10:31","2019-09-30 10:00:00","2019-09-30 10:30:00",3743,1106,4849
"2019-09-29 10:10:31","2019-09-30 11:00:00","2019-09-30 11:30:00",3734,1090,4824
"2019-09-29 10:10:31","2019-09-30 12:00:00","2019-09-30 12:30:00",3730,1066,4796
"2019-09-29 10:10:31","2019-09-30 13:00:00","2019-09-30 13:30:00",3734,1070,4804
"2019-09-29 10:10:31","2019-09-30 14:00:00","2019-09-30 14:30:00",3657,1065,4722
"2019-09-29 10:10:31","2019-09-30 15:00:00","2019-09-30 15:30:00",3650,1079,4729
"2019-09-29 10:10:31","2019-09-30 16:00:00","2019-09-30 16:30:00",3656,1130,4786
"2019-09-29 10:10:31","2019-09-30 17:00:00","2019-09-30 17:30:00",3779,1218,4997
"2019-09-29 10:10:31","2019-09-30 18:00:00","2019-09-30 18:30:00",3891,1209,5100
"2019-09-29 10:10:31","2019-09-30 19:00:00","2019-09-30 19:30:00",3903,1132,5035
"2019-09-29 10:10:31","2019-09-30 20:00:00","2019-09-30 20:30:00",4013,1139,5152
"2019-09-29 10:10:31","2019-09-30 21:00:00","2019-09-30 21:30:00",3760,1078,4838
"2019-09-29 10:10:31","2019-09-30 22:00:00","2019-09-30 22:30:00",3412,973,4385
"2019-09-30 10:10:16","2019-09-30 23:00:00","2019-09-30 23:30:00",2969,751,3720
"2019-09-30 10:10:16","2019-10-01 00:00:00","2019-10-01 00:30:00",2682,677,3359
"2019-09-30 10:10:16","2019-10-01 01:00:00","2019-10-01 01:30:00",2572,622,3194
"2019-09-30 10:10:16","2019-10-01 02:00:00","2019-10-01 02:30:00",2460,594,3054
"2019-09-30 10:10:16","2019-10-01 03:00:00","2019-10-01 03:30:00",2400,588,2988
"2019-09-30 10:10:16","2019-10-01 04:00:00","2019-10-01 04:30:00",2388,592,2980
"2019-09-30 10:10:16","2019-10-01 05:00:00","2019-10-01 05:30:00",2430,598,3028
"2019-09-30 10:10:16","2019-10-01 06:00:00","2019-10-01 06:30:00",2628,681,3309
"2019-09-30 10:10:16","2019-10-01 07:00:00","2019-10-01 07:30:00",3136,866,4002
"2019-09-30 10:10:16","2019-10-01 08:00:00","2019-10-01 08:30:00",3651,1023,4674
"2019-09-30 10:10:16","2019-10-01 09:00:00","2019-10-01 09:30:00",3709,1045,4754
"2019-09-30 10:10:16","2019-10-01 10:00:00","2019-10-01 10:30:00",3715,1054,4769
"2019-09-30 10:10:16","2019-10-01 11:00:00","2019-10-01 11:30:00",3689,1050,4739
"2019-09-30 10:10:16","2019-10-01 12:00:00","2019-10-01 12:30:00",3715,1030,4745
"2019-09-30 10:10:16","2019-10-01 13:00:00","2019-10-01 13:30:00",3733,1055,4788
"2019-09-30 10:10:16","2019-10-01 14:00:00","2019-10-01 14:30:00",3663,1009,4672
"2019-09-30 10:10:16","2019-10-01 15:00:00","2019-10-01 15:30:00",3667,1018,4685
"2019-09-30 10:10:16","2019-10-01 16:00:00","2019-10-01 16:30:00",3701,1069,4770
"2019-09-30 10:10:16","2019-10-01 17:00:00","2019-10-01 17:30:00",3839,1183,5022
"2019-09-30 10:10:16","2019-10-01 18:00:00","2019-10-01 18:30:00",3854,1191,5045
"2019-09-30 10:10:16","2019-10-01 19:00:00","2019-10-01 19:30:00",3860,1136,4996
"2019-09-30 10:10:16","2019-10-01 20:00:00","2019-10-01 20:30:00",3979,1188,5167
"2019-09-30 10:10:16","2019-10-01 21:00:00","2019-10-01 21:30:00",3774,1110,4884
"2019-09-30 10:10:16","2019-10-01 22:00:00","2019-10-01 22:30:00",3363,982,4345
"2019-10-01 10:10:30","2019-10-01 23:00:00","2019-10-01 23:30:00",3011,759,3770
"2019-10-01 10:10:30","2019-10-02 00:00:00","2019-10-02 00:30:00",2711,722,3433
"2019-10-01 10:10:30","2019-10-02 01:00:00","2019-10-02 01:30:00",2595,667,3262
"2019-10-01 10:10:30","2019-10-02 02:00:00","2019-10-02 02:30:00",2476,639,3115
"2019-10-01 10:10:30","2019-10-02 03:00:00","2019-10-02 03:30:00",2413,628,3041
"2019-10-01 10:10:30","2019-10-02 04:00:00","2019-10-02 04:30:00",2400,634,3034
"2019-10-01 10:10:30","2019-10-02 05:00:00","2019-10-02 05:30:00",2444,640,3084
"2019-10-01 10:10:30","2019-10-02 06:00:00","2019-10-02 06:30:00",2654,728,3382
"2019-10-01 10:10:30","2019-10-02 07:00:00","2019-10-02 07:30:00",3193,933,4126
"2019-10-01 10:10:30","2019-10-02 08:00:00","2019-10-02 08:30:00",3739,1090,4829
"2019-10-01 10:10:30","2019-10-02 09:00:00","2019-10-02 09:30:00",3800,1118,4918
"2019-10-01 10:10:30","2019-10-02 10:00:00","2019-10-02 10:30:00",3807,1106,4913
"2019-10-01 10:10:30","2019-10-02 11:00:00","2019-10-02 11:30:00",3779,1096,4875
"2019-10-01 10:10:30","2019-10-02 12:00:00","2019-10-02 12:30:00",3806,1067,4873
"2019-10-01 10:10:30","2019-10-02 13:00:00","2019-10-02 13:30:00",3826,1100,4926
"2019-10-01 10:10:30","2019-10-02 14:00:00","2019-10-02 14:30:00",3752,1044,4796
"2019-10-01 10:10:30","2019-10-02 15:00:00","2019-10-02 15:30:00",3756,1044,4800
"2019-10-01 10:10:30","2019-10-02 16:00:00","2019-10-02 16:30:00",3792,1102,4894
"2019-10-01 10:10:30","2019-10-02 17:00:00","2019-10-02 17:30:00",3938,1211,5149
"2019-10-01 10:10:30","2019-10-02 18:00:00","2019-10-02 18:30:00",3954,1210,5164
"2019-10-01 10:10:30","2019-10-02 19:00:00","2019-10-02 19:30:00",3961,1157,5118
"2019-10-01 10:10:30","2019-10-02 20:00:00","2019-10-02 20:30:00",4087,1211,5298
"2019-10-01 10:10:30","2019-10-02 21:00:00","2019-10-02 21:30:00",3869,1134,5003
"2019-10-01 10:10:30","2019-10-02 22:00:00","2019-10-02 22:30:00",3434,996,4430
"2019-10-02 10:10:20","2019-10-02 23:00:00","2019-10-02 23:30:00",3114,831,3945
"2019-10-02 10:10:20","2019-10-03 00:00:00","2019-10-03 00:30:00",2767,723,3490
"2019-10-02 10:10:20","2019-10-03 01:00:00","2019-10-03 01:30:00",2606,666,3272
"2019-10-02 10:10:20","2019-10-03 02:00:00","2019-10-03 02:30:00",2520,633,3153
"2019-10-02 10:10:20","2019-10-03 03:00:00","2019-10-03 03:30:00",2461,626,3087
"2019-10-02 10:10:20","2019-10-03 04:00:00","2019-10-03 04:30:00",2453,610,3063
"2019-10-02 10:10:20","2019-10-03 05:00:00","2019-10-03 05:30:00",2507,635,3142
"2019-10-02 10:10:20","2019-10-03 06:00:00","2019-10-03 06:30:00",2730,707,3437
"2019-10-02 10:10:20","2019-10-03 07:00:00","2019-10-03 07:30:00",3237,919,4156
"2019-10-02 10:10:20","2019-10-03 08:00:00","2019-10-03 08:30:00",3740,1091,4831
"2019-10-02 10:10:20","2019-10-03 09:00:00","2019-10-03 09:30:00",3860,1118,4978
"2019-10-02 10:10:20","2019-10-03 10:00:00","2019-10-03 10:30:00",3880,1114,4994
"2019-10-02 10:10:20","2019-10-03 11:00:00","2019-10-03 11:30:00",3890,1109,4999
"2019-10-02 10:10:20","2019-10-03 12:00:00","2019-10-03 12:30:00",3890,1100,4990
"2019-10-02 10:10:20","2019-10-03 13:00:00","2019-10-03 13:30:00",3885,1082,4967
"2019-10-02 10:10:20","2019-10-03 14:00:00","2019-10-03 14:30:00",3820,1052,4872
"2019-10-02 10:10:20","2019-10-03 15:00:00","2019-10-03 15:30:00",3860,1044,4904
"2019-10-02 10:10:20","2019-10-03 16:00:00","2019-10-03 16:30:00",3897,1094,4991
"2019-10-02 10:10:20","2019-10-03 17:00:00","2019-10-03 17:30:00",4026,1196,5222
"2019-10-02 10:10:20","2019-10-03 18:00:00","2019-10-03 18:30:00",4025,1217,5242
"2019-10-02 10:10:20","2019-10-03 19:00:00","2019-10-03 19:30:00",3948,1190,5138
"2019-10-02 10:10:20","2019-10-03 20:00:00","2019-10-03 20:30:00",4100,1203,5303
"2019-10-02 10:10:20","2019-10-03 21:00:00","2019-10-03 21:30:00",3875,1136,5011
"2019-10-02 10:10:20","2019-10-03 22:00:00","2019-10-03 22:30:00",3514,992,4506
"2019-10-03 10:10:06","2019-10-03 23:00:00","2019-10-03 23:30:00",3024,833,3857
"2019-10-03 10:10:06","2019-10-04 00:00:00","2019-10-04 00:30:00",2813,639,3452
"2019-10-03 10:10:06","2019-10-04 01:00:00","2019-10-04 01:30:00",2692,571,3263
"2019-10-03 10:10:06","2019-10-04 02:00:00","2019-10-04 02:30:00",2534,566,3100
"2019-10-03 10:10:06","2019-10-04 03:00:00","2019-10-04 03:30:00",2464,551,3015
"2019-10-03 10:10:06","2019-10-04 04:00:00","2019-10-04 04:30:00",2430,545,2975
"2019-10-03 10:10:06","2019-10-04 05:00:00","2019-10-04 05:30:00",2479,577,3056
"2019-10-03 10:10:06","2019-10-04 06:00:00","2019-10-04 06:30:00",2649,656,3305
"2019-10-03 10:10:06","2019-10-04 07:00:00","2019-10-04 07:30:00",3190,831,4021
"2019-10-03 10:10:06","2019-10-04 08:00:00","2019-10-04 08:30:00",3730,996,4726
"2019-10-03 10:10:06","2019-10-04 09:00:00","2019-10-04 09:30:00",3861,1024,4885
"2019-10-03 10:10:06","2019-10-04 10:00:00","2019-10-04 10:30:00",3874,1053,4927
"2019-10-03 10:10:06","2019-10-04 11:00:00","2019-10-04 11:30:00",3823,1045,4868
"2019-10-03 10:10:06","2019-10-04 12:00:00","2019-10-04 12:30:00",3800,1029,4829
"2019-10-03 10:10:06","2019-10-04 13:00:00","2019-10-04 13:30:00",3827,1000,4827
"2019-10-03 10:10:06","2019-10-04 14:00:00","2019-10-04 14:30:00",3726,953,4679
"2019-10-03 10:10:06","2019-10-04 15:00:00","2019-10-04 15:30:00",3711,942,4653
"2019-10-03 10:10:06","2019-10-04 16:00:00","2019-10-04 16:30:00",3730,953,4683
"2019-10-03 10:10:06","2019-10-04 17:00:00","2019-10-04 17:30:00",3804,1047,4851
"2019-10-03 10:10:06","2019-10-04 18:00:00","2019-10-04 18:30:00",3883,1051,4934
"2019-10-03 10:10:06","2019-10-04 19:00:00","2019-10-04 19:30:00",3982,1018,5000
"2019-10-03 10:10:06","2019-10-04 20:00:00","2019-10-04 20:30:00",3995,1050,5045
"2019-10-03 10:10:06","2019-10-04 21:00:00","2019-10-04 21:30:00",3733,986,4719
"2019-10-03 10:10:06","2019-10-04 22:00:00","2019-10-04 22:30:00",3409,873,4282
"2019-10-04 10:10:25","2019-10-04 23:00:00","2019-10-04 23:30:00",3103,836,3939
"2019-10-04 10:10:25","2019-10-05 00:00:00","2019-10-05 00:30:00",2797,708,3505
"2019-10-04 10:10:25","2019-10-05 01:00:00","2019-10-05 01:30:00",2650,621,3271
"2019-10-04 10:10:25","2019-10-05 02:00:00","2019-10-05 02:30:00",2571,567,3138
"2019-10-04 10:10:25","2019-10-05 03:00:00","2019-10-05 03:30:00",2458,559,3017
"2019-10-04 10:10:25","2019-10-05 04:00:00","2019-10-05 04:30:00",2452,531,2983
"2019-10-04 10:10:25","2019-10-05 05:00:00","2019-10-05 05:30:00",2424,531,2955
"2019-10-04 10:10:25","2019-10-05 06:00:00","2019-10-05 06:30:00",2532,557,3089
"2019-10-04 10:10:25","2019-10-05 07:00:00","2019-10-05 07:30:00",2724,649,3373
"2019-10-04 10:10:25","2019-10-05 08:00:00","2019-10-05 08:30:00",3058,757,3815
"2019-10-04 10:10:25","2019-10-05 09:00:00","2019-10-05 09:30:00",3284,875,4159
"2019-10-04 10:10:25","2019-10-05 10:00:00","2019-10-05 10:30:00",3398,913,4311
"2019-10-04 10:10:25","2019-10-05 11:00:00","2019-10-05 11:30:00",3517,920,4437
"2019-10-04 10:10:25","2019-10-05 12:00:00","2019-10-05 12:30:00",3485,907,4392
"2019-10-04 10:10:25","2019-10-05 13:00:00","2019-10-05 13:30:00",3479,897,4376
"2019-10-04 10:10:25","2019-10-05 14:00:00","2019-10-05 14:30:00",3391,850,4241
"2019-10-04 10:10:25","2019-10-05 15:00:00","2019-10-05 15:30:00",3314,842,4156
"2019-10-04 10:10:25","2019-10-05 16:00:00","2019-10-05 16:30:00",3348,861,4209
"2019-10-04 10:10:25","2019-10-05 17:00:00","2019-10-05 17:30:00",3460,930,4390
"2019-10-04 10:10:25","2019-10-05 18:00:00","2019-10-05 18:30:00",3590,977,4567
"2019-10-04 10:10:25","2019-10-05 19:00:00","2019-10-05 19:30:00",3594,964,4558
"2019-10-04 10:10:25","2019-10-05 20:00:00","2019-10-05 20:30:00",3598,958,4556
"2019-10-04 10:10:25","2019-10-05 21:00:00","2019-10-05 21:30:00",3372,899,4271
"2019-10-04 10:10:25","2019-10-05 22:00:00","2019-10-05 22:30:00",3117,823,3940
"2019-10-05 10:10:15","2019-10-05 23:00:00","2019-10-05 23:30:00",2900,798,3698
"2019-10-05 10:10:15","2019-10-06 00:00:00","2019-10-06 00:30:00",2685,684,3369
"2019-10-05 10:10:15","2019-10-06 01:00:00","2019-10-06 01:30:00",2584,600,3184
"2019-10-05 10:10:15","2019-10-06 02:00:00","2019-10-06 02:30:00",2441,573,3014
"2019-10-05 10:10:15","2019-10-06 03:00:00","2019-10-06 03:30:00",2347,550,2897
"2019-10-05 10:10:15","2019-10-06 04:00:00","2019-10-06 04:30:00",2330,534,2864
"2019-10-05 10:10:15","2019-10-06 05:00:00","2019-10-06 05:30:00",2357,536,2893
"2019-10-05 10:10:15","2019-10-06 06:00:00","2019-10-06 06:30:00",2402,557,2959
"2019-10-05 10:10:15","2019-10-06 07:00:00","2019-10-06 07:30:00",2498,605,3103
"2019-10-05 10:10:15","2019-10-06 08:00:00","2019-10-06 08:30:00",2672,659,3331
"2019-10-05 10:10:15","2019-10-06 09:00:00","2019-10-06 09:30:00",2935,779,3714
"2019-10-05 10:10:15","2019-10-06 10:00:00","2019-10-06 10:30:00",3171,843,4014
"2019-10-05 10:10:15","2019-10-06 11:00:00","2019-10-06 11:30:00",3315,865,4180
"2019-10-05 10:10:15","2019-10-06 12:00:00","2019-10-06 12:30:00",3379,883,4262
"2019-10-05 10:10:15","2019-10-06 13:00:00","2019-10-06 13:30:00",3450,945,4395
"2019-10-05 10:10:15","2019-10-06 14:00:00","2019-10-06 14:30:00",3392,873,4265
"2019-10-05 10:10:15","2019-10-06 15:00:00","2019-10-06 15:30:00",3286,849,4135
"2019-10-05 10:10:15","2019-10-06 16:00:00","2019-10-06 16:30:00",3285,880,4165
"2019-10-05 10:10:15","2019-10-06 17:00:00","2019-10-06 17:30:00",3371,955,4326
"2019-10-05 10:10:15","2019-10-06 18:00:00","2019-10-06 18:30:00",3469,1000,4469
"2019-10-05 10:10:15","2019-10-06 19:00:00","2019-10-06 19:30:00",3657,987,4644
"2019-10-05 10:10:15","2019-10-06 20:00:00","2019-10-06 20:30:00",3664,1031,4695
"2019-10-05 10:10:15","2019-10-06 21:00:00","2019-10-06 21:30:00",3448,947,4395
"2019-10-05 10:10:15","2019-10-06 22:00:00","2019-10-06 22:30:00",3141,830,3971
"2019-10-06 10:10:31","2019-10-06 23:00:00","2019-10-06 23:30:00",2819,735,3554
"2019-10-06 10:10:31","2019-10-07 00:00:00","2019-10-07 00:30:00",2661,624,3285
"2019-10-06 10:10:31","2019-10-07 01:00:00","2019-10-07 01:30:00",2563,579,3142
"2019-10-06 10:10:31","2019-10-07 02:00:00","2019-10-07 02:30:00",2433,559,2992
"2019-10-06 10:10:31","2019-10-07 03:00:00","2019-10-07 03:30:00",2350,543,2893
"2019-10-06 10:10:31","2019-10-07 04:00:00","2019-10-07 04:30:00",2364,552,2916
"2019-10-06 10:10:31","2019-10-07 05:00:00","2019-10-07 05:30:00",2421,568,2989
"2019-10-06 10:10:31","2019-10-07 06:00:00","2019-10-07 06:30:00",2610,640,3250
"2019-10-06 10:10:31","2019-10-07 07:00:00","2019-10-07 07:30:00",3087,834,3921
"2019-10-06 10:10:31","2019-10-07 08:00:00","2019-10-07 08:30:00",3635,989,4624
"2019-10-06 10:10:31","2019-10-07 09:00:00","2019-10-07 09:30:00",3800,1053,4853
"2019-10-06 10:10:31","2019-10-07 10:00:00","2019-10-07 10:30:00",3850,1055,4905
"2019-10-06 10:10:31","2019-10-07 11:00:00","2019-10-07 11:30:00",3850,1064,4914
"2019-10-06 10:10:31","2019-10-07 12:00:00","2019-10-07 12:30:00",3870,1067,4937
"2019-10-06 10:10:31","2019-10-07 13:00:00","2019-10-07 13:30:00",3864,1063,4927
"2019-10-06 10:10:31","2019-10-07 14:00:00","2019-10-07 14:30:00",3741,1035,4776
"2019-10-06 10:10:31","2019-10-07 15:00:00","2019-10-07 15:30:00",3767,1018,4785
"2019-10-06 10:10:31","2019-10-07 16:00:00","2019-10-07 16:30:00",3800,1093,4893
"2019-10-06 10:10:31","2019-10-07 17:00:00","2019-10-07 17:30:00",3974,1162,5136
"2019-10-06 10:10:31","2019-10-07 18:00:00","2019-10-07 18:30:00",4071,1167,5238
"2019-10-06 10:10:31","2019-10-07 19:00:00","2019-10-07 19:30:00",4150,1148,5298
"2019-10-06 10:10:31","2019-10-07 20:00:00","2019-10-07 20:30:00",4059,1110,5169
"2019-10-06 10:10:31","2019-10-07 21:00:00","2019-10-07 21:30:00",3799,1021,4820
"2019-10-06 10:10:31","2019-10-07 22:00:00","2019-10-07 22:30:00",3478,899,4377
"2019-10-07 10:10:20","2019-10-07 23:00:00","2019-10-07 23:30:00",3093,716,3809
"2019-10-07 10:10:20","2019-10-08 00:00:00","2019-10-08 00:30:00",2830,656,3486
"2019-10-07 10:10:20","2019-10-08 01:00:00","2019-10-08 01:30:00",2709,598,3307
"2019-10-07 10:10:20","2019-10-08 02:00:00","2019-10-08 02:30:00",2577,569,3146
"2019-10-07 10:10:20","2019-10-08 03:00:00","2019-10-08 03:30:00",2508,553,3061
"2019-10-07 10:10:20","2019-10-08 04:00:00","2019-10-08 04:30:00",2480,533,3013
"2019-10-07 10:10:20","2019-10-08 05:00:00","2019-10-08 05:30:00",2526,537,3063
"2019-10-07 10:10:20","2019-10-08 06:00:00","2019-10-08 06:30:00",2726,613,3339
"2019-10-07 10:10:20","2019-10-08 07:00:00","2019-10-08 07:30:00",3272,840,4112
"2019-10-07 10:10:20","2019-10-08 08:00:00","2019-10-08 08:30:00",3804,1025,4829
"2019-10-07 10:10:20","2019-10-08 09:00:00","2019-10-08 09:30:00",3846,1056,4902
"2019-10-07 10:10:20","2019-10-08 10:00:00","2019-10-08 10:30:00",3865,1081,4946
"2019-10-07 10:10:20","2019-10-08 11:00:00","2019-10-08 11:30:00",3852,1079,4931
"2019-10-07 10:10:20","2019-10-08 12:00:00","2019-10-08 12:30:00",3858,1075,4933
"2019-10-07 10:10:20","2019-10-08 13:00:00","2019-10-08 13:30:00",3849,1062,4911
"2019-10-07 10:10:20","2019-10-08 14:00:00","2019-10-08 14:30:00",3775,1018,4793
"2019-10-07 10:10:20","2019-10-08 15:00:00","2019-10-08 15:30:00",3762,1015,4777
"2019-10-07 10:10:20","2019-10-08 16:00:00","2019-10-08 16:30:00",3835,1035,4870
"2019-10-07 10:10:20","2019-10-08 17:00:00","2019-10-08 17:30:00",3960,1141,5101
"2019-10-07 10:10:20","2019-10-08 18:00:00","2019-10-08 18:30:00",4042,1154,5196
"2019-10-07 10:10:20","2019-10-08 19:00:00","2019-10-08 19:30:00",4150,1127,5277
"2019-10-07 10:10:20","2019-10-08 20:00:00","2019-10-08 20:30:00",4121,1184,5305
"2019-10-07 10:10:20","2019-10-08 21:00:00","2019-10-08 21:30:00",3829,1109,4938
"2019-10-07 10:10:20","2019-10-08 22:00:00","2019-10-08 22:30:00",3494,970,4464
"2019-10-08 10:10:11","2019-10-08 23:00:00","2019-10-08 23:30:00",3071,696,3767
"2019-10-08 10:10:11","2019-10-09 00:00:00","2019-10-09 00:30:00",2806,660,3466
"2019-10-08 10:10:11","2019-10-09 01:00:00","2019-10-09 01:30:00",2687,608,3295
"2019-10-08 10:10:11","2019-10-09 02:00:00","2019-10-09 02:30:00",2555,589,3144
"2019-10-08 10:10:11","2019-10-09 03:00:00","2019-10-09 03:30:00",2488,581,3069
"2019-10-08 10:10:11","2019-10-09 04:00:00","2019-10-09 04:30:00",2460,573,3033
"2019-10-08 10:10:11","2019-10-09 05:00:00","2019-10-09 05:30:00",2506,583,3089
"2019-10-08 10:10:11","2019-10-09 06:00:00","2019-10-09 06:30:00",2703,669,3372
"2019-10-08 10:10:11","2019-10-09 07:00:00","2019-10-09 07:30:00",3242,866,4108
"2019-10-08 10:10:11","2019-10-09 08:00:00","2019-10-09 08:30:00",3769,1059,4828
"2019-10-08 10:10:11","2019-10-09 09:00:00","2019-10-09 09:30:00",3810,1094,4904
"2019-10-08 10:10:11","2019-10-09 10:00:00","2019-10-09 10:30:00",3829,1089,4918
"2019-10-08 10:10:11","2019-10-09 11:00:00","2019-10-09 11:30:00",3816,1084,4900
"2019-10-08 10:10:11","2019-10-09 12:00:00","2019-10-09 12:30:00",3822,1040,4862
"2019-10-08 10:10:11","2019-10-09 13:00:00","2019-10-09 13:30:00",3813,1064,4877
"2019-10-08 10:10:11","2019-10-09 14:00:00","2019-10-09 14:30:00",3740,1047,4787
"2019-10-08 10:10:11","2019-10-09 15:00:00","2019-10-09 15:30:00",3727,1039,4766
"2019-10-08 10:10:11","2019-10-09 16:00:00","2019-10-09 16:30:00",3799,1075,4874
"2019-10-08 10:10:11","2019-10-09 17:00:00","2019-10-09 17:30:00",3922,1173,5095
"2019-10-08 10:10:11","2019-10-09 18:00:00","2019-10-09 18:30:00",4004,1160,5164
"2019-10-08 10:10:11","2019-10-09 19:00:00","2019-10-09 19:30:00",4110,1160,5270
"2019-10-08 10:10:11","2019-10-09 20:00:00","2019-10-09 20:30:00",4082,1170,5252
"2019-10-08 10:10:11","2019-10-09 21:00:00","2019-10-09 21:30:00",3793,1051,4844
"2019-10-08 10:10:11","2019-10-09 22:00:00","2019-10-09 22:30:00",3462,931,4393
"2019-10-09 10:10:31","2019-10-09 23:00:00","2019-10-09 23:30:00",3071,769,3840
"2019-10-09 10:10:31","2019-10-10 00:00:00","2019-10-10 00:30:00",2806,642,3448
"2019-10-09 10:10:31","2019-10-10 01:00:00","2019-10-10 01:30:00",2687,591,3278
"2019-10-09 10:10:31","2019-10-10 02:00:00","2019-10-10 02:30:00",2555,575,3130
"2019-10-09 10:10:31","2019-10-10 03:00:00","2019-10-10 03:30:00",2488,559,3047
"2019-10-09 10:10:31","2019-10-10 04:00:00","2019-10-10 04:30:00",2460,543,3003
"2019-10-09 10:10:31","2019-10-10 05:00:00","2019-10-10 05:30:00",2506,562,3068
"2019-10-09 10:10:31","2019-10-10 06:00:00","2019-10-10 06:30:00",2703,680,3383
"2019-10-09 10:10:31","2019-10-10 07:00:00","2019-10-10 07:30:00",3242,920,4162
"2019-10-09 10:10:31","2019-10-10 08:00:00","2019-10-10 08:30:00",3769,1040,4809
"2019-10-09 10:10:31","2019-10-10 09:00:00","2019-10-10 09:30:00",3810,1087,4897
"2019-10-09 10:10:31","2019-10-10 10:00:00","2019-10-10 10:30:00",3829,1098,4927
"2019-10-09 10:10:31","2019-10-10 11:00:00","2019-10-10 11:30:00",3816,1100,4916
"2019-10-09 10:10:31","2019-10-10 12:00:00","2019-10-10 12:30:00",3822,1060,4882
"2019-10-09 10:10:31","2019-10-10 13:00:00","2019-10-10 13:30:00",3813,1050,4863
"2019-10-09 10:10:31","2019-10-10 14:00:00","2019-10-10 14:30:00",3740,1034,4774
"2019-10-09 10:10:31","2019-10-10 15:00:00","2019-10-10 15:30:00",3727,1030,4757
"2019-10-09 10:10:31","2019-10-10 16:00:00","2019-10-10 16:30:00",3799,1060,4859
"2019-10-09 10:10:31","2019-10-10 17:00:00","2019-10-10 17:30:00",3922,1140,5062
"2019-10-09 10:10:31","2019-10-10 18:00:00","2019-10-10 18:30:00",4004,1155,5159
"2019-10-09 10:10:31","2019-10-10 19:00:00","2019-10-10 19:30:00",4110,1150,5260
"2019-10-09 10:10:31","2019-10-10 20:00:00","2019-10-10 20:30:00",4082,1125,5207
"2019-10-09 10:10:31","2019-10-10 21:00:00","2019-10-10 21:30:00",3793,1009,4802
"2019-10-09 10:10:31","2019-10-10 22:00:00","2019-10-10 22:30:00",3462,882,4344
"2019-10-10 10:10:15","2019-10-10 23:00:00","2019-10-10 23:30:00",3023,811,3834
"2019-10-10 10:10:15","2019-10-11 00:00:00","2019-10-11 00:30:00",2834,634,3468
"2019-10-10 10:10:15","2019-10-11 01:00:00","2019-10-11 01:30:00",2711,585,3296
"2019-10-10 10:10:15","2019-10-11 02:00:00","2019-10-11 02:30:00",2599,557,3156
"2019-10-10 10:10:15","2019-10-11 03:00:00","2019-10-11 03:30:00",2530,535,3065
"2019-10-10 10:10:15","2019-10-11 04:00:00","2019-10-11 04:30:00",2506,520,3026
"2019-10-10 10:10:15","2019-10-11 05:00:00","2019-10-11 05:30:00",2534,568,3102
"2019-10-10 10:10:15","2019-10-11 06:00:00","2019-10-11 06:30:00",2749,670,3419
"2019-10-10 10:10:15","2019-10-11 07:00:00","2019-10-11 07:30:00",3248,880,4128
"2019-10-10 10:10:15","2019-10-11 08:00:00","2019-10-11 08:30:00",3764,1031,4795
"2019-10-10 10:10:15","2019-10-11 09:00:00","2019-10-11 09:30:00",3889,1070,4959
"2019-10-10 10:10:15","2019-10-11 10:00:00","2019-10-11 10:30:00",3895,1074,4969
"2019-10-10 10:10:15","2019-10-11 11:00:00","2019-10-11 11:30:00",3853,1037,4890
"2019-10-10 10:10:15","2019-10-11 12:00:00","2019-10-11 12:30:00",3885,998,4883
"2019-10-10 10:10:15","2019-10-11 13:00:00","2019-10-11 13:30:00",3876,1004,4880
"2019-10-10 10:10:15","2019-10-11 14:00:00","2019-10-11 14:30:00",3745,1004,4749
"2019-10-10 10:10:15","2019-10-11 15:00:00","2019-10-11 15:30:00",3739,1002,4741
"2019-10-10 10:10:15","2019-10-11 16:00:00","2019-10-11 16:30:00",3768,1040,4808
"2019-10-10 10:10:15","2019-10-11 17:00:00","2019-10-11 17:30:00",3834,1140,4974
"2019-10-10 10:10:15","2019-10-11 18:00:00","2019-10-11 18:30:00",3951,1140,5091
"2019-10-10 10:10:15","2019-10-11 19:00:00","2019-10-11 19:30:00",3940,1120,5060
"2019-10-10 10:10:15","2019-10-11 20:00:00","2019-10-11 20:30:00",3983,1090,5073
"2019-10-10 10:10:15","2019-10-11 21:00:00","2019-10-11 21:30:00",3705,1024,4729
"2019-10-10 10:10:15","2019-10-11 22:00:00","2019-10-11 22:30:00",3370,902,4272
"2019-10-10 10:10:15","2019-10-11 23:00:00","2019-10-11 23:30:00",3075,783,3858
"2019-10-10 10:10:15","2019-10-12 00:00:00","2019-10-12 00:30:00",2863,701,3564
"2019-10-10 10:10:15","2019-10-12 01:00:00","2019-10-12 01:30:00",2720,638,3358
"2019-10-10 10:10:15","2019-10-12 02:00:00","2019-10-12 02:30:00",2564,605,3169
"2019-10-10 10:10:15","2019-10-12 03:00:00","2019-10-12 03:30:00",2471,588,3059
"2019-10-10 10:10:15","2019-10-12 04:00:00","2019-10-12 04:30:00",2455,579,3034
"2019-10-10 10:10:15","2019-10-12 05:00:00","2019-10-12 05:30:00",2445,575,3020
"2019-10-10 10:10:15","2019-10-12 06:00:00","2019-10-12 06:30:00",2537,610,3147
"2019-10-10 10:10:15","2019-10-12 07:00:00","2019-10-12 07:30:00",2744,702,3446
"2019-10-10 10:10:15","2019-10-12 08:00:00","2019-10-12 08:30:00",2996,807,3803
"2019-10-10 10:10:15","2019-10-12 09:00:00","2019-10-12 09:30:00",3354,953,4307
"2019-10-10 10:10:15","2019-10-12 10:00:00","2019-10-12 10:30:00",3540,984,4524
"2019-10-10 10:10:15","2019-10-12 11:00:00","2019-10-12 11:30:00",3604,987,4591
"2019-10-10 10:10:15","2019-10-12 12:00:00","2019-10-12 12:30:00",3562,989,4551
"2019-10-10 10:10:15","2019-10-12 13:00:00","2019-10-12 13:30:00",3565,952,4517
"2019-10-10 10:10:15","2019-10-12 14:00:00","2019-10-12 14:30:00",3513,925,4438
"2019-10-10 10:10:15","2019-10-12 15:00:00","2019-10-12 15:30:00",3434,901,4335
"2019-10-10 10:10:15","2019-10-12 16:00:00","2019-10-12 16:30:00",3451,927,4378
"2019-10-10 10:10:15","2019-10-12 17:00:00","2019-10-12 17:30:00",3567,997,4564
"2019-10-10 10:10:15","2019-10-12 18:00:00","2019-10-12 18:30:00",3655,1053,4708
"2019-10-10 10:10:15","2019-10-12 19:00:00","2019-10-12 19:30:00",3674,1045,4719
"2019-10-10 10:10:15","2019-10-12 20:00:00","2019-10-12 20:30:00",3599,994,4593
"2019-10-10 10:10:15","2019-10-12 21:00:00","2019-10-12 21:30:00",3394,946,4340
"2019-10-10 10:10:15","2019-10-12 22:00:00","2019-10-12 22:30:00",3157,860,4017
"2019-10-10 10:10:15","2019-10-12 23:00:00","2019-10-12 23:30:00",2876,762,3638
"2019-10-10 10:10:15","2019-10-13 00:00:00","2019-10-13 00:30:00",2722,685,3407
"2019-10-10 10:10:15","2019-10-13 01:00:00","2019-10-13 01:30:00",2626,615,3241
"2019-10-10 10:10:15","2019-10-13 02:00:00","2019-10-13 02:30:00",2473,583,3056
"2019-10-10 10:10:15","2019-10-13 03:00:00","2019-10-13 03:30:00",2376,557,2933
"2019-10-10 10:10:15","2019-10-13 04:00:00","2019-10-13 04:30:00",2337,538,2875
"2019-10-10 10:10:15","2019-10-13 05:00:00","2019-10-13 05:30:00",2345,553,2898
"2019-10-10 10:10:15","2019-10-13 06:00:00","2019-10-13 06:30:00",2397,579,2976
"2019-10-10 10:10:15","2019-10-13 07:00:00","2019-10-13 07:30:00",2514,637,3151
"2019-10-10 10:10:15","2019-10-13 08:00:00","2019-10-13 08:30:00",2655,716,3371
"2019-10-10 10:10:15","2019-10-13 09:00:00","2019-10-13 09:30:00",2924,810,3734
"2019-10-10 10:10:15","2019-10-13 10:00:00","2019-10-13 10:30:00",3200,842,4042
"2019-10-10 10:10:15","2019-10-13 11:00:00","2019-10-13 11:30:00",3291,872,4163
"2019-10-10 10:10:15","2019-10-13 12:00:00","2019-10-13 12:30:00",3360,901,4261
"2019-10-10 10:10:15","2019-10-13 13:00:00","2019-10-13 13:30:00",3387,925,4312
"2019-10-10 10:10:15","2019-10-13 14:00:00","2019-10-13 14:30:00",3319,867,4186
"2019-10-10 10:10:15","2019-10-13 15:00:00","2019-10-13 15:30:00",3222,838,4060
"2019-10-10 10:10:15","2019-10-13 16:00:00","2019-10-13 16:30:00",3220,849,4069
"2019-10-10 10:10:15","2019-10-13 17:00:00","2019-10-13 17:30:00",3323,930,4253
"2019-10-10 10:10:15","2019-10-13 18:00:00","2019-10-13 18:30:00",3474,1001,4475
"2019-10-10 10:10:15","2019-10-13 19:00:00","2019-10-13 19:30:00",3625,1039,4664
"2019-10-10 10:10:15","2019-10-13 20:00:00","2019-10-13 20:30:00",3643,1036,4679
"2019-10-10 10:10:15","2019-10-13 21:00:00","2019-10-13 21:30:00",3450,961,4411
"2019-10-10 10:10:15","2019-10-13 22:00:00","2019-10-13 22:30:00",3155,861,4016
"2019-10-13 10:10:26","2019-10-13 23:00:00","2019-10-13 23:30:00",2782,782,3564
"2019-10-13 10:10:26","2019-10-14 00:00:00","2019-10-14 00:30:00",2580,621,3201
"2019-10-13 10:10:26","2019-10-14 01:00:00","2019-10-14 01:30:00",2487,551,3038
"2019-10-13 10:10:26","2019-10-14 02:00:00","2019-10-14 02:30:00",2370,514,2884
"2019-10-13 10:10:26","2019-10-14 03:00:00","2019-10-14 03:30:00",2285,505,2790
"2019-10-13 10:10:26","2019-10-14 04:00:00","2019-10-14 04:30:00",2284,512,2796
"2019-10-13 10:10:26","2019-10-14 05:00:00","2019-10-14 05:30:00",2339,537,2876
"2019-10-13 10:10:26","2019-10-14 06:00:00","2019-10-14 06:30:00",2533,627,3160
"2019-10-13 10:10:26","2019-10-14 07:00:00","2019-10-14 07:30:00",3062,844,3906
"2019-10-13 10:10:26","2019-10-14 08:00:00","2019-10-14 08:30:00",3677,1063,4740
"2019-10-13 10:10:26","2019-10-14 09:00:00","2019-10-14 09:30:00",3824,1094,4918
"2019-10-13 10:10:26","2019-10-14 10:00:00","2019-10-14 10:30:00",3845,1088,4933
"2019-10-13 10:10:26","2019-10-14 11:00:00","2019-10-14 11:30:00",3840,1105,4945
"2019-10-13 10:10:26","2019-10-14 12:00:00","2019-10-14 12:30:00",3850,1083,4933
"2019-10-13 10:10:26","2019-10-14 13:00:00","2019-10-14 13:30:00",3850,1100,4950
"2019-10-13 10:10:26","2019-10-14 14:00:00","2019-10-14 14:30:00",3770,1021,4791
"2019-10-13 10:10:26","2019-10-14 15:00:00","2019-10-14 15:30:00",3780,1017,4797
"2019-10-13 10:10:26","2019-10-14 16:00:00","2019-10-14 16:30:00",3795,1047,4842
"2019-10-13 10:10:26","2019-10-14 17:00:00","2019-10-14 17:30:00",3930,1116,5046
"2019-10-13 10:10:26","2019-10-14 18:00:00","2019-10-14 18:30:00",3970,1127,5097
"2019-10-13 10:10:26","2019-10-14 19:00:00","2019-10-14 19:30:00",4136,1135,5271
"2019-10-13 10:10:26","2019-10-14 20:00:00","2019-10-14 20:30:00",4047,1138,5185
"2019-10-13 10:10:26","2019-10-14 21:00:00","2019-10-14 21:30:00",3793,1043,4836
"2019-10-13 10:10:26","2019-10-14 22:00:00","2019-10-14 22:30:00",3392,918,4310
"2019-10-14 10:10:10","2019-10-14 23:00:00","2019-10-14 23:30:00",3044,836,3880
"2019-10-14 10:10:10","2019-10-15 00:00:00","2019-10-15 00:30:00",2782,652,3434
"2019-10-14 10:10:10","2019-10-15 01:00:00","2019-10-15 01:30:00",2673,589,3262
"2019-10-14 10:10:10","2019-10-15 02:00:00","2019-10-15 02:30:00",2545,572,3117
"2019-10-14 10:10:10","2019-10-15 03:00:00","2019-10-15 03:30:00",2469,569,3038
"2019-10-14 10:10:10","2019-10-15 04:00:00","2019-10-15 04:30:00",2440,558,2998
"2019-10-14 10:10:10","2019-10-15 05:00:00","2019-10-15 05:30:00",2480,582,3062
"2019-10-14 10:10:10","2019-10-15 06:00:00","2019-10-15 06:30:00",2696,663,3359
"2019-10-14 10:10:10","2019-10-15 07:00:00","2019-10-15 07:30:00",3249,877,4126
"2019-10-14 10:10:10","2019-10-15 08:00:00","2019-10-15 08:30:00",3765,1058,4823
"2019-10-14 10:10:10","2019-10-15 09:00:00","2019-10-15 09:30:00",3829,1096,4925
"2019-10-14 10:10:10","2019-10-15 10:00:00","2019-10-15 10:30:00",3875,1100,4975
"2019-10-14 10:10:10","2019-10-15 11:00:00","2019-10-15 11:30:00",3804,1087,4891
"2019-10-14 10:10:10","2019-10-15 12:00:00","2019-10-15 12:30:00",3841,1080,4921
"2019-10-14 10:10:10","2019-10-15 13:00:00","2019-10-15 13:30:00",3848,1072,4920
"2019-10-14 10:10:10","2019-10-15 14:00:00","2019-10-15 14:30:00",3824,1034,4858
"2019-10-14 10:10:10","2019-10-15 15:00:00","2019-10-15 15:30:00",3788,1008,4796
"2019-10-14 10:10:10","2019-10-15 16:00:00","2019-10-15 16:30:00",3887,1053,4940
"2019-10-14 10:10:10","2019-10-15 17:00:00","2019-10-15 17:30:00",3990,1126,5116
"2019-10-14 10:10:10","2019-10-15 18:00:00","2019-10-15 18:30:00",4053,1133,5186
"2019-10-14 10:10:10","2019-10-15 19:00:00","2019-10-15 19:30:00",4126,1158,5284
"2019-10-14 10:10:10","2019-10-15 20:00:00","2019-10-15 20:30:00",4149,1116,5265
"2019-10-14 10:10:10","2019-10-15 21:00:00","2019-10-15 21:30:00",3906,1016,4922
"2019-10-14 10:10:10","2019-10-15 22:00:00","2019-10-15 22:30:00",3545,895,4440
"2019-10-15 10:10:31","2019-10-15 23:00:00","2019-10-15 23:30:00",3147,836,3983
"2019-10-15 10:10:31","2019-10-16 00:00:00","2019-10-16 00:30:00",2808,676,3484
"2019-10-15 10:10:31","2019-10-16 01:00:00","2019-10-16 01:30:00",2734,616,3350
"2019-10-15 10:10:31","2019-10-16 02:00:00","2019-10-16 02:30:00",2588,597,3185
"2019-10-15 10:10:31","2019-10-16 03:00:00","2019-10-16 03:30:00",2469,578,3047
"2019-10-15 10:10:31","2019-10-16 04:00:00","2019-10-16 04:30:00",2395,563,2958
"2019-10-15 10:10:31","2019-10-16 05:00:00","2019-10-16 05:30:00",2466,581,3047
"2019-10-15 10:10:31","2019-10-16 06:00:00","2019-10-16 06:30:00",2636,667,3303
"2019-10-15 10:10:31","2019-10-16 07:00:00","2019-10-16 07:30:00",3147,888,4035
"2019-10-15 10:10:31","2019-10-16 08:00:00","2019-10-16 08:30:00",3681,1109,4790
"2019-10-15 10:10:31","2019-10-16 09:00:00","2019-10-16 09:30:00",3781,1121,4902
"2019-10-15 10:10:31","2019-10-16 10:00:00","2019-10-16 10:30:00",3849,1133,4982
"2019-10-15 10:10:31","2019-10-16 11:00:00","2019-10-16 11:30:00",3818,1135,4953
"2019-10-15 10:10:31","2019-10-16 12:00:00","2019-10-16 12:30:00",3803,1129,4932
"2019-10-15 10:10:31","2019-10-16 13:00:00","2019-10-16 13:30:00",3841,1121,4962
"2019-10-15 10:10:31","2019-10-16 14:00:00","2019-10-16 14:30:00",3746,1075,4821
"2019-10-15 10:10:31","2019-10-16 15:00:00","2019-10-16 15:30:00",3779,1082,4861
"2019-10-15 10:10:31","2019-10-16 16:00:00","2019-10-16 16:30:00",3835,1132,4967
"2019-10-15 10:10:31","2019-10-16 17:00:00","2019-10-16 17:30:00",3991,1233,5224
"2019-10-15 10:10:31","2019-10-16 18:00:00","2019-10-16 18:30:00",4116,1251,5367
"2019-10-15 10:10:31","2019-10-16 19:00:00","2019-10-16 19:30:00",4217,1268,5485
"2019-10-15 10:10:31","2019-10-16 20:00:00","2019-10-16 20:30:00",4143,1193,5336
"2019-10-15 10:10:31","2019-10-16 21:00:00","2019-10-16 21:30:00",3875,1118,4993
"2019-10-15 10:10:31","2019-10-16 22:00:00","2019-10-16 22:30:00",3517,980,4497
"2019-10-16 10:10:16","2019-10-16 23:00:00","2019-10-16 23:30:00",3045,817,3862
"2019-10-16 10:10:16","2019-10-17 00:00:00","2019-10-17 00:30:00",2807,650,3457
"2019-10-16 10:10:16","2019-10-17 01:00:00","2019-10-17 01:30:00",2707,590,3297
"2019-10-16 10:10:16","2019-10-17 02:00:00","2019-10-17 02:30:00",2584,570,3154
"2019-10-16 10:10:16","2019-10-17 03:00:00","2019-10-17 03:30:00",2483,550,3033
"2019-10-16 10:10:16","2019-10-17 04:00:00","2019-10-17 04:30:00",2470,550,3020
"2019-10-16 10:10:16","2019-10-17 05:00:00","2019-10-17 05:30:00",2514,560,3074
"2019-10-16 10:10:16","2019-10-17 06:00:00","2019-10-17 06:30:00",2694,650,3344
"2019-10-16 10:10:16","2019-10-17 07:00:00","2019-10-17 07:30:00",3211,909,4120
"2019-10-16 10:10:16","2019-10-17 08:00:00","2019-10-17 08:30:00",3735,1095,4830
"2019-10-16 10:10:16","2019-10-17 09:00:00","2019-10-17 09:30:00",3794,1090,4884
"2019-10-16 10:10:16","2019-10-17 10:00:00","2019-10-17 10:30:00",3766,1126,4892
"2019-10-16 10:10:16","2019-10-17 11:00:00","2019-10-17 11:30:00",3726,1096,4822
"2019-10-16 10:10:16","2019-10-17 12:00:00","2019-10-17 12:30:00",3712,1102,4814
"2019-10-16 10:10:16","2019-10-17 13:00:00","2019-10-17 13:30:00",3755,1089,4844
"2019-10-16 10:10:16","2019-10-17 14:00:00","2019-10-17 14:30:00",3729,1093,4822
"2019-10-16 10:10:16","2019-10-17 15:00:00","2019-10-17 15:30:00",3735,1075,4810
"2019-10-16 10:10:16","2019-10-17 16:00:00","2019-10-17 16:30:00",3815,1138,4953
"2019-10-16 10:10:16","2019-10-17 17:00:00","2019-10-17 17:30:00",3945,1237,5182
"2019-10-16 10:10:16","2019-10-17 18:00:00","2019-10-17 18:30:00",4072,1240,5312
"2019-10-16 10:10:16","2019-10-17 19:00:00","2019-10-17 19:30:00",4240,1258,5498
"2019-10-16 10:10:16","2019-10-17 20:00:00","2019-10-17 20:30:00",4066,1199,5265
"2019-10-16 10:10:16","2019-10-17 21:00:00","2019-10-17 21:30:00",3845,1108,4953
"2019-10-16 10:10:16","2019-10-17 22:00:00","2019-10-17 22:30:00",3458,993,4451
"2019-10-17 10:10:36","2019-10-17 23:00:00","2019-10-17 23:30:00",3057,786,3843
"2019-10-17 10:10:36","2019-10-18 00:00:00","2019-10-18 00:30:00",2797,705,3502
"2019-10-17 10:10:36","2019-10-18 01:00:00","2019-10-18 01:30:00",2690,623,3313
"2019-10-17 10:10:36","2019-10-18 02:00:00","2019-10-18 02:30:00",2560,594,3154
"2019-10-17 10:10:36","2019-10-18 03:00:00","2019-10-18 03:30:00",2500,579,3079
"2019-10-17 10:10:36","2019-10-18 04:00:00","2019-10-18 04:30:00",2456,574,3030
"2019-10-17 10:10:36","2019-10-18 05:00:00","2019-10-18 05:30:00",2499,596,3095
"2019-10-17 10:10:36","2019-10-18 06:00:00","2019-10-18 06:30:00",2684,692,3376
"2019-10-17 10:10:36","2019-10-18 07:00:00","2019-10-18 07:30:00",3186,907,4093
"2019-10-17 10:10:36","2019-10-18 08:00:00","2019-10-18 08:30:00",3716,1136,4852
"2019-10-17 10:10:36","2019-10-18 09:00:00","2019-10-18 09:30:00",3775,1157,4932
"2019-10-17 10:10:36","2019-10-18 10:00:00","2019-10-18 10:30:00",3785,1157,4942
"2019-10-17 10:10:36","2019-10-18 11:00:00","2019-10-18 11:30:00",3778,1139,4917
"2019-10-17 10:10:36","2019-10-18 12:00:00","2019-10-18 12:30:00",3762,1128,4890
"2019-10-17 10:10:36","2019-10-18 13:00:00","2019-10-18 13:30:00",3744,1111,4855
"2019-10-17 10:10:36","2019-10-18 14:00:00","2019-10-18 14:30:00",3685,1054,4739
"2019-10-17 10:10:36","2019-10-18 15:00:00","2019-10-18 15:30:00",3681,1025,4706
"2019-10-17 10:10:36","2019-10-18 16:00:00","2019-10-18 16:30:00",3703,1049,4752
"2019-10-17 10:10:36","2019-10-18 17:00:00","2019-10-18 17:30:00",3781,1150,4931
"2019-10-17 10:10:36","2019-10-18 18:00:00","2019-10-18 18:30:00",3860,1210,5070
"2019-10-17 10:10:36","2019-10-18 19:00:00","2019-10-18 19:30:00",4055,1190,5245
"2019-10-17 10:10:36","2019-10-18 20:00:00","2019-10-18 20:30:00",3892,1091,4983
"2019-10-17 10:10:36","2019-10-18 21:00:00","2019-10-18 21:30:00",3644,1004,4648
"2019-10-17 10:10:36","2019-10-18 22:00:00","2019-10-18 22:30:00",3346,888,4234
"2019-10-18 10:10:16","2019-10-18 23:00:00","2019-10-18 23:30:00",3026,780,3806
"2019-10-18 10:10:16","2019-10-19 00:00:00","2019-10-19 00:30:00",2901,728,3629
"2019-10-18 10:10:16","2019-10-19 01:00:00","2019-10-19 01:30:00",2733,674,3407
"2019-10-18 10:10:16","2019-10-19 02:00:00","2019-10-19 02:30:00",2578,638,3216
"2019-10-18 10:10:16","2019-10-19 03:00:00","2019-10-19 03:30:00",2477,626,3103
"2019-10-18 10:10:16","2019-10-19 04:00:00","2019-10-19 04:30:00",2401,603,3004
"2019-10-18 10:10:16","2019-10-19 05:00:00","2019-10-19 05:30:00",2425,588,3013
"2019-10-18 10:10:16","2019-10-19 06:00:00","2019-10-19 06:30:00",2502,626,3128
"2019-10-18 10:10:16","2019-10-19 07:00:00","2019-10-19 07:30:00",2693,718,3411
"2019-10-18 10:10:16","2019-10-19 08:00:00","2019-10-19 08:30:00",3011,823,3834
"2019-10-18 10:10:16","2019-10-19 09:00:00","2019-10-19 09:30:00",3332,943,4275
"2019-10-18 10:10:16","2019-10-19 10:00:00","2019-10-19 10:30:00",3507,986,4493
"2019-10-18 10:10:16","2019-10-19 11:00:00","2019-10-19 11:30:00",3602,997,4599
"2019-10-18 10:10:16","2019-10-19 12:00:00","2019-10-19 12:30:00",3671,1007,4678
"2019-10-18 10:10:16","2019-10-19 13:00:00","2019-10-19 13:30:00",3684,983,4667
"2019-10-18 10:10:16","2019-10-19 14:00:00","2019-10-19 14:30:00",3579,924,4503
"2019-10-18 10:10:16","2019-10-19 15:00:00","2019-10-19 15:30:00",3481,920,4401
"2019-10-18 10:10:16","2019-10-19 16:00:00","2019-10-19 16:30:00",3440,932,4372
"2019-10-18 10:10:16","2019-10-19 17:00:00","2019-10-19 17:30:00",3586,1034,4620
"2019-10-18 10:10:16","2019-10-19 18:00:00","2019-10-19 18:30:00",3698,1066,4764
"2019-10-18 10:10:16","2019-10-19 19:00:00","2019-10-19 19:30:00",3800,1135,4935
"2019-10-18 10:10:16","2019-10-19 20:00:00","2019-10-19 20:30:00",3603,1076,4679
"2019-10-18 10:10:16","2019-10-19 21:00:00","2019-10-19 21:30:00",3403,992,4395
"2019-10-18 10:10:16","2019-10-19 22:00:00","2019-10-19 22:30:00",3166,893,4059
"2019-10-19 10:10:36","2019-10-19 23:00:00","2019-10-19 23:30:00",2921,792,3713
"2019-10-19 10:10:36","2019-10-20 00:00:00","2019-10-20 00:30:00",2729,714,3443
"2019-10-19 10:10:36","2019-10-20 01:00:00","2019-10-20 01:30:00",2589,647,3236
"2019-10-19 10:10:36","2019-10-20 02:00:00","2019-10-20 02:30:00",2445,622,3067
"2019-10-19 10:10:36","2019-10-20 03:00:00","2019-10-20 03:30:00",2378,610,2988
"2019-10-19 10:10:36","2019-10-20 04:00:00","2019-10-20 04:30:00",2308,587,2895
"2019-10-19 10:10:36","2019-10-20 05:00:00","2019-10-20 05:30:00",2267,580,2847
"2019-10-19 10:10:36","2019-10-20 06:00:00","2019-10-20 06:30:00",2293,605,2898
"2019-10-19 10:10:36","2019-10-20 07:00:00","2019-10-20 07:30:00",2396,646,3042
"2019-10-19 10:10:36","2019-10-20 08:00:00","2019-10-20 08:30:00",2601,714,3315
"2019-10-19 10:10:36","2019-10-20 09:00:00","2019-10-20 09:30:00",2889,825,3714
"2019-10-19 10:10:36","2019-10-20 10:00:00","2019-10-20 10:30:00",3133,920,4053
"2019-10-19 10:10:36","2019-10-20 11:00:00","2019-10-20 11:30:00",3344,976,4320
"2019-10-19 10:10:36","2019-10-20 12:00:00","2019-10-20 12:30:00",3373,1002,4375
"2019-10-19 10:10:36","2019-10-20 13:00:00","2019-10-20 13:30:00",3458,1005,4463
"2019-10-19 10:10:36","2019-10-20 14:00:00","2019-10-20 14:30:00",3323,908,4231
"2019-10-19 10:10:36","2019-10-20 15:00:00","2019-10-20 15:30:00",3207,875,4082
"2019-10-19 10:10:36","2019-10-20 16:00:00","2019-10-20 16:30:00",3196,893,4089
"2019-10-19 10:10:36","2019-10-20 17:00:00","2019-10-20 17:30:00",3280,991,4271
"2019-10-19 10:10:36","2019-10-20 18:00:00","2019-10-20 18:30:00",3459,1072,4531
"2019-10-19 10:10:36","2019-10-20 19:00:00","2019-10-20 19:30:00",3782,1130,4912
"2019-10-19 10:10:36","2019-10-20 20:00:00","2019-10-20 20:30:00",3632,1082,4714
"2019-10-19 10:10:36","2019-10-20 21:00:00","2019-10-20 21:30:00",3422,1009,4431
"2019-10-19 10:10:36","2019-10-20 22:00:00","2019-10-20 22:30:00",3135,902,4037
"2019-10-20 10:10:15","2019-10-20 23:00:00","2019-10-20 23:30:00",2803,755,3558
"2019-10-20 10:10:15","2019-10-21 00:00:00","2019-10-21 00:30:00",2554,695,3249
"2019-10-20 10:10:15","2019-10-21 01:00:00","2019-10-21 01:30:00",2420,636,3056
"2019-10-20 10:10:15","2019-10-21 02:00:00","2019-10-21 02:30:00",2305,619,2924
"2019-10-20 10:10:15","2019-10-21 03:00:00","2019-10-21 03:30:00",2249,624,2873
"2019-10-20 10:10:15","2019-10-21 04:00:00","2019-10-21 04:30:00",2278,615,2893
"2019-10-20 10:10:15","2019-10-21 05:00:00","2019-10-21 05:30:00",2353,626,2979
"2019-10-20 10:10:15","2019-10-21 06:00:00","2019-10-21 06:30:00",2590,696,3286
"2019-10-20 10:10:15","2019-10-21 07:00:00","2019-10-21 07:30:00",3112,922,4034
"2019-10-20 10:10:15","2019-10-21 08:00:00","2019-10-21 08:30:00",3684,1163,4847
"2019-10-20 10:10:15","2019-10-21 09:00:00","2019-10-21 09:30:00",3740,1190,4930
"2019-10-20 10:10:15","2019-10-21 10:00:00","2019-10-21 10:30:00",3767,1208,4975
"2019-10-20 10:10:15","2019-10-21 11:00:00","2019-10-21 11:30:00",3798,1183,4981
"2019-10-20 10:10:15","2019-10-21 12:00:00","2019-10-21 12:30:00",3800,1182,4982
"2019-10-20 10:10:15","2019-10-21 13:00:00","2019-10-21 13:30:00",3863,1178,5041
"2019-10-20 10:10:15","2019-10-21 14:00:00","2019-10-21 14:30:00",3801,1147,4948
"2019-10-20 10:10:15","2019-10-21 15:00:00","2019-10-21 15:30:00",3822,1153,4975
"2019-10-20 10:10:15","2019-10-21 16:00:00","2019-10-21 16:30:00",3873,1198,5071
"2019-10-20 10:10:15","2019-10-21 17:00:00","2019-10-21 17:30:00",4030,1312,5342
"2019-10-20 10:10:15","2019-10-21 18:00:00","2019-10-21 18:30:00",4155,1310,5465
"2019-10-20 10:10:15","2019-10-21 19:00:00","2019-10-21 19:30:00",4247,1352,5599
"2019-10-20 10:10:15","2019-10-21 20:00:00","2019-10-21 20:30:00",4122,1277,5399
"2019-10-20 10:10:15","2019-10-21 21:00:00","2019-10-21 21:30:00",3836,1207,5043
"2019-10-20 10:10:15","2019-10-21 22:00:00","2019-10-21 22:30:00",3448,1061,4509
"2019-10-21 10:10:35","2019-10-21 23:00:00","2019-10-21 23:30:00",3114,825,3939
"2019-10-21 10:10:35","2019-10-22 00:00:00","2019-10-22 00:30:00",2915,697,3612
"2019-10-21 10:10:35","2019-10-22 01:00:00","2019-10-22 01:30:00",2761,627,3388
"2019-10-21 10:10:35","2019-10-22 02:00:00","2019-10-22 02:30:00",2632,614,3246
"2019-10-21 10:10:35","2019-10-22 03:00:00","2019-10-22 03:30:00",2537,612,3149
"2019-10-21 10:10:35","2019-10-22 04:00:00","2019-10-22 04:30:00",2490,599,3089
"2019-10-21 10:10:35","2019-10-22 05:00:00","2019-10-22 05:30:00",2557,621,3178
"2019-10-21 10:10:35","2019-10-22 06:00:00","2019-10-22 06:30:00",2731,700,3431
"2019-10-21 10:10:35","2019-10-22 07:00:00","2019-10-22 07:30:00",3311,913,4224
"2019-10-21 10:10:35","2019-10-22 08:00:00","2019-10-22 08:30:00",3895,1125,5020
"2019-10-21 10:10:35","2019-10-22 09:00:00","2019-10-22 09:30:00",3922,1155,5077
"2019-10-21 10:10:35","2019-10-22 10:00:00","2019-10-22 10:30:00",3928,1152,5080
"2019-10-21 10:10:35","2019-10-22 11:00:00","2019-10-22 11:30:00",3906,1110,5016
"2019-10-21 10:10:35","2019-10-22 12:00:00","2019-10-22 12:30:00",3881,1099,4980
"2019-10-21 10:10:35","2019-10-22 13:00:00","2019-10-22 13:30:00",3903,1087,4990
"2019-10-21 10:10:35","2019-10-22 14:00:00","2019-10-22 14:30:00",3807,1046,4853
"2019-10-21 10:10:35","2019-10-22 15:00:00","2019-10-22 15:30:00",3803,1038,4841
"2019-10-21 10:10:35","2019-10-22 16:00:00","2019-10-22 16:30:00",3879,1106,4985
"2019-10-21 10:10:35","2019-10-22 17:00:00","2019-10-22 17:30:00",4032,1175,5207
"2019-10-21 10:10:35","2019-10-22 18:00:00","2019-10-22 18:30:00",4209,1194,5403
"2019-10-21 10:10:35","2019-10-22 19:00:00","2019-10-22 19:30:00",4400,1219,5619
"2019-10-21 10:10:35","2019-10-22 20:00:00","2019-10-22 20:30:00",4203,1180,5383
"2019-10-21 10:10:35","2019-10-22 21:00:00","2019-10-22 21:30:00",3970,1079,5049
"2019-10-21 10:10:35","2019-10-22 22:00:00","2019-10-22 22:30:00",3556,954,4510
"2019-10-22 10:10:26","2019-10-22 23:00:00","2019-10-22 23:30:00",3142,812,3954
"2019-10-22 10:10:26","2019-10-23 00:00:00","2019-10-23 00:30:00",2920,687,3607
"2019-10-22 10:10:26","2019-10-23 01:00:00","2019-10-23 01:30:00",2764,616,3380
"2019-10-22 10:10:26","2019-10-23 02:00:00","2019-10-23 02:30:00",2634,600,3234
"2019-10-22 10:10:26","2019-10-23 03:00:00","2019-10-23 03:30:00",2537,602,3139
"2019-10-22 10:10:26","2019-10-23 04:00:00","2019-10-23 04:30:00",2490,597,3087
"2019-10-22 10:10:26","2019-10-23 05:00:00","2019-10-23 05:30:00",2557,606,3163
"2019-10-22 10:10:26","2019-10-23 06:00:00","2019-10-23 06:30:00",2734,677,3411
"2019-10-22 10:10:26","2019-10-23 07:00:00","2019-10-23 07:30:00",3320,882,4202
"2019-10-22 10:10:26","2019-10-23 08:00:00","2019-10-23 08:30:00",3910,1080,4990
"2019-10-22 10:10:26","2019-10-23 09:00:00","2019-10-23 09:30:00",3937,1101,5038
"2019-10-22 10:10:26","2019-10-23 10:00:00","2019-10-23 10:30:00",3943,1096,5039
"2019-10-22 10:10:26","2019-10-23 11:00:00","2019-10-23 11:30:00",3921,1062,4983
"2019-10-22 10:10:26","2019-10-23 12:00:00","2019-10-23 12:30:00",3896,1051,4947
"2019-10-22 10:10:26","2019-10-23 13:00:00","2019-10-23 13:30:00",3918,1032,4950
"2019-10-22 10:10:26","2019-10-23 14:00:00","2019-10-23 14:30:00",3821,1003,4824
"2019-10-22 10:10:26","2019-10-23 15:00:00","2019-10-23 15:30:00",3816,1031,4847
"2019-10-22 10:10:26","2019-10-23 16:00:00","2019-10-23 16:30:00",3893,1111,5004
"2019-10-22 10:10:26","2019-10-23 17:00:00","2019-10-23 17:30:00",4048,1200,5248
"2019-10-22 10:10:26","2019-10-23 18:00:00","2019-10-23 18:30:00",4227,1206,5433
"2019-10-22 10:10:26","2019-10-23 19:00:00","2019-10-23 19:30:00",4420,1277,5697
"2019-10-22 10:10:26","2019-10-23 20:00:00","2019-10-23 20:30:00",4221,1179,5400
"2019-10-22 10:10:26","2019-10-23 21:00:00","2019-10-23 21:30:00",3985,1056,5041
"2019-10-22 10:10:26","2019-10-23 22:00:00","2019-10-23 22:30:00",3567,935,4502
"2019-10-23 10:10:36","2019-10-23 23:00:00","2019-10-23 23:30:00",3144,799,3943
"2019-10-23 10:10:36","2019-10-24 00:00:00","2019-10-24 00:30:00",2832,669,3501
"2019-10-23 10:10:36","2019-10-24 01:00:00","2019-10-24 01:30:00",2751,609,3360
"2019-10-23 10:10:36","2019-10-24 02:00:00","2019-10-24 02:30:00",2612,583,3195
"2019-10-23 10:10:36","2019-10-24 03:00:00","2019-10-24 03:30:00",2550,598,3148
"2019-10-23 10:10:36","2019-10-24 04:00:00","2019-10-24 04:30:00",2520,594,3114
"2019-10-23 10:10:36","2019-10-24 05:00:00","2019-10-24 05:30:00",2572,606,3178
"2019-10-23 10:10:36","2019-10-24 06:00:00","2019-10-24 06:30:00",2754,678,3432
"2019-10-23 10:10:36","2019-10-24 07:00:00","2019-10-24 07:30:00",3283,894,4177
"2019-10-23 10:10:36","2019-10-24 08:00:00","2019-10-24 08:30:00",3913,1099,5012
"2019-10-23 10:10:36","2019-10-24 09:00:00","2019-10-24 09:30:00",3974,1124,5098
"2019-10-23 10:10:36","2019-10-24 10:00:00","2019-10-24 10:30:00",4008,1126,5134
"2019-10-23 10:10:36","2019-10-24 11:00:00","2019-10-24 11:30:00",3973,1112,5085
"2019-10-23 10:10:36","2019-10-24 12:00:00","2019-10-24 12:30:00",3967,1086,5053
"2019-10-23 10:10:36","2019-10-24 13:00:00","2019-10-24 13:30:00",3963,1049,5012
"2019-10-23 10:10:36","2019-10-24 14:00:00","2019-10-24 14:30:00",3842,1018,4860
"2019-10-23 10:10:36","2019-10-24 15:00:00","2019-10-24 15:30:00",3853,1062,4915
"2019-10-23 10:10:36","2019-10-24 16:00:00","2019-10-24 16:30:00",3936,1110,5046
"2019-10-23 10:10:36","2019-10-24 17:00:00","2019-10-24 17:30:00",4095,1219,5314
"2019-10-23 10:10:36","2019-10-24 18:00:00","2019-10-24 18:30:00",4252,1255,5507
"2019-10-23 10:10:36","2019-10-24 19:00:00","2019-10-24 19:30:00",4410,1280,5690
"2019-10-23 10:10:36","2019-10-24 20:00:00","2019-10-24 20:30:00",4214,1212,5426
"2019-10-23 10:10:36","2019-10-24 21:00:00","2019-10-24 21:30:00",3991,1122,5113
"2019-10-23 10:10:36","2019-10-24 22:00:00","2019-10-24 22:30:00",3617,1002,4619
"2019-10-24 10:10:30","2019-10-24 23:00:00","2019-10-24 23:30:00",3144,851,3995
"2019-10-24 10:10:30","2019-10-25 00:00:00","2019-10-25 00:30:00",2887,734,3621
"2019-10-24 10:10:30","2019-10-25 01:00:00","2019-10-25 01:30:00",2786,671,3457
"2019-10-24 10:10:30","2019-10-25 02:00:00","2019-10-25 02:30:00",2619,636,3255
"2019-10-24 10:10:30","2019-10-25 03:00:00","2019-10-25 03:30:00",2553,627,3180
"2019-10-24 10:10:30","2019-10-25 04:00:00","2019-10-25 04:30:00",2558,618,3176
"2019-10-24 10:10:30","2019-10-25 05:00:00","2019-10-25 05:30:00",2583,642,3225
"2019-10-24 10:10:30","2019-10-25 06:00:00","2019-10-25 06:30:00",2759,708,3467
"2019-10-24 10:10:30","2019-10-25 07:00:00","2019-10-25 07:30:00",3260,913,4173
"2019-10-24 10:10:30","2019-10-25 08:00:00","2019-10-25 08:30:00",3880,1137,5017
"2019-10-24 10:10:30","2019-10-25 09:00:00","2019-10-25 09:30:00",3910,1194,5104
"2019-10-24 10:10:30","2019-10-25 10:00:00","2019-10-25 10:30:00",3967,1192,5159
"2019-10-24 10:10:30","2019-10-25 11:00:00","2019-10-25 11:30:00",3922,1187,5109
"2019-10-24 10:10:30","2019-10-25 12:00:00","2019-10-25 12:30:00",3894,1198,5092
"2019-10-24 10:10:30","2019-10-25 13:00:00","2019-10-25 13:30:00",3781,1222,5003
"2019-10-24 10:10:30","2019-10-25 14:00:00","2019-10-25 14:30:00",3779,1154,4933
"2019-10-24 10:10:30","2019-10-25 15:00:00","2019-10-25 15:30:00",3752,1097,4849
"2019-10-24 10:10:30","2019-10-25 16:00:00","2019-10-25 16:30:00",3729,1123,4852
"2019-10-24 10:10:30","2019-10-25 17:00:00","2019-10-25 17:30:00",3863,1222,5085
"2019-10-24 10:10:30","2019-10-25 18:00:00","2019-10-25 18:30:00",3977,1223,5200
"2019-10-24 10:10:30","2019-10-25 19:00:00","2019-10-25 19:30:00",4250,1254,5504
"2019-10-24 10:10:30","2019-10-25 20:00:00","2019-10-25 20:30:00",4015,1132,5147
"2019-10-24 10:10:30","2019-10-25 21:00:00","2019-10-25 21:30:00",3806,1034,4840
"2019-10-24 10:10:30","2019-10-25 22:00:00","2019-10-25 22:30:00",3497,931,4428
"2019-10-25 10:10:15","2019-10-25 23:00:00","2019-10-25 23:30:00",3246,885,4131
"2019-10-25 10:10:15","2019-10-26 00:00:00","2019-10-26 00:30:00",2966,691,3657
"2019-10-25 10:10:15","2019-10-26 01:00:00","2019-10-26 01:30:00",2905,632,3537
"2019-10-25 10:10:15","2019-10-26 02:00:00","2019-10-26 02:30:00",2738,599,3337
"2019-10-25 10:10:15","2019-10-26 03:00:00","2019-10-26 03:30:00",2575,606,3181
"2019-10-25 10:10:15","2019-10-26 04:00:00","2019-10-26 04:30:00",2535,603,3138
"2019-10-25 10:10:15","2019-10-26 05:00:00","2019-10-26 05:30:00",2537,595,3132
"2019-10-25 10:10:15","2019-10-26 06:00:00","2019-10-26 06:30:00",2611,633,3244
"2019-10-25 10:10:15","2019-10-26 07:00:00","2019-10-26 07:30:00",2839,705,3544
"2019-10-25 10:10:15","2019-10-26 08:00:00","2019-10-26 08:30:00",3129,837,3966
"2019-10-25 10:10:15","2019-10-26 09:00:00","2019-10-26 09:30:00",3471,949,4420
"2019-10-25 10:10:15","2019-10-26 10:00:00","2019-10-26 10:30:00",3624,1009,4633
"2019-10-25 10:10:15","2019-10-26 11:00:00","2019-10-26 11:30:00",3697,1046,4743
"2019-10-25 10:10:15","2019-10-26 12:00:00","2019-10-26 12:30:00",3665,1021,4686
"2019-10-25 10:10:15","2019-10-26 13:00:00","2019-10-26 13:30:00",3650,982,4632
"2019-10-25 10:10:15","2019-10-26 14:00:00","2019-10-26 14:30:00",3570,919,4489
"2019-10-25 10:10:15","2019-10-26 15:00:00","2019-10-26 15:30:00",3517,880,4397
"2019-10-25 10:10:15","2019-10-26 16:00:00","2019-10-26 16:30:00",3539,899,4438
"2019-10-25 10:10:15","2019-10-26 17:00:00","2019-10-26 17:30:00",3604,964,4568
"2019-10-25 10:10:15","2019-10-26 18:00:00","2019-10-26 18:30:00",3732,1032,4764
"2019-10-25 10:10:15","2019-10-26 19:00:00","2019-10-26 19:30:00",3950,1094,5044
"2019-10-25 10:10:15","2019-10-26 20:00:00","2019-10-26 20:30:00",3737,999,4736
"2019-10-25 10:10:15","2019-10-26 21:00:00","2019-10-26 21:30:00",3538,911,4449
"2019-10-25 10:10:15","2019-10-26 22:00:00","2019-10-26 22:30:00",3321,822,4143
"2019-10-26 10:10:35","2019-10-26 23:00:00","2019-10-26 23:30:00",3193,795,3988
"2019-10-26 10:10:35","2019-10-27 00:00:00","2019-10-27 00:30:00",3002,728,3730
"2019-10-26 10:10:35","2019-10-27 01:00:00","2019-10-27 01:30:00",2903,660,3563
"2019-10-26 10:10:35","2019-10-27 02:00:00","2019-10-27 02:30:00",2739,627,3366
"2019-10-26 10:10:35","2019-10-27 03:00:00","2019-10-27 03:30:00",2653,626,3279
"2019-10-26 10:10:35","2019-10-27 04:00:00","2019-10-27 04:30:00",2542,607,3149
"2019-10-26 10:10:35","2019-10-27 05:00:00","2019-10-27 05:30:00",2531,598,3129
"2019-10-26 10:10:35","2019-10-27 06:00:00","2019-10-27 06:30:00",2520,606,3126
"2019-10-26 10:10:35","2019-10-27 07:00:00","2019-10-27 07:30:00",2572,640,3212
"2019-10-26 10:10:35","2019-10-27 08:00:00","2019-10-27 08:30:00",2723,691,3414
"2019-10-26 10:10:35","2019-10-27 09:00:00","2019-10-27 09:30:00",2986,788,3774
"2019-10-26 10:10:35","2019-10-27 10:00:00","2019-10-27 10:30:00",3299,901,4200
"2019-10-26 10:10:35","2019-10-27 11:00:00","2019-10-27 11:30:00",3537,965,4502
"2019-10-26 10:10:35","2019-10-27 12:00:00","2019-10-27 12:30:00",3609,977,4586
"2019-10-26 10:10:35","2019-10-27 13:00:00","2019-10-27 13:30:00",3642,993,4635
"2019-10-26 10:10:35","2019-10-27 14:00:00","2019-10-27 14:30:00",3627,1010,4637
"2019-10-26 10:10:35","2019-10-27 15:00:00","2019-10-27 15:30:00",3500,964,4464
"2019-10-26 10:10:35","2019-10-27 16:00:00","2019-10-27 16:30:00",3422,951,4373
"2019-10-26 10:10:35","2019-10-27 17:00:00","2019-10-27 17:30:00",3460,997,4457
"2019-10-26 10:10:35","2019-10-27 18:00:00","2019-10-27 18:30:00",3694,1137,4831
"2019-10-26 10:10:35","2019-10-27 19:00:00","2019-10-27 19:30:00",4100,1245,5345
"2019-10-26 10:10:35","2019-10-27 20:00:00","2019-10-27 20:30:00",3935,1151,5086
"2019-10-26 10:10:35","2019-10-27 21:00:00","2019-10-27 21:30:00",3740,1083,4823
"2019-10-26 10:10:35","2019-10-27 22:00:00","2019-10-27 22:30:00",3539,1009,4548
"2019-10-27 10:10:26","2019-10-27 23:00:00","2019-10-27 23:30:00",3243,916,4159
"2019-10-27 10:10:26","2019-10-28 00:00:00","2019-10-28 00:30:00",3130,860,3990
"2019-10-27 10:10:26","2019-10-28 01:00:00","2019-10-28 01:30:00",2976,700,3676
"2019-10-27 10:10:26","2019-10-28 02:00:00","2019-10-28 02:30:00",2797,633,3430
"2019-10-27 10:10:26","2019-10-28 03:00:00","2019-10-28 03:30:00",2644,612,3256
"2019-10-27 10:10:26","2019-10-28 04:00:00","2019-10-28 04:30:00",2585,623,3208
"2019-10-27 10:10:26","2019-10-28 05:00:00","2019-10-28 05:30:00",2532,615,3147
"2019-10-27 10:10:26","2019-10-28 06:00:00","2019-10-28 06:30:00",2533,625,3158
"2019-10-27 10:10:26","2019-10-28 07:00:00","2019-10-28 07:30:00",2581,706,3287
"2019-10-27 10:10:26","2019-10-28 08:00:00","2019-10-28 08:30:00",2767,923,3690
"2019-10-27 10:10:26","2019-10-28 09:00:00","2019-10-28 09:30:00",2940,1147,4087
"2019-10-27 10:10:26","2019-10-28 10:00:00","2019-10-28 10:30:00",3222,1158,4380
"2019-10-27 10:10:26","2019-10-28 11:00:00","2019-10-28 11:30:00",3457,1209,4666
"2019-10-27 10:10:26","2019-10-28 12:00:00","2019-10-28 12:30:00",3594,1201,4795
"2019-10-27 10:10:26","2019-10-28 13:00:00","2019-10-28 13:30:00",3645,1171,4816
"2019-10-27 10:10:26","2019-10-28 14:00:00","2019-10-28 14:30:00",3650,1143,4793
"2019-10-27 10:10:26","2019-10-28 15:00:00","2019-10-28 15:30:00",3549,1102,4651
"2019-10-27 10:10:26","2019-10-28 16:00:00","2019-10-28 16:30:00",3551,1099,4650
"2019-10-27 10:10:26","2019-10-28 17:00:00","2019-10-28 17:30:00",3610,1142,4752
"2019-10-27 10:10:26","2019-10-28 18:00:00","2019-10-28 18:30:00",3926,1237,5163
"2019-10-27 10:10:26","2019-10-28 19:00:00","2019-10-28 19:30:00",4280,1283,5563
"2019-10-27 10:10:26","2019-10-28 20:00:00","2019-10-28 20:30:00",4047,1331,5378
"2019-10-27 10:10:26","2019-10-28 21:00:00","2019-10-28 21:30:00",3873,1243,5116
"2019-10-27 10:10:26","2019-10-28 22:00:00","2019-10-28 22:30:00",3657,1134,4791
"2019-10-28 10:10:16","2019-10-28 23:00:00","2019-10-28 23:30:00",2939,872,3811
"2019-10-28 10:10:16","2019-10-29 00:00:00","2019-10-29 00:30:00",2898,753,3651
"2019-10-28 10:10:16","2019-10-29 01:00:00","2019-10-29 01:30:00",2735,703,3438
"2019-10-28 10:10:16","2019-10-29 02:00:00","2019-10-29 02:30:00",2587,698,3285
"2019-10-28 10:10:16","2019-10-29 03:00:00","2019-10-29 03:30:00",2563,680,3243
"2019-10-28 10:10:16","2019-10-29 04:00:00","2019-10-29 04:30:00",2545,682,3227
"2019-10-28 10:10:16","2019-10-29 05:00:00","2019-10-29 05:30:00",2570,690,3260
"2019-10-28 10:10:16","2019-10-29 06:00:00","2019-10-29 06:30:00",2761,767,3528
"2019-10-28 10:10:16","2019-10-29 07:00:00","2019-10-29 07:30:00",3229,943,4172
"2019-10-28 10:10:16","2019-10-29 08:00:00","2019-10-29 08:30:00",3686,1089,4775
"2019-10-28 10:10:16","2019-10-29 09:00:00","2019-10-29 09:30:00",4014,1191,5205
"2019-10-28 10:10:16","2019-10-29 10:00:00","2019-10-29 10:30:00",4132,1201,5333
"2019-10-28 10:10:16","2019-10-29 11:00:00","2019-10-29 11:30:00",4140,1188,5328
"2019-10-28 10:10:16","2019-10-29 12:00:00","2019-10-29 12:30:00",4150,1190,5340
"2019-10-28 10:10:16","2019-10-29 13:00:00","2019-10-29 13:30:00",4179,1173,5352
"2019-10-28 10:10:16","2019-10-29 14:00:00","2019-10-29 14:30:00",4085,1153,5238
"2019-10-28 10:10:16","2019-10-29 15:00:00","2019-10-29 15:30:00",4072,1179,5251
"2019-10-28 10:10:16","2019-10-29 16:00:00","2019-10-29 16:30:00",4168,1237,5405
"2019-10-28 10:10:16","2019-10-29 17:00:00","2019-10-29 17:30:00",4495,1406,5901
"2019-10-28 10:10:16","2019-10-29 18:00:00","2019-10-29 18:30:00",4760,1448,6208
"2019-10-28 10:10:16","2019-10-29 19:00:00","2019-10-29 19:30:00",4560,1329,5889
"2019-10-28 10:10:16","2019-10-29 20:00:00","2019-10-29 20:30:00",4298,1234,5532
"2019-10-28 10:10:16","2019-10-29 21:00:00","2019-10-29 21:30:00",4021,1148,5169
"2019-10-28 10:10:16","2019-10-29 22:00:00","2019-10-29 22:30:00",3694,1028,4722
"2019-10-29 10:10:36","2019-10-29 23:00:00","2019-10-29 23:30:00",3380,889,4269
"2019-10-29 10:10:36","2019-10-30 00:00:00","2019-10-30 00:30:00",3136,753,3889
"2019-10-29 10:10:36","2019-10-30 01:00:00","2019-10-30 01:30:00",2894,703,3597
"2019-10-29 10:10:36","2019-10-30 02:00:00","2019-10-30 02:30:00",2717,698,3415
"2019-10-29 10:10:36","2019-10-30 03:00:00","2019-10-30 03:30:00",2641,680,3321
"2019-10-29 10:10:36","2019-10-30 04:00:00","2019-10-30 04:30:00",2600,682,3282
"2019-10-29 10:10:36","2019-10-30 05:00:00","2019-10-30 05:30:00",2646,690,3336
"2019-10-29 10:10:36","2019-10-30 06:00:00","2019-10-30 06:30:00",2793,767,3560
"2019-10-29 10:10:36","2019-10-30 07:00:00","2019-10-30 07:30:00",3280,943,4223
"2019-10-29 10:10:36","2019-10-30 08:00:00","2019-10-30 08:30:00",3666,1089,4755
"2019-10-29 10:10:36","2019-10-30 09:00:00","2019-10-30 09:30:00",3990,1191,5181
"2019-10-29 10:10:36","2019-10-30 10:00:00","2019-10-30 10:30:00",4110,1201,5311
"2019-10-29 10:10:36","2019-10-30 11:00:00","2019-10-30 11:30:00",4111,1188,5299
"2019-10-29 10:10:36","2019-10-30 12:00:00","2019-10-30 12:30:00",4106,1190,5296
"2019-10-29 10:10:36","2019-10-30 13:00:00","2019-10-30 13:30:00",4076,1173,5249
"2019-10-29 10:10:36","2019-10-30 14:00:00","2019-10-30 14:30:00",3975,1153,5128
"2019-10-29 10:10:36","2019-10-30 15:00:00","2019-10-30 15:30:00",3958,1179,5137
"2019-10-29 10:10:36","2019-10-30 16:00:00","2019-10-30 16:30:00",4033,1237,5270
"2019-10-29 10:10:36","2019-10-30 17:00:00","2019-10-30 17:30:00",4320,1406,5726
"2019-10-29 10:10:36","2019-10-30 18:00:00","2019-10-30 18:30:00",4750,1448,6198
"2019-10-29 10:10:36","2019-10-30 19:00:00","2019-10-30 19:30:00",4587,1329,5916
"2019-10-29 10:10:36","2019-10-30 20:00:00","2019-10-30 20:30:00",4363,1234,5597
"2019-10-29 10:10:36","2019-10-30 21:00:00","2019-10-30 21:30:00",4102,1148,5250
"2019-10-29 10:10:36","2019-10-30 22:00:00","2019-10-30 22:30:00",3739,1028,4767
"2019-10-30 10:10:15","2019-10-30 23:00:00","2019-10-30 23:30:00",3426,831,4257
"2019-10-30 10:10:15","2019-10-31 00:00:00","2019-10-31 00:30:00",3124,680,3804
"2019-10-30 10:10:15","2019-10-31 01:00:00","2019-10-31 01:30:00",2888,642,3530
"2019-10-30 10:10:15","2019-10-31 02:00:00","2019-10-31 02:30:00",2715,632,3347
"2019-10-30 10:10:15","2019-10-31 03:00:00","2019-10-31 03:30:00",2640,616,3256
"2019-10-30 10:10:15","2019-10-31 04:00:00","2019-10-31 04:30:00",2600,613,3213
"2019-10-30 10:10:15","2019-10-31 05:00:00","2019-10-31 05:30:00",2645,636,3281
"2019-10-30 10:10:15","2019-10-31 06:00:00","2019-10-31 06:30:00",2788,714,3502
"2019-10-30 10:10:15","2019-10-31 07:00:00","2019-10-31 07:30:00",3264,883,4147
"2019-10-30 10:10:15","2019-10-31 08:00:00","2019-10-31 08:30:00",3642,1042,4684
"2019-10-30 10:10:15","2019-10-31 09:00:00","2019-10-31 09:30:00",3958,1150,5108
"2019-10-30 10:10:15","2019-10-31 10:00:00","2019-10-31 10:30:00",4074,1167,5241
"2019-10-30 10:10:15","2019-10-31 11:00:00","2019-10-31 11:30:00",4076,1153,5229
"2019-10-30 10:10:15","2019-10-31 12:00:00","2019-10-31 12:30:00",4071,1127,5198
"2019-10-30 10:10:15","2019-10-31 13:00:00","2019-10-31 13:30:00",4042,1111,5153
"2019-10-30 10:10:15","2019-10-31 14:00:00","2019-10-31 14:30:00",3943,1077,5020
"2019-10-30 10:10:15","2019-10-31 15:00:00","2019-10-31 15:30:00",3927,1096,5023
"2019-10-30 10:10:15","2019-10-31 16:00:00","2019-10-31 16:30:00",4000,1141,5141
"2019-10-30 10:10:15","2019-10-31 17:00:00","2019-10-31 17:30:00",4280,1323,5603
"2019-10-30 10:10:15","2019-10-31 18:00:00","2019-10-31 18:30:00",4700,1412,6112
"2019-10-30 10:10:15","2019-10-31 19:00:00","2019-10-31 19:30:00",4541,1280,5821
"2019-10-30 10:10:15","2019-10-31 20:00:00","2019-10-31 20:30:00",4322,1182,5504
"2019-10-30 10:10:15","2019-10-31 21:00:00","2019-10-31 21:30:00",4067,1100,5167
"2019-10-30 10:10:15","2019-10-31 22:00:00","2019-10-31 22:30:00",3713,979,4692
"2019-10-31 10:10:35","2019-10-31 23:00:00","2019-10-31 23:30:00",3382,831,4213
"2019-10-31 10:10:35","2019-11-01 00:00:00","2019-11-01 00:30:00",3101,693,3794
"2019-10-31 10:10:35","2019-11-01 01:00:00","2019-11-01 01:30:00",2874,630,3504
"2019-10-31 10:10:35","2019-11-01 02:00:00","2019-11-01 02:30:00",2717,601,3318
"2019-10-31 10:10:35","2019-11-01 03:00:00","2019-11-01 03:30:00",2623,601,3224
"2019-10-31 10:10:35","2019-11-01 04:00:00","2019-11-01 04:30:00",2594,593,3187
"2019-10-31 10:10:35","2019-11-01 05:00:00","2019-11-01 05:30:00",2605,602,3207
"2019-10-31 10:10:35","2019-11-01 06:00:00","2019-11-01 06:30:00",2781,661,3442
"2019-10-31 10:10:35","2019-11-01 07:00:00","2019-11-01 07:30:00",3236,866,4102
"2019-10-31 10:10:35","2019-11-01 08:00:00","2019-11-01 08:30:00",3623,1085,4708
"2019-10-31 10:10:35","2019-11-01 09:00:00","2019-11-01 09:30:00",3923,1103,5026
"2019-10-31 10:10:35","2019-11-01 10:00:00","2019-11-01 10:30:00",4031,1121,5152
"2019-10-31 10:10:35","2019-11-01 11:00:00","2019-11-01 11:30:00",4034,1138,5172
"2019-10-31 10:10:35","2019-11-01 12:00:00","2019-11-01 12:30:00",4017,1151,5168
"2019-10-31 10:10:35","2019-11-01 13:00:00","2019-11-01 13:30:00",4047,1116,5163
"2019-10-31 10:10:35","2019-11-01 14:00:00","2019-11-01 14:30:00",3982,1073,5055
"2019-10-31 10:10:35","2019-11-01 15:00:00","2019-11-01 15:30:00",4001,1046,5047
"2019-10-31 10:10:35","2019-11-01 16:00:00","2019-11-01 16:30:00",4089,1077,5166
"2019-10-31 10:10:35","2019-11-01 17:00:00","2019-11-01 17:30:00",4393,1160,5553
"2019-10-31 10:10:35","2019-11-01 18:00:00","2019-11-01 18:30:00",4572,1129,5701
"2019-10-31 10:10:35","2019-11-01 19:00:00","2019-11-01 19:30:00",4391,1180,5571
"2019-10-31 10:10:35","2019-11-01 20:00:00","2019-11-01 20:30:00",4131,1075,5206
"2019-10-31 10:10:35","2019-11-01 21:00:00","2019-11-01 21:30:00",3883,1023,4906
"2019-10-31 10:10:35","2019-11-01 22:00:00","2019-11-01 22:30:00",3536,912,4448
"2019-11-01 10:10:36","2019-11-01 23:00:00","2019-11-01 23:30:00",3302,813,4115
"2019-11-01 10:10:36","2019-11-02 00:00:00","2019-11-02 00:30:00",3180,667,3847
"2019-11-01 10:10:36","2019-11-02 01:00:00","2019-11-02 01:30:00",2891,612,3503
"2019-11-01 10:10:36","2019-11-02 02:00:00","2019-11-02 02:30:00",2715,581,3296
"2019-11-01 10:10:36","2019-11-02 03:00:00","2019-11-02 03:30:00",2589,566,3155
"2019-11-01 10:10:36","2019-11-02 04:00:00","2019-11-02 04:30:00",2529,564,3093
"2019-11-01 10:10:36","2019-11-02 05:00:00","2019-11-02 05:30:00",2500,570,3070
"2019-11-01 10:10:36","2019-11-02 06:00:00","2019-11-02 06:30:00",2563,604,3167
"2019-11-01 10:10:36","2019-11-02 07:00:00","2019-11-02 07:30:00",2784,676,3460
"2019-11-01 10:10:36","2019-11-02 08:00:00","2019-11-02 08:30:00",3046,831,3877
"2019-11-01 10:10:36","2019-11-02 09:00:00","2019-11-02 09:30:00",3369,946,4315
"2019-11-01 10:10:36","2019-11-02 10:00:00","2019-11-02 10:30:00",3603,1008,4611
"2019-11-01 10:10:36","2019-11-02 11:00:00","2019-11-02 11:30:00",3707,984,4691
"2019-11-01 10:10:36","2019-11-02 12:00:00","2019-11-02 12:30:00",3731,957,4688
"2019-11-01 10:10:36","2019-11-02 13:00:00","2019-11-02 13:30:00",3715,907,4622
"2019-11-01 10:10:36","2019-11-02 14:00:00","2019-11-02 14:30:00",3592,865,4457
"2019-11-01 10:10:36","2019-11-02 15:00:00","2019-11-02 15:30:00",3544,852,4396
"2019-11-01 10:10:36","2019-11-02 16:00:00","2019-11-02 16:30:00",3572,875,4447
"2019-11-01 10:10:36","2019-11-02 17:00:00","2019-11-02 17:30:00",3853,944,4797
"2019-11-01 10:10:36","2019-11-02 18:00:00","2019-11-02 18:30:00",4120,1033,5153
"2019-11-01 10:10:36","2019-11-02 19:00:00","2019-11-02 19:30:00",3928,1038,4966
"2019-11-01 10:10:36","2019-11-02 20:00:00","2019-11-02 20:30:00",3639,952,4591
"2019-11-01 10:10:36","2019-11-02 21:00:00","2019-11-02 21:30:00",3408,910,4318
"2019-11-01 10:10:36","2019-11-02 22:00:00","2019-11-02 22:30:00",3150,831,3981
"2019-11-02 10:10:26","2019-11-02 23:00:00","2019-11-02 23:30:00",2991,747,3738
"2019-11-02 10:10:26","2019-11-03 00:00:00","2019-11-03 00:30:00",2938,672,3610
"2019-11-02 10:10:26","2019-11-03 01:00:00","2019-11-03 01:30:00",2737,618,3355
"2019-11-02 10:10:26","2019-11-03 02:00:00","2019-11-03 02:30:00",2551,600,3151
"2019-11-02 10:10:26","2019-11-03 03:00:00","2019-11-03 03:30:00",2431,581,3012
"2019-11-02 10:10:26","2019-11-03 04:00:00","2019-11-03 04:30:00",2417,556,2973
"2019-11-02 10:10:26","2019-11-03 05:00:00","2019-11-03 05:30:00",2390,550,2940
"2019-11-02 10:10:26","2019-11-03 06:00:00","2019-11-03 06:30:00",2408,581,2989
"2019-11-02 10:10:26","2019-11-03 07:00:00","2019-11-03 07:30:00",2539,646,3185
"2019-11-02 10:10:26","2019-11-03 08:00:00","2019-11-03 08:30:00",2670,728,3398
"2019-11-02 10:10:26","2019-11-03 09:00:00","2019-11-03 09:30:00",2960,842,3802
"2019-11-02 10:10:26","2019-11-03 10:00:00","2019-11-03 10:30:00",3185,867,4052
"2019-11-02 10:10:26","2019-11-03 11:00:00","2019-11-03 11:30:00",3318,943,4261
"2019-11-02 10:10:26","2019-11-03 12:00:00","2019-11-03 12:30:00",3417,946,4363
"2019-11-02 10:10:26","2019-11-03 13:00:00","2019-11-03 13:30:00",3458,982,4440
"2019-11-02 10:10:26","2019-11-03 14:00:00","2019-11-03 14:30:00",3413,925,4338
"2019-11-02 10:10:26","2019-11-03 15:00:00","2019-11-03 15:30:00",3345,902,4247
"2019-11-02 10:10:26","2019-11-03 16:00:00","2019-11-03 16:30:00",3407,912,4319
"2019-11-02 10:10:26","2019-11-03 17:00:00","2019-11-03 17:30:00",3752,1012,4764
"2019-11-02 10:10:26","2019-11-03 18:00:00","2019-11-03 18:30:00",4050,1065,5115
"2019-11-02 10:10:26","2019-11-03 19:00:00","2019-11-03 19:30:00",3895,1148,5043
"2019-11-02 10:10:26","2019-11-03 20:00:00","2019-11-03 20:30:00",3725,1085,4810
"2019-11-02 10:10:26","2019-11-03 21:00:00","2019-11-03 21:30:00",3506,1002,4508
"2019-11-02 10:10:26","2019-11-03 22:00:00","2019-11-03 22:30:00",3209,894,4103
"2019-11-03 10:10:10","2019-11-03 23:00:00","2019-11-03 23:30:00",2986,772,3758
"2019-11-03 10:10:10","2019-11-04 00:00:00","2019-11-04 00:30:00",2892,673,3565
"2019-11-03 10:10:10","2019-11-04 01:00:00","2019-11-04 01:30:00",2737,623,3360
"2019-11-03 10:10:10","2019-11-04 02:00:00","2019-11-04 02:30:00",2591,605,3196
"2019-11-03 10:10:10","2019-11-04 03:00:00","2019-11-04 03:30:00",2504,601,3105
"2019-11-03 10:10:10","2019-11-04 04:00:00","2019-11-04 04:30:00",2500,590,3090
"2019-11-03 10:10:10","2019-11-04 05:00:00","2019-11-04 05:30:00",2531,610,3141
"2019-11-03 10:10:10","2019-11-04 06:00:00","2019-11-04 06:30:00",2734,740,3474
"2019-11-03 10:10:10","2019-11-04 07:00:00","2019-11-04 07:30:00",3301,970,4271
"2019-11-03 10:10:10","2019-11-04 08:00:00","2019-11-04 08:30:00",3803,1110,4913
"2019-11-03 10:10:10","2019-11-04 09:00:00","2019-11-04 09:30:00",3910,1170,5080
"2019-11-03 10:10:10","2019-11-04 10:00:00","2019-11-04 10:30:00",4004,1205,5209
"2019-11-03 10:10:10","2019-11-04 11:00:00","2019-11-04 11:30:00",4010,1210,5220
"2019-11-03 10:10:10","2019-11-04 12:00:00","2019-11-04 12:30:00",4020,1220,5240
"2019-11-03 10:10:10","2019-11-04 13:00:00","2019-11-04 13:30:00",4056,1210,5266
"2019-11-03 10:10:10","2019-11-04 14:00:00","2019-11-04 14:30:00",3995,1200,5195
"2019-11-03 10:10:10","2019-11-04 15:00:00","2019-11-04 15:30:00",4033,1190,5223
"2019-11-03 10:10:10","2019-11-04 16:00:00","2019-11-04 16:30:00",4116,1250,5366
"2019-11-03 10:10:10","2019-11-04 17:00:00","2019-11-04 17:30:00",4485,1430,5915
"2019-11-03 10:10:10","2019-11-04 18:00:00","2019-11-04 18:30:00",4685,1405,6090
"2019-11-03 10:10:10","2019-11-04 19:00:00","2019-11-04 19:30:00",4468,1263,5731
"2019-11-03 10:10:10","2019-11-04 20:00:00","2019-11-04 20:30:00",4190,1164,5354
"2019-11-03 10:10:10","2019-11-04 21:00:00","2019-11-04 21:30:00",3947,1082,5029
"2019-11-03 10:10:10","2019-11-04 22:00:00","2019-11-04 22:30:00",3572,959,4531
"2019-11-04 10:10:31","2019-11-04 23:00:00","2019-11-04 23:30:00",3359,858,4217
"2019-11-04 10:10:31","2019-11-05 00:00:00","2019-11-05 00:30:00",3110,715,3825
"2019-11-04 10:10:31","2019-11-05 01:00:00","2019-11-05 01:30:00",2906,653,3559
"2019-11-04 10:10:31","2019-11-05 02:00:00","2019-11-05 02:30:00",2722,629,3351
"2019-11-04 10:10:31","2019-11-05 03:00:00","2019-11-05 03:30:00",2647,615,3262
"2019-11-04 10:10:31","2019-11-05 04:00:00","2019-11-05 04:30:00",2633,604,3237
"2019-11-04 10:10:31","2019-11-05 05:00:00","2019-11-05 05:30:00",2613,632,3245
"2019-11-04 10:10:31","2019-11-05 06:00:00","2019-11-05 06:30:00",2809,704,3513
"2019-11-04 10:10:31","2019-11-05 07:00:00","2019-11-05 07:30:00",3411,888,4299
"2019-11-04 10:10:31","2019-11-05 08:00:00","2019-11-05 08:30:00",3893,1046,4939
"2019-11-04 10:10:31","2019-11-05 09:00:00","2019-11-05 09:30:00",3968,1153,5121
"2019-11-04 10:10:31","2019-11-05 10:00:00","2019-11-05 10:30:00",4062,1180,5242
"2019-11-04 10:10:31","2019-11-05 11:00:00","2019-11-05 11:30:00",4058,1167,5225
"2019-11-04 10:10:31","2019-11-05 12:00:00","2019-11-05 12:30:00",4027,1193,5220
"2019-11-04 10:10:31","2019-11-05 13:00:00","2019-11-05 13:30:00",4086,1167,5253
"2019-11-04 10:10:31","2019-11-05 14:00:00","2019-11-05 14:30:00",4030,1138,5168
"2019-11-04 10:10:31","2019-11-05 15:00:00","2019-11-05 15:30:00",4105,1151,5256
"2019-11-04 10:10:31","2019-11-05 16:00:00","2019-11-05 16:30:00",4220,1201,5421
"2019-11-04 10:10:31","2019-11-05 17:00:00","2019-11-05 17:30:00",4523,1347,5870
"2019-11-04 10:10:31","2019-11-05 18:00:00","2019-11-05 18:30:00",4705,1345,6050
"2019-11-04 10:10:31","2019-11-05 19:00:00","2019-11-05 19:30:00",4493,1261,5754
"2019-11-04 10:10:31","2019-11-05 20:00:00","2019-11-05 20:30:00",4243,1173,5416
"2019-11-04 10:10:31","2019-11-05 21:00:00","2019-11-05 21:30:00",4031,1101,5132
"2019-11-04 10:10:31","2019-11-05 22:00:00","2019-11-05 22:30:00",3666,1010,4676
"2019-11-05 10:10:15","2019-11-05 23:00:00","2019-11-05 23:30:00",3377,783,4160
"2019-11-05 10:10:15","2019-11-06 00:00:00","2019-11-06 00:30:00",3110,736,3846
"2019-11-05 10:10:15","2019-11-06 01:00:00","2019-11-06 01:30:00",2906,673,3579
"2019-11-05 10:10:15","2019-11-06 02:00:00","2019-11-06 02:30:00",2722,649,3371
"2019-11-05 10:10:15","2019-11-06 03:00:00","2019-11-06 03:30:00",2647,635,3282
"2019-11-05 10:10:15","2019-11-06 04:00:00","2019-11-06 04:30:00",2633,620,3253
"2019-11-05 10:10:15","2019-11-06 05:00:00","2019-11-06 05:30:00",2613,661,3274
"2019-11-05 10:10:15","2019-11-06 06:00:00","2019-11-06 06:30:00",2809,742,3551
"2019-11-05 10:10:15","2019-11-06 07:00:00","2019-11-06 07:30:00",3411,929,4340
"2019-11-05 10:10:15","2019-11-06 08:00:00","2019-11-06 08:30:00",3893,1100,4993
"2019-11-05 10:10:15","2019-11-06 09:00:00","2019-11-06 09:30:00",3968,1216,5184
"2019-11-05 10:10:15","2019-11-06 10:00:00","2019-11-06 10:30:00",4062,1242,5304
"2019-11-05 10:10:15","2019-11-06 11:00:00","2019-11-06 11:30:00",4058,1232,5290
"2019-11-05 10:10:15","2019-11-06 12:00:00","2019-11-06 12:30:00",4027,1251,5278
"2019-11-05 10:10:15","2019-11-06 13:00:00","2019-11-06 13:30:00",4086,1237,5323
"2019-11-05 10:10:15","2019-11-06 14:00:00","2019-11-06 14:30:00",4030,1212,5242
"2019-11-05 10:10:15","2019-11-06 15:00:00","2019-11-06 15:30:00",4105,1234,5339
"2019-11-05 10:10:15","2019-11-06 16:00:00","2019-11-06 16:30:00",4220,1281,5501
"2019-11-05 10:10:15","2019-11-06 17:00:00","2019-11-06 17:30:00",4523,1424,5947
"2019-11-05 10:10:15","2019-11-06 18:00:00","2019-11-06 18:30:00",4705,1420,6125
"2019-11-05 10:10:15","2019-11-06 19:00:00","2019-11-06 19:30:00",4493,1312,5805
"2019-11-05 10:10:15","2019-11-06 20:00:00","2019-11-06 20:30:00",4243,1224,5467
"2019-11-05 10:10:15","2019-11-06 21:00:00","2019-11-06 21:30:00",4031,1144,5175
"2019-11-05 10:10:15","2019-11-06 22:00:00","2019-11-06 22:30:00",3666,1038,4704
"2019-11-06 10:10:31","2019-11-06 23:00:00","2019-11-06 23:30:00",3377,907,4284
"2019-11-06 10:10:31","2019-11-07 00:00:00","2019-11-07 00:30:00",3110,753,3863
"2019-11-06 10:10:31","2019-11-07 01:00:00","2019-11-07 01:30:00",2906,685,3591
"2019-11-06 10:10:31","2019-11-07 02:00:00","2019-11-07 02:30:00",2722,660,3382
"2019-11-06 10:10:31","2019-11-07 03:00:00","2019-11-07 03:30:00",2647,644,3291
"2019-11-06 10:10:31","2019-11-07 04:00:00","2019-11-07 04:30:00",2633,626,3259
"2019-11-06 10:10:31","2019-11-07 05:00:00","2019-11-07 05:30:00",2613,641,3254
"2019-11-06 10:10:31","2019-11-07 06:00:00","2019-11-07 06:30:00",2809,721,3530
"2019-11-06 10:10:31","2019-11-07 07:00:00","2019-11-07 07:30:00",3411,932,4343
"2019-11-06 10:10:31","2019-11-07 08:00:00","2019-11-07 08:30:00",3893,1091,4984
"2019-11-06 10:10:31","2019-11-07 09:00:00","2019-11-07 09:30:00",3968,1171,5139
"2019-11-06 10:10:31","2019-11-07 10:00:00","2019-11-07 10:30:00",4062,1199,5261
"2019-11-06 10:10:31","2019-11-07 11:00:00","2019-11-07 11:30:00",4058,1211,5269
"2019-11-06 10:10:31","2019-11-07 12:00:00","2019-11-07 12:30:00",4027,1235,5262
"2019-11-06 10:10:31","2019-11-07 13:00:00","2019-11-07 13:30:00",4086,1230,5316
"2019-11-06 10:10:31","2019-11-07 14:00:00","2019-11-07 14:30:00",4030,1174,5204
"2019-11-06 10:10:31","2019-11-07 15:00:00","2019-11-07 15:30:00",4105,1191,5296
"2019-11-06 10:10:31","2019-11-07 16:00:00","2019-11-07 16:30:00",4220,1237,5457
"2019-11-06 10:10:31","2019-11-07 17:00:00","2019-11-07 17:30:00",4523,1409,5932
"2019-11-06 10:10:31","2019-11-07 18:00:00","2019-11-07 18:30:00",4705,1397,6102
"2019-11-06 10:10:31","2019-11-07 19:00:00","2019-11-07 19:30:00",4493,1277,5770
"2019-11-06 10:10:31","2019-11-07 20:00:00","2019-11-07 20:30:00",4243,1190,5433
"2019-11-06 10:10:31","2019-11-07 21:00:00","2019-11-07 21:30:00",4031,1112,5143
"2019-11-06 10:10:31","2019-11-07 22:00:00","2019-11-07 22:30:00",3666,1004,4670
"2019-11-07 10:10:21","2019-11-07 23:00:00","2019-11-07 23:30:00",3377,874,4251
"2019-11-07 10:10:21","2019-11-08 00:00:00","2019-11-08 00:30:00",3303,777,4080
"2019-11-07 10:10:21","2019-11-08 01:00:00","2019-11-08 01:30:00",3087,735,3822
"2019-11-07 10:10:21","2019-11-08 02:00:00","2019-11-08 02:30:00",2922,720,3642
"2019-11-07 10:10:21","2019-11-08 03:00:00","2019-11-08 03:30:00",2859,695,3554
"2019-11-07 10:10:21","2019-11-08 04:00:00","2019-11-08 04:30:00",2796,681,3477
"2019-11-07 10:10:21","2019-11-08 05:00:00","2019-11-08 05:30:00",2828,697,3525
"2019-11-07 10:10:21","2019-11-08 06:00:00","2019-11-08 06:30:00",2982,765,3747
"2019-11-07 10:10:21","2019-11-08 07:00:00","2019-11-08 07:30:00",3385,957,4342
"2019-11-07 10:10:21","2019-11-08 08:00:00","2019-11-08 08:30:00",3764,1116,4880
"2019-11-07 10:10:21","2019-11-08 09:00:00","2019-11-08 09:30:00",4069,1191,5260
"2019-11-07 10:10:21","2019-11-08 10:00:00","2019-11-08 10:30:00",4180,1232,5412
"2019-11-07 10:10:21","2019-11-08 11:00:00","2019-11-08 11:30:00",4166,1236,5402
"2019-11-07 10:10:21","2019-11-08 12:00:00","2019-11-08 12:30:00",4166,1235,5401
"2019-11-07 10:10:21","2019-11-08 13:00:00","2019-11-08 13:30:00",4146,1227,5373
"2019-11-07 10:10:21","2019-11-08 14:00:00","2019-11-08 14:30:00",4065,1184,5249
"2019-11-07 10:10:21","2019-11-08 15:00:00","2019-11-08 15:30:00",4091,1157,5248
"2019-11-07 10:10:21","2019-11-08 16:00:00","2019-11-08 16:30:00",4106,1183,5289
"2019-11-07 10:10:21","2019-11-08 17:00:00","2019-11-08 17:30:00",4363,1340,5703
"2019-11-07 10:10:21","2019-11-08 18:00:00","2019-11-08 18:30:00",4539,1340,5879
"2019-11-07 10:10:21","2019-11-08 19:00:00","2019-11-08 19:30:00",4335,1304,5639
"2019-11-07 10:10:21","2019-11-08 20:00:00","2019-11-08 20:30:00",4090,1196,5286
"2019-11-07 10:10:21","2019-11-08 21:00:00","2019-11-08 21:30:00",3755,1110,4865
"2019-11-07 10:10:21","2019-11-08 22:00:00","2019-11-08 22:30:00",3444,1002,4446
"2019-11-08 10:10:36","2019-11-08 23:00:00","2019-11-08 23:30:00",3317,867,4184
"2019-11-08 10:10:36","2019-11-09 00:00:00","2019-11-09 00:30:00",3177,773,3950
"2019-11-08 10:10:36","2019-11-09 01:00:00","2019-11-09 01:30:00",2938,687,3625
"2019-11-08 10:10:36","2019-11-09 02:00:00","2019-11-09 02:30:00",2781,647,3428
"2019-11-08 10:10:36","2019-11-09 03:00:00","2019-11-09 03:30:00",2671,612,3283
"2019-11-08 10:10:36","2019-11-09 04:00:00","2019-11-09 04:30:00",2655,602,3257
"2019-11-08 10:10:36","2019-11-09 05:00:00","2019-11-09 05:30:00",2668,624,3292
"2019-11-08 10:10:36","2019-11-09 06:00:00","2019-11-09 06:30:00",2735,661,3396
"2019-11-08 10:10:36","2019-11-09 07:00:00","2019-11-09 07:30:00",2913,755,3668
"2019-11-08 10:10:36","2019-11-09 08:00:00","2019-11-09 08:30:00",3107,877,3984
"2019-11-08 10:10:36","2019-11-09 09:00:00","2019-11-09 09:30:00",3488,1023,4511
"2019-11-08 10:10:36","2019-11-09 10:00:00","2019-11-09 10:30:00",3763,1059,4822
"2019-11-08 10:10:36","2019-11-09 11:00:00","2019-11-09 11:30:00",3747,1056,4803
"2019-11-08 10:10:36","2019-11-09 12:00:00","2019-11-09 12:30:00",3793,1082,4875
"2019-11-08 10:10:36","2019-11-09 13:00:00","2019-11-09 13:30:00",3771,1088,4859
"2019-11-08 10:10:36","2019-11-09 14:00:00","2019-11-09 14:30:00",3649,1049,4698
"2019-11-08 10:10:36","2019-11-09 15:00:00","2019-11-09 15:30:00",3601,1039,4640
"2019-11-08 10:10:36","2019-11-09 16:00:00","2019-11-09 16:30:00",3638,1052,4690
"2019-11-08 10:10:36","2019-11-09 17:00:00","2019-11-09 17:30:00",3961,1223,5184
"2019-11-08 10:10:36","2019-11-09 18:00:00","2019-11-09 18:30:00",4170,1277,5447
"2019-11-08 10:10:36","2019-11-09 19:00:00","2019-11-09 19:30:00",3994,1173,5167
"2019-11-08 10:10:36","2019-11-09 20:00:00","2019-11-09 20:30:00",3761,1086,4847
"2019-11-08 10:10:36","2019-11-09 21:00:00","2019-11-09 21:30:00",3550,1001,4551
"2019-11-08 10:10:36","2019-11-09 22:00:00","2019-11-09 22:30:00",3328,921,4249
"2019-11-09 10:10:26","2019-11-09 23:00:00","2019-11-09 23:30:00",3179,877,4056
"2019-11-09 10:10:26","2019-11-10 00:00:00","2019-11-10 00:30:00",3057,696,3753
"2019-11-09 10:10:26","2019-11-10 01:00:00","2019-11-10 01:30:00",2856,661,3517
"2019-11-09 10:10:26","2019-11-10 02:00:00","2019-11-10 02:30:00",2684,628,3312
"2019-11-09 10:10:26","2019-11-10 03:00:00","2019-11-10 03:30:00",2586,606,3192
"2019-11-09 10:10:26","2019-11-10 04:00:00","2019-11-10 04:30:00",2546,594,3140
"2019-11-09 10:10:26","2019-11-10 05:00:00","2019-11-10 05:30:00",2514,582,3096
"2019-11-09 10:10:26","2019-11-10 06:00:00","2019-11-10 06:30:00",2532,615,3147
"2019-11-09 10:10:26","2019-11-10 07:00:00","2019-11-10 07:30:00",2628,673,3301
"2019-11-09 10:10:26","2019-11-10 08:00:00","2019-11-10 08:30:00",2718,746,3464
"2019-11-09 10:10:26","2019-11-10 09:00:00","2019-11-10 09:30:00",3013,859,3872
"2019-11-09 10:10:26","2019-11-10 10:00:00","2019-11-10 10:30:00",3307,930,4237
"2019-11-09 10:10:26","2019-11-10 11:00:00","2019-11-10 11:30:00",3457,951,4408
"2019-11-09 10:10:26","2019-11-10 12:00:00","2019-11-10 12:30:00",3534,999,4533
"2019-11-09 10:10:26","2019-11-10 13:00:00","2019-11-10 13:30:00",3612,1053,4665
"2019-11-09 10:10:26","2019-11-10 14:00:00","2019-11-10 14:30:00",3568,1025,4593
"2019-11-09 10:10:26","2019-11-10 15:00:00","2019-11-10 15:30:00",3544,1002,4546
"2019-11-09 10:10:26","2019-11-10 16:00:00","2019-11-10 16:30:00",3572,1051,4623
"2019-11-09 10:10:26","2019-11-10 17:00:00","2019-11-10 17:30:00",3881,1191,5072
"2019-11-09 10:10:26","2019-11-10 18:00:00","2019-11-10 18:30:00",4100,1221,5321
"2019-11-09 10:10:26","2019-11-10 19:00:00","2019-11-10 19:30:00",3962,1190,5152
"2019-11-09 10:10:26","2019-11-10 20:00:00","2019-11-10 20:30:00",3850,1105,4955
"2019-11-09 10:10:26","2019-11-10 21:00:00","2019-11-10 21:30:00",3610,1014,4624
"2019-11-09 10:10:26","2019-11-10 22:00:00","2019-11-10 22:30:00",3351,916,4267
"2019-11-10 10:10:16","2019-11-10 23:00:00","2019-11-10 23:30:00",3049,760,3809
"2019-11-10 10:10:16","2019-11-11 00:00:00","2019-11-11 00:30:00",2945,708,3653
"2019-11-10 10:10:16","2019-11-11 01:00:00","2019-11-11 01:30:00",2780,661,3441
"2019-11-10 10:10:16","2019-11-11 02:00:00","2019-11-11 02:30:00",2661,636,3297
"2019-11-10 10:10:16","2019-11-11 03:00:00","2019-11-11 03:30:00",2612,624,3236
"2019-11-10 10:10:16","2019-11-11 04:00:00","2019-11-11 04:30:00",2600,622,3222
"2019-11-10 10:10:16","2019-11-11 05:00:00","2019-11-11 05:30:00",2634,641,3275
"2019-11-10 10:10:16","2019-11-11 06:00:00","2019-11-11 06:30:00",2837,722,3559
"2019-11-10 10:10:16","2019-11-11 07:00:00","2019-11-11 07:30:00",3354,910,4264
"2019-11-10 10:10:16","2019-11-11 08:00:00","2019-11-11 08:30:00",3804,1089,4893
"2019-11-10 10:10:16","2019-11-11 09:00:00","2019-11-11 09:30:00",3910,1153,5063
"2019-11-10 10:10:16","2019-11-11 10:00:00","2019-11-11 10:30:00",4003,1194,5197
"2019-11-10 10:10:16","2019-11-11 11:00:00","2019-11-11 11:30:00",4046,1157,5203
"2019-11-10 10:10:16","2019-11-11 12:00:00","2019-11-11 12:30:00",4086,1178,5264
"2019-11-10 10:10:16","2019-11-11 13:00:00","2019-11-11 13:30:00",4061,1182,5243
"2019-11-10 10:10:16","2019-11-11 14:00:00","2019-11-11 14:30:00",4025,1158,5183
"2019-11-10 10:10:16","2019-11-11 15:00:00","2019-11-11 15:30:00",4120,1193,5313
"2019-11-10 10:10:16","2019-11-11 16:00:00","2019-11-11 16:30:00",4220,1213,5433
"2019-11-10 10:10:16","2019-11-11 17:00:00","2019-11-11 17:30:00",4548,1438,5986
"2019-11-10 10:10:16","2019-11-11 18:00:00","2019-11-11 18:30:00",4750,1461,6211
"2019-11-10 10:10:16","2019-11-11 19:00:00","2019-11-11 19:30:00",4544,1333,5877
"2019-11-10 10:10:16","2019-11-11 20:00:00","2019-11-11 20:30:00",4317,1245,5562
"2019-11-10 10:10:16","2019-11-11 21:00:00","2019-11-11 21:30:00",4016,1133,5149
"2019-11-10 10:10:16","2019-11-11 22:00:00","2019-11-11 22:30:00",3659,994,4653
"2019-11-10 10:10:16","2019-11-11 23:00:00","2019-11-11 23:30:00",3372,845,4217
"2019-11-10 10:10:16","2019-11-12 00:00:00","2019-11-12 00:30:00",3207,738,3945
"2019-11-10 10:10:16","2019-11-12 01:00:00","2019-11-12 01:30:00",3005,678,3683
"2019-11-10 10:10:16","2019-11-12 02:00:00","2019-11-12 02:30:00",2817,662,3479
"2019-11-10 10:10:16","2019-11-12 03:00:00","2019-11-12 03:30:00",2718,653,3371
"2019-11-10 10:10:16","2019-11-12 04:00:00","2019-11-12 04:30:00",2701,629,3330
"2019-11-10 10:10:16","2019-11-12 05:00:00","2019-11-12 05:30:00",2703,642,3345
"2019-11-10 10:10:16","2019-11-12 06:00:00","2019-11-12 06:30:00",2906,717,3623
"2019-11-10 10:10:16","2019-11-12 07:00:00","2019-11-12 07:30:00",3484,922,4406
"2019-11-10 10:10:16","2019-11-12 08:00:00","2019-11-12 08:30:00",4046,1099,5145
"2019-11-10 10:10:16","2019-11-12 09:00:00","2019-11-12 09:30:00",4081,1144,5225
"2019-11-10 10:10:16","2019-11-12 10:00:00","2019-11-12 10:30:00",4167,1184,5351
"2019-11-10 10:10:16","2019-11-12 11:00:00","2019-11-12 11:30:00",4146,1169,5315
"2019-11-10 10:10:16","2019-11-12 12:00:00","2019-11-12 12:30:00",4159,1182,5341
"2019-11-10 10:10:16","2019-11-12 13:00:00","2019-11-12 13:30:00",4199,1188,5387
"2019-11-10 10:10:16","2019-11-12 14:00:00","2019-11-12 14:30:00",4122,1157,5279
"2019-11-10 10:10:16","2019-11-12 15:00:00","2019-11-12 15:30:00",4167,1154,5321
"2019-11-10 10:10:16","2019-11-12 16:00:00","2019-11-12 16:30:00",4284,1201,5485
"2019-11-10 10:10:16","2019-11-12 17:00:00","2019-11-12 17:30:00",4657,1409,6066
"2019-11-10 10:10:16","2019-11-12 18:00:00","2019-11-12 18:30:00",4744,1420,6164
"2019-11-10 10:10:16","2019-11-12 19:00:00","2019-11-12 19:30:00",4522,1316,5838
"2019-11-10 10:10:16","2019-11-12 20:00:00","2019-11-12 20:30:00",4313,1220,5533
"2019-11-10 10:10:16","2019-11-12 21:00:00","2019-11-12 21:30:00",4099,1153,5252
"2019-11-10 10:10:16","2019-11-12 22:00:00","2019-11-12 22:30:00",3768,1007,4775
"2019-11-12 10:10:25","2019-11-12 23:00:00","2019-11-12 23:30:00",3530,874,4404
"2019-11-12 10:10:25","2019-11-13 00:00:00","2019-11-13 00:30:00",3292,737,4029
"2019-11-12 10:10:25","2019-11-13 01:00:00","2019-11-13 01:30:00",3070,694,3764
"2019-11-12 10:10:25","2019-11-13 02:00:00","2019-11-13 02:30:00",2876,679,3555
"2019-11-12 10:10:25","2019-11-13 03:00:00","2019-11-13 03:30:00",2837,667,3504
"2019-11-12 10:10:25","2019-11-13 04:00:00","2019-11-13 04:30:00",2770,652,3422
"2019-11-12 10:10:25","2019-11-13 05:00:00","2019-11-13 05:30:00",2793,662,3455
"2019-11-12 10:10:25","2019-11-13 06:00:00","2019-11-13 06:30:00",2938,738,3676
"2019-11-12 10:10:25","2019-11-13 07:00:00","2019-11-13 07:30:00",3485,953,4438
"2019-11-12 10:10:25","2019-11-13 08:00:00","2019-11-13 08:30:00",4016,1150,5166
"2019-11-12 10:10:25","2019-11-13 09:00:00","2019-11-13 09:30:00",4095,1197,5292
"2019-11-12 10:10:25","2019-11-13 10:00:00","2019-11-13 10:30:00",4237,1233,5470
"2019-11-12 10:10:25","2019-11-13 11:00:00","2019-11-13 11:30:00",4227,1230,5457
"2019-11-12 10:10:25","2019-11-13 12:00:00","2019-11-13 12:30:00",4237,1243,5480
"2019-11-12 10:10:25","2019-11-13 13:00:00","2019-11-13 13:30:00",4311,1247,5558
"2019-11-12 10:10:25","2019-11-13 14:00:00","2019-11-13 14:30:00",4233,1203,5436
"2019-11-12 10:10:25","2019-11-13 15:00:00","2019-11-13 15:30:00",4285,1195,5480
"2019-11-12 10:10:25","2019-11-13 16:00:00","2019-11-13 16:30:00",4387,1249,5636
"2019-11-12 10:10:25","2019-11-13 17:00:00","2019-11-13 17:30:00",4735,1459,6194
"2019-11-12 10:10:25","2019-11-13 18:00:00","2019-11-13 18:30:00",4920,1464,6384
"2019-11-12 10:10:25","2019-11-13 19:00:00","2019-11-13 19:30:00",4720,1342,6062
"2019-11-12 10:10:25","2019-11-13 20:00:00","2019-11-13 20:30:00",4477,1247,5724
"2019-11-12 10:10:25","2019-11-13 21:00:00","2019-11-13 21:30:00",4248,1176,5424
"2019-11-12 10:10:25","2019-11-13 22:00:00","2019-11-13 22:30:00",3877,1018,4895
"2019-11-13 10:10:35","2019-11-13 23:00:00","2019-11-13 23:30:00",3565,849,4414
"2019-11-13 10:10:35","2019-11-14 00:00:00","2019-11-14 00:30:00",3238,699,3937
"2019-11-13 10:10:35","2019-11-14 01:00:00","2019-11-14 01:30:00",3005,655,3660
"2019-11-13 10:10:35","2019-11-14 02:00:00","2019-11-14 02:30:00",2855,625,3480
"2019-11-13 10:10:35","2019-11-14 03:00:00","2019-11-14 03:30:00",2763,617,3380
"2019-11-13 10:10:35","2019-11-14 04:00:00","2019-11-14 04:30:00",2750,607,3357
"2019-11-13 10:10:35","2019-11-14 05:00:00","2019-11-14 05:30:00",2816,622,3438
"2019-11-13 10:10:35","2019-11-14 06:00:00","2019-11-14 06:30:00",3002,690,3692
"2019-11-13 10:10:35","2019-11-14 07:00:00","2019-11-14 07:30:00",3585,938,4523
"2019-11-13 10:10:35","2019-11-14 08:00:00","2019-11-14 08:30:00",4040,1121,5161
"2019-11-13 10:10:35","2019-11-14 09:00:00","2019-11-14 09:30:00",4110,1181,5291
"2019-11-13 10:10:35","2019-11-14 10:00:00","2019-11-14 10:30:00",4190,1209,5399
"2019-11-13 10:10:35","2019-11-14 11:00:00","2019-11-14 11:30:00",4153,1188,5341
"2019-11-13 10:10:35","2019-11-14 12:00:00","2019-11-14 12:30:00",4168,1185,5353
"2019-11-13 10:10:35","2019-11-14 13:00:00","2019-11-14 13:30:00",4175,1183,5358
"2019-11-13 10:10:35","2019-11-14 14:00:00","2019-11-14 14:30:00",4128,1149,5277
"2019-11-13 10:10:35","2019-11-14 15:00:00","2019-11-14 15:30:00",4159,1174,5333
"2019-11-13 10:10:35","2019-11-14 16:00:00","2019-11-14 16:30:00",4271,1231,5502
"2019-11-13 10:10:35","2019-11-14 17:00:00","2019-11-14 17:30:00",4654,1437,6091
"2019-11-13 10:10:35","2019-11-14 18:00:00","2019-11-14 18:30:00",4890,1439,6329
"2019-11-13 10:10:35","2019-11-14 19:00:00","2019-11-14 19:30:00",4698,1334,6032
"2019-11-13 10:10:35","2019-11-14 20:00:00","2019-11-14 20:30:00",4501,1246,5747
"2019-11-13 10:10:35","2019-11-14 21:00:00","2019-11-14 21:30:00",4268,1154,5422
"2019-11-13 10:10:35","2019-11-14 22:00:00","2019-11-14 22:30:00",3882,1030,4912
"2019-11-14 10:10:56","2019-11-14 23:00:00","2019-11-14 23:30:00",3565,962,4527
"2019-11-14 10:10:56","2019-11-15 00:00:00","2019-11-15 00:30:00",3269,736,4005
"2019-11-14 10:10:56","2019-11-15 01:00:00","2019-11-15 01:30:00",3029,684,3713
"2019-11-14 10:10:56","2019-11-15 02:00:00","2019-11-15 02:30:00",2870,663,3533
"2019-11-14 10:10:56","2019-11-15 03:00:00","2019-11-15 03:30:00",2805,634,3439
"2019-11-14 10:10:56","2019-11-15 04:00:00","2019-11-15 04:30:00",2810,631,3441
"2019-11-14 10:10:56","2019-11-15 05:00:00","2019-11-15 05:30:00",2846,648,3494
"2019-11-14 10:10:56","2019-11-15 06:00:00","2019-11-15 06:30:00",3063,719,3782
"2019-11-14 10:10:56","2019-11-15 07:00:00","2019-11-15 07:30:00",3619,950,4569
"2019-11-14 10:10:56","2019-11-15 08:00:00","2019-11-15 08:30:00",4112,1140,5252
"2019-11-14 10:10:56","2019-11-15 09:00:00","2019-11-15 09:30:00",4223,1176,5399
"2019-11-14 10:10:56","2019-11-15 10:00:00","2019-11-15 10:30:00",4278,1204,5482
"2019-11-14 10:10:56","2019-11-15 11:00:00","2019-11-15 11:30:00",4255,1191,5446
"2019-11-14 10:10:56","2019-11-15 12:00:00","2019-11-15 12:30:00",4204,1177,5381
"2019-11-14 10:10:56","2019-11-15 13:00:00","2019-11-15 13:30:00",4188,1154,5342
"2019-11-14 10:10:56","2019-11-15 14:00:00","2019-11-15 14:30:00",4110,1116,5226
"2019-11-14 10:10:56","2019-11-15 15:00:00","2019-11-15 15:30:00",4114,1135,5249
"2019-11-14 10:10:56","2019-11-15 16:00:00","2019-11-15 16:30:00",4180,1178,5358
"2019-11-14 10:10:56","2019-11-15 17:00:00","2019-11-15 17:30:00",4524,1358,5882
"2019-11-14 10:10:56","2019-11-15 18:00:00","2019-11-15 18:30:00",4800,1384,6184
"2019-11-14 10:10:56","2019-11-15 19:00:00","2019-11-15 19:30:00",4548,1303,5851
"2019-11-14 10:10:56","2019-11-15 20:00:00","2019-11-15 20:30:00",4257,1202,5459
"2019-11-14 10:10:56","2019-11-15 21:00:00","2019-11-15 21:30:00",4033,1125,5158
"2019-11-14 10:10:56","2019-11-15 22:00:00","2019-11-15 22:30:00",3689,1008,4697
"2019-11-15 10:10:40","2019-11-15 23:00:00","2019-11-15 23:30:00",3449,867,4316
"2019-11-15 10:10:40","2019-11-16 00:00:00","2019-11-16 00:30:00",3288,754,4042
"2019-11-15 10:10:40","2019-11-16 01:00:00","2019-11-16 01:30:00",3062,680,3742
"2019-11-15 10:10:40","2019-11-16 02:00:00","2019-11-16 02:30:00",2792,638,3430
"2019-11-15 10:10:40","2019-11-16 03:00:00","2019-11-16 03:30:00",2830,602,3432
"2019-11-15 10:10:40","2019-11-16 04:00:00","2019-11-16 04:30:00",2746,583,3329
"2019-11-15 10:10:40","2019-11-16 05:00:00","2019-11-16 05:30:00",2730,591,3321
"2019-11-15 10:10:40","2019-11-16 06:00:00","2019-11-16 06:30:00",2768,651,3419
"2019-11-15 10:10:40","2019-11-16 07:00:00","2019-11-16 07:30:00",2989,761,3750
"2019-11-15 10:10:40","2019-11-16 08:00:00","2019-11-16 08:30:00",3170,884,4054
"2019-11-15 10:10:40","2019-11-16 09:00:00","2019-11-16 09:30:00",3563,1031,4594
"2019-11-15 10:10:40","2019-11-16 10:00:00","2019-11-16 10:30:00",3766,1091,4857
"2019-11-15 10:10:40","2019-11-16 11:00:00","2019-11-16 11:30:00",3890,1126,5016
"2019-11-15 10:10:40","2019-11-16 12:00:00","2019-11-16 12:30:00",3868,1147,5015
"2019-11-15 10:10:40","2019-11-16 13:00:00","2019-11-16 13:30:00",3868,1125,4993
"2019-11-15 10:10:40","2019-11-16 14:00:00","2019-11-16 14:30:00",3805,1084,4889
"2019-11-15 10:10:40","2019-11-16 15:00:00","2019-11-16 15:30:00",3716,1074,4790
"2019-11-15 10:10:40","2019-11-16 16:00:00","2019-11-16 16:30:00",3804,1107,4911
"2019-11-15 10:10:40","2019-11-16 17:00:00","2019-11-16 17:30:00",4182,1248,5430
"2019-11-15 10:10:40","2019-11-16 18:00:00","2019-11-16 18:30:00",4400,1271,5671
"2019-11-15 10:10:40","2019-11-16 19:00:00","2019-11-16 19:30:00",4229,1181,5410
"2019-11-15 10:10:40","2019-11-16 20:00:00","2019-11-16 20:30:00",3965,1091,5056
"2019-11-15 10:10:40","2019-11-16 21:00:00","2019-11-16 21:30:00",3763,1010,4773
"2019-11-15 10:10:40","2019-11-16 22:00:00","2019-11-16 22:30:00",3552,926,4478
"2019-11-16 10:10:40","2019-11-16 23:00:00","2019-11-16 23:30:00",3325,871,4196
"2019-11-16 10:10:40","2019-11-17 00:00:00","2019-11-17 00:30:00",3251,738,3989
"2019-11-16 10:10:40","2019-11-17 01:00:00","2019-11-17 01:30:00",3064,696,3760
"2019-11-16 10:10:40","2019-11-17 02:00:00","2019-11-17 02:30:00",2899,663,3562
"2019-11-16 10:10:40","2019-11-17 03:00:00","2019-11-17 03:30:00",2794,629,3423
"2019-11-16 10:10:40","2019-11-17 04:00:00","2019-11-17 04:30:00",2748,622,3370
"2019-11-16 10:10:40","2019-11-17 05:00:00","2019-11-17 05:30:00",2729,619,3348
"2019-11-16 10:10:40","2019-11-17 06:00:00","2019-11-17 06:30:00",2748,651,3399
"2019-11-16 10:10:40","2019-11-17 07:00:00","2019-11-17 07:30:00",2863,731,3594
"2019-11-16 10:10:40","2019-11-17 08:00:00","2019-11-17 08:30:00",2981,807,3788
"2019-11-16 10:10:40","2019-11-17 09:00:00","2019-11-17 09:30:00",3266,926,4192
"2019-11-16 10:10:40","2019-11-17 10:00:00","2019-11-17 10:30:00",3532,1003,4535
"2019-11-16 10:10:40","2019-11-17 11:00:00","2019-11-17 11:30:00",3690,1029,4719
"2019-11-16 10:10:40","2019-11-17 12:00:00","2019-11-17 12:30:00",3746,1094,4840
"2019-11-16 10:10:40","2019-11-17 13:00:00","2019-11-17 13:30:00",3802,1112,4914
"2019-11-16 10:10:40","2019-11-17 14:00:00","2019-11-17 14:30:00",3775,1076,4851
"2019-11-16 10:10:40","2019-11-17 15:00:00","2019-11-17 15:30:00",3748,1042,4790
"2019-11-16 10:10:40","2019-11-17 16:00:00","2019-11-17 16:30:00",3900,1077,4977
"2019-11-16 10:10:40","2019-11-17 17:00:00","2019-11-17 17:30:00",4185,1246,5431
"2019-11-16 10:10:40","2019-11-17 18:00:00","2019-11-17 18:30:00",4349,1237,5586
"2019-11-16 10:10:40","2019-11-17 19:00:00","2019-11-17 19:30:00",4222,1154,5376
"2019-11-16 10:10:40","2019-11-17 20:00:00","2019-11-17 20:30:00",4027,1050,5077
"2019-11-16 10:10:40","2019-11-17 21:00:00","2019-11-17 21:30:00",3873,974,4847
"2019-11-16 10:10:40","2019-11-17 22:00:00","2019-11-17 22:30:00",3493,918,4411
"2019-11-16 10:10:40","2019-11-17 23:00:00","2019-11-17 23:30:00",3260,778,4038
"2019-11-16 10:10:40","2019-11-18 00:00:00","2019-11-18 00:30:00",3100,673,3773
"2019-11-16 10:10:40","2019-11-18 01:00:00","2019-11-18 01:30:00",2885,617,3502
"2019-11-16 10:10:40","2019-11-18 02:00:00","2019-11-18 02:30:00",2715,618,3333
"2019-11-16 10:10:40","2019-11-18 03:00:00","2019-11-18 03:30:00",2678,605,3283
"2019-11-16 10:10:40","2019-11-18 04:00:00","2019-11-18 04:30:00",2637,594,3231
"2019-11-16 10:10:40","2019-11-18 05:00:00","2019-11-18 05:30:00",2701,620,3321
"2019-11-16 10:10:40","2019-11-18 06:00:00","2019-11-18 06:30:00",2903,725,3628
"2019-11-16 10:10:40","2019-11-18 07:00:00","2019-11-18 07:30:00",3477,920,4397
"2019-11-16 10:10:40","2019-11-18 08:00:00","2019-11-18 08:30:00",3988,1132,5120
"2019-11-16 10:10:40","2019-11-18 09:00:00","2019-11-18 09:30:00",4114,1178,5292
"2019-11-16 10:10:40","2019-11-18 10:00:00","2019-11-18 10:30:00",4180,1227,5407
"2019-11-16 10:10:40","2019-11-18 11:00:00","2019-11-18 11:30:00",4130,1189,5319
"2019-11-16 10:10:40","2019-11-18 12:00:00","2019-11-18 12:30:00",4108,1215,5323
"2019-11-16 10:10:40","2019-11-18 13:00:00","2019-11-18 13:30:00",4123,1208,5331
"2019-11-16 10:10:40","2019-11-18 14:00:00","2019-11-18 14:30:00",4063,1160,5223
"2019-11-16 10:10:40","2019-11-18 15:00:00","2019-11-18 15:30:00",4135,1177,5312
"2019-11-16 10:10:40","2019-11-18 16:00:00","2019-11-18 16:30:00",4229,1227,5456
"2019-11-16 10:10:40","2019-11-18 17:00:00","2019-11-18 17:30:00",4684,1490,6174
"2019-11-16 10:10:40","2019-11-18 18:00:00","2019-11-18 18:30:00",4806,1440,6246
"2019-11-16 10:10:40","2019-11-18 19:00:00","2019-11-18 19:30:00",4567,1317,5884
"2019-11-16 10:10:40","2019-11-18 20:00:00","2019-11-18 20:30:00",4388,1228,5616
"2019-11-16 10:10:40","2019-11-18 21:00:00","2019-11-18 21:30:00",4168,1165,5333
"2019-11-16 10:10:40","2019-11-18 22:00:00","2019-11-18 22:30:00",3765,990,4755
"2019-11-18 10:10:51","2019-11-18 23:00:00","2019-11-18 23:30:00",3565,906,4471
"2019-11-18 10:10:51","2019-11-19 00:00:00","2019-11-19 00:30:00",3291,751,4042
"2019-11-18 10:10:51","2019-11-19 01:00:00","2019-11-19 01:30:00",3062,686,3748
"2019-11-18 10:10:51","2019-11-19 02:00:00","2019-11-19 02:30:00",2932,695,3627
"2019-11-18 10:10:51","2019-11-19 03:00:00","2019-11-19 03:30:00",2848,663,3511
"2019-11-18 10:10:51","2019-11-19 04:00:00","2019-11-19 04:30:00",2810,650,3460
"2019-11-18 10:10:51","2019-11-19 05:00:00","2019-11-19 05:30:00",2838,661,3499
"2019-11-18 10:10:51","2019-11-19 06:00:00","2019-11-19 06:30:00",3040,738,3778
"2019-11-18 10:10:51","2019-11-19 07:00:00","2019-11-19 07:30:00",3564,944,4508
"2019-11-18 10:10:51","2019-11-19 08:00:00","2019-11-19 08:30:00",4031,1146,5177
"2019-11-18 10:10:51","2019-11-19 09:00:00","2019-11-19 09:30:00",4129,1189,5318
"2019-11-18 10:10:51","2019-11-19 10:00:00","2019-11-19 10:30:00",4207,1213,5420
"2019-11-18 10:10:51","2019-11-19 11:00:00","2019-11-19 11:30:00",4223,1183,5406
"2019-11-18 10:10:51","2019-11-19 12:00:00","2019-11-19 12:30:00",4265,1179,5444
"2019-11-18 10:10:51","2019-11-19 13:00:00","2019-11-19 13:30:00",4284,1167,5451
"2019-11-18 10:10:51","2019-11-19 14:00:00","2019-11-19 14:30:00",4206,1140,5346
"2019-11-18 10:10:51","2019-11-19 15:00:00","2019-11-19 15:30:00",4329,1169,5498
"2019-11-18 10:10:51","2019-11-19 16:00:00","2019-11-19 16:30:00",4493,1227,5720
"2019-11-18 10:10:51","2019-11-19 17:00:00","2019-11-19 17:30:00",4889,1440,6329
"2019-11-18 10:10:51","2019-11-19 18:00:00","2019-11-19 18:30:00",4942,1416,6358
"2019-11-18 10:10:51","2019-11-19 19:00:00","2019-11-19 19:30:00",4714,1302,6016
"2019-11-18 10:10:51","2019-11-19 20:00:00","2019-11-19 20:30:00",4469,1222,5691
"2019-11-18 10:10:51","2019-11-19 21:00:00","2019-11-19 21:30:00",4146,1139,5285
"2019-11-18 10:10:51","2019-11-19 22:00:00","2019-11-19 22:30:00",3753,1011,4764
"2019-11-19 10:10:46","2019-11-19 23:00:00","2019-11-19 23:30:00",3469,858,4327
"2019-11-19 10:10:46","2019-11-20 00:00:00","2019-11-20 00:30:00",3299,771,4070
"2019-11-19 10:10:46","2019-11-20 01:00:00","2019-11-20 01:30:00",3071,690,3761
"2019-11-19 10:10:46","2019-11-20 02:00:00","2019-11-20 02:30:00",2941,691,3632
"2019-11-19 10:10:46","2019-11-20 03:00:00","2019-11-20 03:30:00",2858,651,3509
"2019-11-19 10:10:46","2019-11-20 04:00:00","2019-11-20 04:30:00",2820,629,3449
"2019-11-19 10:10:46","2019-11-20 05:00:00","2019-11-20 05:30:00",2848,639,3487
"2019-11-19 10:10:46","2019-11-20 06:00:00","2019-11-20 06:30:00",3049,707,3756
"2019-11-19 10:10:46","2019-11-20 07:00:00","2019-11-20 07:30:00",3571,918,4489
"2019-11-19 10:10:46","2019-11-20 08:00:00","2019-11-20 08:30:00",4035,1111,5146
"2019-11-19 10:10:46","2019-11-20 09:00:00","2019-11-20 09:30:00",4133,1158,5291
"2019-11-19 10:10:46","2019-11-20 10:00:00","2019-11-20 10:30:00",4211,1185,5396
"2019-11-19 10:10:46","2019-11-20 11:00:00","2019-11-20 11:30:00",4226,1158,5384
"2019-11-19 10:10:46","2019-11-20 12:00:00","2019-11-20 12:30:00",4268,1162,5430
"2019-11-19 10:10:46","2019-11-20 13:00:00","2019-11-20 13:30:00",4287,1158,5445
"2019-11-19 10:10:46","2019-11-20 14:00:00","2019-11-20 14:30:00",4210,1129,5339
"2019-11-19 10:10:46","2019-11-20 15:00:00","2019-11-20 15:30:00",4331,1163,5494
"2019-11-19 10:10:46","2019-11-20 16:00:00","2019-11-20 16:30:00",4495,1229,5724
"2019-11-19 10:10:46","2019-11-20 17:00:00","2019-11-20 17:30:00",4889,1454,6343
"2019-11-19 10:10:46","2019-11-20 18:00:00","2019-11-20 18:30:00",4942,1435,6377
"2019-11-19 10:10:46","2019-11-20 19:00:00","2019-11-20 19:30:00",4716,1312,6028
"2019-11-19 10:10:46","2019-11-20 20:00:00","2019-11-20 20:30:00",4472,1234,5706
"2019-11-19 10:10:46","2019-11-20 21:00:00","2019-11-20 21:30:00",4150,1151,5301
"2019-11-19 10:10:46","2019-11-20 22:00:00","2019-11-20 22:30:00",3758,1023,4781
"2019-11-19 10:10:46","2019-11-20 23:00:00","2019-11-20 23:30:00",3476,879,4355
"2019-11-19 10:10:46","2019-11-21 00:00:00","2019-11-21 00:30:00",3299,753,4052
"2019-11-19 10:10:46","2019-11-21 01:00:00","2019-11-21 01:30:00",3071,691,3762
"2019-11-19 10:10:46","2019-11-21 02:00:00","2019-11-21 02:30:00",2941,694,3635
"2019-11-19 10:10:46","2019-11-21 03:00:00","2019-11-21 03:30:00",2858,666,3524
"2019-11-19 10:10:46","2019-11-21 04:00:00","2019-11-21 04:30:00",2820,654,3474
"2019-11-19 10:10:46","2019-11-21 05:00:00","2019-11-21 05:30:00",2848,669,3517
"2019-11-19 10:10:46","2019-11-21 06:00:00","2019-11-21 06:30:00",3049,740,3789
"2019-11-19 10:10:46","2019-11-21 07:00:00","2019-11-21 07:30:00",3571,964,4535
"2019-11-19 10:10:46","2019-11-21 08:00:00","2019-11-21 08:30:00",4035,1164,5199
"2019-11-19 10:10:46","2019-11-21 09:00:00","2019-11-21 09:30:00",4133,1214,5347
"2019-11-19 10:10:46","2019-11-21 10:00:00","2019-11-21 10:30:00",4211,1240,5451
"2019-11-19 10:10:46","2019-11-21 11:00:00","2019-11-21 11:30:00",4226,1212,5438
"2019-11-19 10:10:46","2019-11-21 12:00:00","2019-11-21 12:30:00",4268,1213,5481
"2019-11-19 10:10:46","2019-11-21 13:00:00","2019-11-21 13:30:00",4287,1205,5492
"2019-11-19 10:10:46","2019-11-21 14:00:00","2019-11-21 14:30:00",4210,1171,5381
"2019-11-19 10:10:46","2019-11-21 15:00:00","2019-11-21 15:30:00",4331,1208,5539
"2019-11-19 10:10:46","2019-11-21 16:00:00","2019-11-21 16:30:00",4495,1267,5762
"2019-11-19 10:10:46","2019-11-21 17:00:00","2019-11-21 17:30:00",4889,1483,6372
"2019-11-19 10:10:46","2019-11-21 18:00:00","2019-11-21 18:30:00",4942,1456,6398
"2019-11-19 10:10:46","2019-11-21 19:00:00","2019-11-21 19:30:00",4716,1339,6055
"2019-11-19 10:10:46","2019-11-21 20:00:00","2019-11-21 20:30:00",4472,1250,5722
"2019-11-19 10:10:46","2019-11-21 21:00:00","2019-11-21 21:30:00",4150,1163,5313
"2019-11-19 10:10:46","2019-11-21 22:00:00","2019-11-21 22:30:00",3758,1030,4788
"2019-11-19 10:10:46","2019-11-21 23:00:00","2019-11-21 23:30:00",3476,886,4362
"2019-11-19 10:10:46","2019-11-22 00:00:00","2019-11-22 00:30:00",3351,741,4092
"2019-11-19 10:10:46","2019-11-22 01:00:00","2019-11-22 01:30:00",3142,694,3836
"2019-11-19 10:10:46","2019-11-22 02:00:00","2019-11-22 02:30:00",2948,690,3638
"2019-11-19 10:10:46","2019-11-22 03:00:00","2019-11-22 03:30:00",2820,673,3493
"2019-11-19 10:10:46","2019-11-22 04:00:00","2019-11-22 04:30:00",2830,671,3501
"2019-11-19 10:10:46","2019-11-22 05:00:00","2019-11-22 05:30:00",2841,692,3533
"2019-11-19 10:10:46","2019-11-22 06:00:00","2019-11-22 06:30:00",3023,767,3790
"2019-11-19 10:10:46","2019-11-22 07:00:00","2019-11-22 07:30:00",3595,973,4568
"2019-11-19 10:10:46","2019-11-22 08:00:00","2019-11-22 08:30:00",4135,1195,5330
"2019-11-19 10:10:46","2019-11-22 09:00:00","2019-11-22 09:30:00",4223,1231,5454
"2019-11-19 10:10:46","2019-11-22 10:00:00","2019-11-22 10:30:00",4322,1256,5578
"2019-11-19 10:10:46","2019-11-22 11:00:00","2019-11-22 11:30:00",4304,1244,5548
"2019-11-19 10:10:46","2019-11-22 12:00:00","2019-11-22 12:30:00",4239,1241,5480
"2019-11-19 10:10:46","2019-11-22 13:00:00","2019-11-22 13:30:00",4214,1242,5456
"2019-11-19 10:10:46","2019-11-22 14:00:00","2019-11-22 14:30:00",4133,1221,5354
"2019-11-19 10:10:46","2019-11-22 15:00:00","2019-11-22 15:30:00",4131,1239,5370
"2019-11-19 10:10:46","2019-11-22 16:00:00","2019-11-22 16:30:00",4269,1312,5581
"2019-11-19 10:10:46","2019-11-22 17:00:00","2019-11-22 17:30:00",4676,1527,6203
"2019-11-19 10:10:46","2019-11-22 18:00:00","2019-11-22 18:30:00",4830,1489,6319
"2019-11-19 10:10:46","2019-11-22 19:00:00","2019-11-22 19:30:00",4647,1370,6017
"2019-11-19 10:10:46","2019-11-22 20:00:00","2019-11-22 20:30:00",4411,1293,5704
"2019-11-19 10:10:46","2019-11-22 21:00:00","2019-11-22 21:30:00",4138,1194,5332
"2019-11-19 10:10:46","2019-11-22 22:00:00","2019-11-22 22:30:00",3847,1054,4901
"2019-11-22 10:10:46","2019-11-22 23:00:00","2019-11-22 23:30:00",3535,839,4374
"2019-11-22 10:10:46","2019-11-23 00:00:00","2019-11-23 00:30:00",3293,756,4049
"2019-11-22 10:10:46","2019-11-23 01:00:00","2019-11-23 01:30:00",3040,684,3724
"2019-11-22 10:10:46","2019-11-23 02:00:00","2019-11-23 02:30:00",2859,657,3516
"2019-11-22 10:10:46","2019-11-23 03:00:00","2019-11-23 03:30:00",2740,626,3366
"2019-11-22 10:10:46","2019-11-23 04:00:00","2019-11-23 04:30:00",2687,626,3313
"2019-11-22 10:10:46","2019-11-23 05:00:00","2019-11-23 05:30:00",2663,617,3280
"2019-11-22 10:10:46","2019-11-23 06:00:00","2019-11-23 06:30:00",2735,667,3402
"2019-11-22 10:10:46","2019-11-23 07:00:00","2019-11-23 07:30:00",2921,759,3680
"2019-11-22 10:10:46","2019-11-23 08:00:00","2019-11-23 08:30:00",3150,863,4013
"2019-11-22 10:10:46","2019-11-23 09:00:00","2019-11-23 09:30:00",3469,995,4464
"2019-11-22 10:10:46","2019-11-23 10:00:00","2019-11-23 10:30:00",3710,1076,4786
"2019-11-22 10:10:46","2019-11-23 11:00:00","2019-11-23 11:30:00",3822,1097,4919
"2019-11-22 10:10:46","2019-11-23 12:00:00","2019-11-23 12:30:00",3847,1135,4982
"2019-11-22 10:10:46","2019-11-23 13:00:00","2019-11-23 13:30:00",3876,1103,4979
"2019-11-22 10:10:46","2019-11-23 14:00:00","2019-11-23 14:30:00",3778,1070,4848
"2019-11-22 10:10:46","2019-11-23 15:00:00","2019-11-23 15:30:00",3763,1056,4819
"2019-11-22 10:10:46","2019-11-23 16:00:00","2019-11-23 16:30:00",3849,1093,4942
"2019-11-22 10:10:46","2019-11-23 17:00:00","2019-11-23 17:30:00",4274,1272,5546
"2019-11-22 10:10:46","2019-11-23 18:00:00","2019-11-23 18:30:00",4382,1259,5641
"2019-11-22 10:10:46","2019-11-23 19:00:00","2019-11-23 19:30:00",4186,1169,5355
"2019-11-22 10:10:46","2019-11-23 20:00:00","2019-11-23 20:30:00",3952,1082,5034
"2019-11-22 10:10:46","2019-11-23 21:00:00","2019-11-23 21:30:00",3740,1027,4767
"2019-11-22 10:10:46","2019-11-23 22:00:00","2019-11-23 22:30:00",3487,942,4429
"2019-11-23 10:10:41","2019-11-23 23:00:00","2019-11-23 23:30:00",3301,851,4152
"2019-11-23 10:10:41","2019-11-24 00:00:00","2019-11-24 00:30:00",3201,740,3941
"2019-11-23 10:10:41","2019-11-24 01:00:00","2019-11-24 01:30:00",2995,680,3675
"2019-11-23 10:10:41","2019-11-24 02:00:00","2019-11-24 02:30:00",2810,672,3482
"2019-11-23 10:10:41","2019-11-24 03:00:00","2019-11-24 03:30:00",2666,629,3295
"2019-11-23 10:10:41","2019-11-24 04:00:00","2019-11-24 04:30:00",2590,618,3208
"2019-11-23 10:10:41","2019-11-24 05:00:00","2019-11-24 05:30:00",2513,610,3123
"2019-11-23 10:10:41","2019-11-24 06:00:00","2019-11-24 06:30:00",2539,633,3172
"2019-11-23 10:10:41","2019-11-24 07:00:00","2019-11-24 07:30:00",2621,694,3315
"2019-11-23 10:10:41","2019-11-24 08:00:00","2019-11-24 08:30:00",2770,770,3540
"2019-11-23 10:10:41","2019-11-24 09:00:00","2019-11-24 09:30:00",3077,885,3962
"2019-11-23 10:10:41","2019-11-24 10:00:00","2019-11-24 10:30:00",3436,977,4413
"2019-11-23 10:10:41","2019-11-24 11:00:00","2019-11-24 11:30:00",3671,1019,4690
"2019-11-23 10:10:41","2019-11-24 12:00:00","2019-11-24 12:30:00",3802,1081,4883
"2019-11-23 10:10:41","2019-11-24 13:00:00","2019-11-24 13:30:00",3814,1104,4918
"2019-11-23 10:10:41","2019-11-24 14:00:00","2019-11-24 14:30:00",3735,1055,4790
"2019-11-23 10:10:41","2019-11-24 15:00:00","2019-11-24 15:30:00",3689,1019,4708
"2019-11-23 10:10:41","2019-11-24 16:00:00","2019-11-24 16:30:00",3693,1088,4781
"2019-11-23 10:10:41","2019-11-24 17:00:00","2019-11-24 17:30:00",4119,1257,5376
"2019-11-23 10:10:41","2019-11-24 18:00:00","2019-11-24 18:30:00",4298,1269,5567
"2019-11-23 10:10:41","2019-11-24 19:00:00","2019-11-24 19:30:00",4138,1138,5276
"2019-11-23 10:10:41","2019-11-24 20:00:00","2019-11-24 20:30:00",3969,1082,5051
"2019-11-23 10:10:41","2019-11-24 21:00:00","2019-11-24 21:30:00",3782,1033,4815
"2019-11-23 10:10:41","2019-11-24 22:00:00","2019-11-24 22:30:00",3451,925,4376
"2019-11-23 10:10:41","2019-11-24 23:00:00","2019-11-24 23:30:00",3202,803,4005
"2019-11-23 10:10:41","2019-11-25 00:00:00","2019-11-25 00:30:00",3027,696,3723
"2019-11-23 10:10:41","2019-11-25 01:00:00","2019-11-25 01:30:00",2815,655,3470
"2019-11-23 10:10:41","2019-11-25 02:00:00","2019-11-25 02:30:00",2668,646,3314
"2019-11-23 10:10:41","2019-11-25 03:00:00","2019-11-25 03:30:00",2590,629,3219
"2019-11-23 10:10:41","2019-11-25 04:00:00","2019-11-25 04:30:00",2558,619,3177
"2019-11-23 10:10:41","2019-11-25 05:00:00","2019-11-25 05:30:00",2564,628,3192
"2019-11-23 10:10:41","2019-11-25 06:00:00","2019-11-25 06:30:00",2756,714,3470
"2019-11-23 10:10:41","2019-11-25 07:00:00","2019-11-25 07:30:00",3261,910,4171
"2019-11-23 10:10:41","2019-11-25 08:00:00","2019-11-25 08:30:00",3724,1098,4822
"2019-11-23 10:10:41","2019-11-25 09:00:00","2019-11-25 09:30:00",3851,1146,4997
"2019-11-23 10:10:41","2019-11-25 10:00:00","2019-11-25 10:30:00",4006,1162,5168
"2019-11-23 10:10:41","2019-11-25 11:00:00","2019-11-25 11:30:00",4072,1155,5227
"2019-11-23 10:10:41","2019-11-25 12:00:00","2019-11-25 12:30:00",4182,1162,5344
"2019-11-23 10:10:41","2019-11-25 13:00:00","2019-11-25 13:30:00",4184,1173,5357
"2019-11-23 10:10:41","2019-11-25 14:00:00","2019-11-25 14:30:00",4137,1117,5254
"2019-11-23 10:10:41","2019-11-25 15:00:00","2019-11-25 15:30:00",4225,1175,5400
"2019-11-23 10:10:41","2019-11-25 16:00:00","2019-11-25 16:30:00",4332,1235,5567
"2019-11-23 10:10:41","2019-11-25 17:00:00","2019-11-25 17:30:00",4794,1473,6267
"2019-11-23 10:10:41","2019-11-25 18:00:00","2019-11-25 18:30:00",4837,1456,6293
"2019-11-23 10:10:41","2019-11-25 19:00:00","2019-11-25 19:30:00",4644,1322,5966
"2019-11-23 10:10:41","2019-11-25 20:00:00","2019-11-25 20:30:00",4399,1225,5624
"2019-11-23 10:10:41","2019-11-25 21:00:00","2019-11-25 21:30:00",4099,1163,5262
"2019-11-23 10:10:41","2019-11-25 22:00:00","2019-11-25 22:30:00",3738,1006,4744
"2019-11-25 10:10:51","2019-11-25 23:00:00","2019-11-25 23:30:00",3425,878,4303
"2019-11-25 10:10:51","2019-11-26 00:00:00","2019-11-26 00:30:00",3225,701,3926
"2019-11-25 10:10:51","2019-11-26 01:00:00","2019-11-26 01:30:00",3034,646,3680
"2019-11-25 10:10:51","2019-11-26 02:00:00","2019-11-26 02:30:00",2916,644,3560
"2019-11-25 10:10:51","2019-11-26 03:00:00","2019-11-26 03:30:00",2818,629,3447
"2019-11-25 10:10:51","2019-11-26 04:00:00","2019-11-26 04:30:00",2793,623,3416
"2019-11-25 10:10:51","2019-11-26 05:00:00","2019-11-26 05:30:00",2824,633,3457
"2019-11-25 10:10:51","2019-11-26 06:00:00","2019-11-26 06:30:00",3033,713,3746
"2019-11-25 10:10:51","2019-11-26 07:00:00","2019-11-26 07:30:00",3579,945,4524
"2019-11-25 10:10:51","2019-11-26 08:00:00","2019-11-26 08:30:00",4117,1169,5286
"2019-11-25 10:10:51","2019-11-26 09:00:00","2019-11-26 09:30:00",4183,1186,5369
"2019-11-25 10:10:51","2019-11-26 10:00:00","2019-11-26 10:30:00",4254,1214,5468
"2019-11-25 10:10:51","2019-11-26 11:00:00","2019-11-26 11:30:00",4232,1215,5447
"2019-11-25 10:10:51","2019-11-26 12:00:00","2019-11-26 12:30:00",4254,1224,5478
"2019-11-25 10:10:51","2019-11-26 13:00:00","2019-11-26 13:30:00",4228,1211,5439
"2019-11-25 10:10:51","2019-11-26 14:00:00","2019-11-26 14:30:00",4181,1174,5355
"2019-11-25 10:10:51","2019-11-26 15:00:00","2019-11-26 15:30:00",4194,1191,5385
"2019-11-25 10:10:51","2019-11-26 16:00:00","2019-11-26 16:30:00",4310,1240,5550
"2019-11-25 10:10:51","2019-11-26 17:00:00","2019-11-26 17:30:00",4750,1426,6176
"2019-11-25 10:10:51","2019-11-26 18:00:00","2019-11-26 18:30:00",4723,1391,6114
"2019-11-25 10:10:51","2019-11-26 19:00:00","2019-11-26 19:30:00",4508,1283,5791
"2019-11-25 10:10:51","2019-11-26 20:00:00","2019-11-26 20:30:00",4315,1202,5517
"2019-11-25 10:10:51","2019-11-26 21:00:00","2019-11-26 21:30:00",4075,1130,5205
"2019-11-25 10:10:51","2019-11-26 22:00:00","2019-11-26 22:30:00",3695,983,4678
"2019-11-26 10:10:40","2019-11-26 23:00:00","2019-11-26 23:30:00",3406,858,4264
"2019-11-26 10:10:40","2019-11-27 00:00:00","2019-11-27 00:30:00",3240,714,3954
"2019-11-26 10:10:40","2019-11-27 01:00:00","2019-11-27 01:30:00",3030,659,3689
"2019-11-26 10:10:40","2019-11-27 02:00:00","2019-11-27 02:30:00",2906,659,3565
"2019-11-26 10:10:40","2019-11-27 03:00:00","2019-11-27 03:30:00",2811,642,3453
"2019-11-26 10:10:40","2019-11-27 04:00:00","2019-11-27 04:30:00",2788,636,3424
"2019-11-26 10:10:40","2019-11-27 05:00:00","2019-11-27 05:30:00",2822,645,3467
"2019-11-26 10:10:40","2019-11-27 06:00:00","2019-11-27 06:30:00",3029,727,3756
"2019-11-26 10:10:40","2019-11-27 07:00:00","2019-11-27 07:30:00",3576,961,4537
"2019-11-26 10:10:40","2019-11-27 08:00:00","2019-11-27 08:30:00",4116,1190,5306
"2019-11-26 10:10:40","2019-11-27 09:00:00","2019-11-27 09:30:00",4178,1218,5396
"2019-11-26 10:10:40","2019-11-27 10:00:00","2019-11-27 10:30:00",4250,1255,5505
"2019-11-26 10:10:40","2019-11-27 11:00:00","2019-11-27 11:30:00",4222,1256,5478
"2019-11-26 10:10:40","2019-11-27 12:00:00","2019-11-27 12:30:00",4243,1258,5501
"2019-11-26 10:10:40","2019-11-27 13:00:00","2019-11-27 13:30:00",4209,1252,5461
"2019-11-26 10:10:40","2019-11-27 14:00:00","2019-11-27 14:30:00",4157,1207,5364
"2019-11-26 10:10:40","2019-11-27 15:00:00","2019-11-27 15:30:00",4174,1221,5395
"2019-11-26 10:10:40","2019-11-27 16:00:00","2019-11-27 16:30:00",4295,1283,5578
"2019-11-26 10:10:40","2019-11-27 17:00:00","2019-11-27 17:30:00",4750,1478,6228
"2019-11-26 10:10:40","2019-11-27 18:00:00","2019-11-27 18:30:00",4730,1440,6170
"2019-11-26 10:10:40","2019-11-27 19:00:00","2019-11-27 19:30:00",4515,1329,5844
"2019-11-26 10:10:40","2019-11-27 20:00:00","2019-11-27 20:30:00",4322,1250,5572
"2019-11-26 10:10:40","2019-11-27 21:00:00","2019-11-27 21:30:00",4081,1179,5260
"2019-11-26 10:10:40","2019-11-27 22:00:00","2019-11-27 22:30:00",3702,1029,4731
"2019-11-26 10:10:40","2019-11-27 23:00:00","2019-11-27 23:30:00",3419,885,4304
"2019-11-26 10:10:40","2019-11-28 00:00:00","2019-11-28 00:30:00",3248,728,3976
"2019-11-26 10:10:40","2019-11-28 01:00:00","2019-11-28 01:30:00",3034,670,3704
"2019-11-26 10:10:40","2019-11-28 02:00:00","2019-11-28 02:30:00",2907,669,3576
"2019-11-26 10:10:40","2019-11-28 03:00:00","2019-11-28 03:30:00",2812,651,3463
"2019-11-26 10:10:40","2019-11-28 04:00:00","2019-11-28 04:30:00",2788,643,3431
"2019-11-26 10:10:40","2019-11-28 05:00:00","2019-11-28 05:30:00",2822,649,3471
"2019-11-26 10:10:40","2019-11-28 06:00:00","2019-11-28 06:30:00",3030,728,3758
"2019-11-26 10:10:40","2019-11-28 07:00:00","2019-11-28 07:30:00",3576,969,4545
"2019-11-26 10:10:40","2019-11-28 08:00:00","2019-11-28 08:30:00",4116,1200,5316
"2019-11-26 10:10:40","2019-11-28 09:00:00","2019-11-28 09:30:00",4178,1229,5407
"2019-11-26 10:10:40","2019-11-28 10:00:00","2019-11-28 10:30:00",4250,1270,5520
"2019-11-26 10:10:40","2019-11-28 11:00:00","2019-11-28 11:30:00",4222,1275,5497
"2019-11-26 10:10:40","2019-11-28 12:00:00","2019-11-28 12:30:00",4243,1283,5526
"2019-11-26 10:10:40","2019-11-28 13:00:00","2019-11-28 13:30:00",4209,1279,5488
"2019-11-26 10:10:40","2019-11-28 14:00:00","2019-11-28 14:30:00",4157,1224,5381
"2019-11-26 10:10:40","2019-11-28 15:00:00","2019-11-28 15:30:00",4174,1241,5415
"2019-11-26 10:10:40","2019-11-28 16:00:00","2019-11-28 16:30:00",4295,1308,5603
"2019-11-26 10:10:40","2019-11-28 17:00:00","2019-11-28 17:30:00",4678,1498,6176
"2019-11-26 10:10:40","2019-11-28 18:00:00","2019-11-28 18:30:00",4730,1460,6190
"2019-11-26 10:10:40","2019-11-28 19:00:00","2019-11-28 19:30:00",4515,1349,5864
"2019-11-26 10:10:40","2019-11-28 20:00:00","2019-11-28 20:30:00",4322,1270,5592
"2019-11-26 10:10:40","2019-11-28 21:00:00","2019-11-28 21:30:00",4081,1192,5273
"2019-11-26 10:10:40","2019-11-28 22:00:00","2019-11-28 22:30:00",3702,1040,4742
"2019-11-28 10:10:55","2019-11-28 23:00:00","2019-11-28 23:30:00",3430,896,4326
"2019-11-28 10:10:55","2019-11-29 00:00:00","2019-11-29 00:30:00",3181,726,3907
"2019-11-28 10:10:55","2019-11-29 01:00:00","2019-11-29 01:30:00",2985,656,3641
"2019-11-28 10:10:55","2019-11-29 02:00:00","2019-11-29 02:30:00",2847,657,3504
"2019-11-28 10:10:55","2019-11-29 03:00:00","2019-11-29 03:30:00",2744,630,3374
"2019-11-28 10:10:55","2019-11-29 04:00:00","2019-11-29 04:30:00",2736,630,3366
"2019-11-28 10:10:55","2019-11-29 05:00:00","2019-11-29 05:30:00",2753,650,3403
"2019-11-28 10:10:55","2019-11-29 06:00:00","2019-11-29 06:30:00",2908,724,3632
"2019-11-28 10:10:55","2019-11-29 07:00:00","2019-11-29 07:30:00",3472,917,4389
"2019-11-28 10:10:55","2019-11-29 08:00:00","2019-11-29 08:30:00",4013,1144,5157
"2019-11-28 10:10:55","2019-11-29 09:00:00","2019-11-29 09:30:00",4072,1182,5254
"2019-11-28 10:10:55","2019-11-29 10:00:00","2019-11-29 10:30:00",4162,1226,5388
"2019-11-28 10:10:55","2019-11-29 11:00:00","2019-11-29 11:30:00",4142,1231,5373
"2019-11-28 10:10:55","2019-11-29 12:00:00","2019-11-29 12:30:00",4136,1239,5375
"2019-11-28 10:10:55","2019-11-29 13:00:00","2019-11-29 13:30:00",4125,1227,5352
"2019-11-28 10:10:55","2019-11-29 14:00:00","2019-11-29 14:30:00",4102,1172,5274
"2019-11-28 10:10:55","2019-11-29 15:00:00","2019-11-29 15:30:00",4107,1180,5287
"2019-11-28 10:10:55","2019-11-29 16:00:00","2019-11-29 16:30:00",4212,1221,5433
"2019-11-28 10:10:55","2019-11-29 17:00:00","2019-11-29 17:30:00",4583,1370,5953
"2019-11-28 10:10:55","2019-11-29 18:00:00","2019-11-29 18:30:00",4656,1334,5990
"2019-11-28 10:10:55","2019-11-29 19:00:00","2019-11-29 19:30:00",4452,1248,5700
"2019-11-28 10:10:55","2019-11-29 20:00:00","2019-11-29 20:30:00",4230,1151,5381
"2019-11-28 10:10:55","2019-11-29 21:00:00","2019-11-29 21:30:00",4034,1084,5118
"2019-11-28 10:10:55","2019-11-29 22:00:00","2019-11-29 22:30:00",3687,968,4655
"2019-11-29 10:10:51","2019-11-29 23:00:00","2019-11-29 23:30:00",3482,856,4338
"2019-11-29 10:10:51","2019-11-30 00:00:00","2019-11-30 00:30:00",3310,778,4088
"2019-11-29 10:10:51","2019-11-30 01:00:00","2019-11-30 01:30:00",3035,698,3733
"2019-11-29 10:10:51","2019-11-30 02:00:00","2019-11-30 02:30:00",2825,683,3508
"2019-11-29 10:10:51","2019-11-30 03:00:00","2019-11-30 03:30:00",2732,651,3383
"2019-11-29 10:10:51","2019-11-30 04:00:00","2019-11-30 04:30:00",2656,646,3302
"2019-11-29 10:10:51","2019-11-30 05:00:00","2019-11-30 05:30:00",2640,635,3275
"2019-11-29 10:10:51","2019-11-30 06:00:00","2019-11-30 06:30:00",2711,657,3368
"2019-11-29 10:10:51","2019-11-30 07:00:00","2019-11-30 07:30:00",2899,756,3655
"2019-11-29 10:10:51","2019-11-30 08:00:00","2019-11-30 08:30:00",3189,884,4073
"2019-11-29 10:10:51","2019-11-30 09:00:00","2019-11-30 09:30:00",3469,1005,4474
"2019-11-29 10:10:51","2019-11-30 10:00:00","2019-11-30 10:30:00",3721,1085,4806
"2019-11-29 10:10:51","2019-11-30 11:00:00","2019-11-30 11:30:00",3858,1118,4976
"2019-11-29 10:10:51","2019-11-30 12:00:00","2019-11-30 12:30:00",3899,1144,5043
"2019-11-29 10:10:51","2019-11-30 13:00:00","2019-11-30 13:30:00",3911,1132,5043
"2019-11-29 10:10:51","2019-11-30 14:00:00","2019-11-30 14:30:00",3840,1088,4928
"2019-11-29 10:10:51","2019-11-30 15:00:00","2019-11-30 15:30:00",3843,1088,4931
"2019-11-29 10:10:51","2019-11-30 16:00:00","2019-11-30 16:30:00",3884,1131,5015
"2019-11-29 10:10:51","2019-11-30 17:00:00","2019-11-30 17:30:00",4268,1309,5577
"2019-11-29 10:10:51","2019-11-30 18:00:00","2019-11-30 18:30:00",4336,1297,5633
"2019-11-29 10:10:51","2019-11-30 19:00:00","2019-11-30 19:30:00",4125,1215,5340
"2019-11-29 10:10:51","2019-11-30 20:00:00","2019-11-30 20:30:00",3914,1109,5023
"2019-11-29 10:10:51","2019-11-30 21:00:00","2019-11-30 21:30:00",3719,1040,4759
"2019-11-29 10:10:51","2019-11-30 22:00:00","2019-11-30 22:30:00",3478,948,4426
"2019-11-30 10:10:45","2019-11-30 23:00:00","2019-11-30 23:30:00",3339,853,4192
"2019-11-30 10:10:45","2019-12-01 00:00:00","2019-12-01 00:30:00",3230,757,3987
"2019-11-30 10:10:45","2019-12-01 01:00:00","2019-12-01 01:30:00",2989,700,3689
"2019-11-30 10:10:45","2019-12-01 02:00:00","2019-12-01 02:30:00",2804,680,3484
"2019-11-30 10:10:45","2019-12-01 03:00:00","2019-12-01 03:30:00",2710,653,3363
"2019-11-30 10:10:45","2019-12-01 04:00:00","2019-12-01 04:30:00",2665,642,3307
"2019-11-30 10:10:45","2019-12-01 05:00:00","2019-12-01 05:30:00",2634,636,3270
"2019-11-30 10:10:45","2019-12-01 06:00:00","2019-12-01 06:30:00",2649,656,3305
"2019-11-30 10:10:45","2019-12-01 07:00:00","2019-12-01 07:30:00",2735,721,3456
"2019-11-30 10:10:45","2019-12-01 08:00:00","2019-12-01 08:30:00",2850,801,3651
"2019-11-30 10:10:45","2019-12-01 09:00:00","2019-12-01 09:30:00",3094,911,4005
"2019-11-30 10:10:45","2019-12-01 10:00:00","2019-12-01 10:30:00",3384,993,4377
"2019-11-30 10:10:45","2019-12-01 11:00:00","2019-12-01 11:30:00",3554,1058,4612
"2019-11-30 10:10:45","2019-12-01 12:00:00","2019-12-01 12:30:00",3669,1136,4805
"2019-11-30 10:10:45","2019-12-01 13:00:00","2019-12-01 13:30:00",3739,1160,4899
"2019-11-30 10:10:45","2019-12-01 14:00:00","2019-12-01 14:30:00",3666,1102,4768
"2019-11-30 10:10:45","2019-12-01 15:00:00","2019-12-01 15:30:00",3610,1087,4697
"2019-11-30 10:10:45","2019-12-01 16:00:00","2019-12-01 16:30:00",3667,1145,4812
"2019-11-30 10:10:45","2019-12-01 17:00:00","2019-12-01 17:30:00",4038,1325,5363
"2019-11-30 10:10:45","2019-12-01 18:00:00","2019-12-01 18:30:00",4151,1323,5474
"2019-11-30 10:10:45","2019-12-01 19:00:00","2019-12-01 19:30:00",4035,1213,5248
"2019-11-30 10:10:45","2019-12-01 20:00:00","2019-12-01 20:30:00",3910,1143,5053
"2019-11-30 10:10:45","2019-12-01 21:00:00","2019-12-01 21:30:00",3709,1078,4787
"2019-11-30 10:10:45","2019-12-01 22:00:00","2019-12-01 22:30:00",3392,977,4369
"2019-12-01 10:10:46","2019-12-01 23:00:00","2019-12-01 23:30:00",3212,873,4085
"2019-12-01 10:10:46","2019-12-02 00:00:00","2019-12-02 00:30:00",3037,726,3763
"2019-12-01 10:10:46","2019-12-02 01:00:00","2019-12-02 01:30:00",2837,679,3516
"2019-12-01 10:10:46","2019-12-02 02:00:00","2019-12-02 02:30:00",2696,667,3363
"2019-12-01 10:10:46","2019-12-02 03:00:00","2019-12-02 03:30:00",2622,652,3274
"2019-12-01 10:10:46","2019-12-02 04:00:00","2019-12-02 04:30:00",2634,629,3263
"2019-12-01 10:10:46","2019-12-02 05:00:00","2019-12-02 05:30:00",2662,630,3292
"2019-12-01 10:10:46","2019-12-02 06:00:00","2019-12-02 06:30:00",2869,711,3580
"2019-12-01 10:10:46","2019-12-02 07:00:00","2019-12-02 07:30:00",3414,941,4355
"2019-12-01 10:10:46","2019-12-02 08:00:00","2019-12-02 08:30:00",4017,1153,5170
"2019-12-01 10:10:46","2019-12-02 09:00:00","2019-12-02 09:30:00",4120,1207,5327
"2019-12-01 10:10:46","2019-12-02 10:00:00","2019-12-02 10:30:00",4236,1235,5471
"2019-12-01 10:10:46","2019-12-02 11:00:00","2019-12-02 11:30:00",4270,1235,5505
"2019-12-01 10:10:46","2019-12-02 12:00:00","2019-12-02 12:30:00",4284,1236,5520
"2019-12-01 10:10:46","2019-12-02 13:00:00","2019-12-02 13:30:00",4305,1244,5549
"2019-12-01 10:10:46","2019-12-02 14:00:00","2019-12-02 14:30:00",4204,1211,5415
"2019-12-01 10:10:46","2019-12-02 15:00:00","2019-12-02 15:30:00",4243,1230,5473
"2019-12-01 10:10:46","2019-12-02 16:00:00","2019-12-02 16:30:00",4396,1299,5695
"2019-12-01 10:10:46","2019-12-02 17:00:00","2019-12-02 17:30:00",4866,1524,6390
"2019-12-01 10:10:46","2019-12-02 18:00:00","2019-12-02 18:30:00",4901,1494,6395
"2019-12-01 10:10:46","2019-12-02 19:00:00","2019-12-02 19:30:00",4676,1351,6027
"2019-12-01 10:10:46","2019-12-02 20:00:00","2019-12-02 20:30:00",4446,1265,5711
"2019-12-01 10:10:46","2019-12-02 21:00:00","2019-12-02 21:30:00",4211,1192,5403
"2019-12-01 10:10:46","2019-12-02 22:00:00","2019-12-02 22:30:00",3793,1050,4843
"2019-12-02 10:10:51","2019-12-02 23:00:00","2019-12-02 23:30:00",3560,930,4490
"2019-12-02 10:10:51","2019-12-03 00:00:00","2019-12-03 00:30:00",3276,748,4024
"2019-12-02 10:10:51","2019-12-03 01:00:00","2019-12-03 01:30:00",3047,692,3739
"2019-12-02 10:10:51","2019-12-03 02:00:00","2019-12-03 02:30:00",2892,684,3576
"2019-12-02 10:10:51","2019-12-03 03:00:00","2019-12-03 03:30:00",2811,662,3473
"2019-12-02 10:10:51","2019-12-03 04:00:00","2019-12-03 04:30:00",2806,655,3461
"2019-12-02 10:10:51","2019-12-03 05:00:00","2019-12-03 05:30:00",2814,662,3476
"2019-12-02 10:10:51","2019-12-03 06:00:00","2019-12-03 06:30:00",2997,743,3740
"2019-12-02 10:10:51","2019-12-03 07:00:00","2019-12-03 07:30:00",3544,966,4510
"2019-12-02 10:10:51","2019-12-03 08:00:00","2019-12-03 08:30:00",4160,1179,5339
"2019-12-02 10:10:51","2019-12-03 09:00:00","2019-12-03 09:30:00",4155,1202,5357
"2019-12-02 10:10:51","2019-12-03 10:00:00","2019-12-03 10:30:00",4268,1231,5499
"2019-12-02 10:10:51","2019-12-03 11:00:00","2019-12-03 11:30:00",4273,1226,5499
"2019-12-02 10:10:51","2019-12-03 12:00:00","2019-12-03 12:30:00",4278,1234,5512
"2019-12-02 10:10:51","2019-12-03 13:00:00","2019-12-03 13:30:00",4315,1218,5533
"2019-12-02 10:10:51","2019-12-03 14:00:00","2019-12-03 14:30:00",4254,1174,5428
"2019-12-02 10:10:51","2019-12-03 15:00:00","2019-12-03 15:30:00",4324,1169,5493
"2019-12-02 10:10:51","2019-12-03 16:00:00","2019-12-03 16:30:00",4542,1231,5773
"2019-12-02 10:10:51","2019-12-03 17:00:00","2019-12-03 17:30:00",4917,1438,6355
"2019-12-02 10:10:51","2019-12-03 18:00:00","2019-12-03 18:30:00",4972,1397,6369
"2019-12-02 10:10:51","2019-12-03 19:00:00","2019-12-03 19:30:00",4769,1295,6064
"2019-12-02 10:10:51","2019-12-03 20:00:00","2019-12-03 20:30:00",4551,1219,5770
"2019-12-02 10:10:51","2019-12-03 21:00:00","2019-12-03 21:30:00",4323,1146,5469
"2019-12-02 10:10:51","2019-12-03 22:00:00","2019-12-03 22:30:00",3916,1014,4930
"2019-12-03 10:10:46","2019-12-03 23:00:00","2019-12-03 23:30:00",3556,871,4427
"2019-12-03 10:10:46","2019-12-04 00:00:00","2019-12-04 00:30:00",3267,737,4004
"2019-12-03 10:10:46","2019-12-04 01:00:00","2019-12-04 01:30:00",3043,682,3725
"2019-12-03 10:10:46","2019-12-04 02:00:00","2019-12-04 02:30:00",2890,670,3560
"2019-12-03 10:10:46","2019-12-04 03:00:00","2019-12-04 03:30:00",2811,649,3460
"2019-12-03 10:10:46","2019-12-04 04:00:00","2019-12-04 04:30:00",2806,643,3449
"2019-12-03 10:10:46","2019-12-04 05:00:00","2019-12-04 05:30:00",2813,647,3460
"2019-12-03 10:10:46","2019-12-04 06:00:00","2019-12-04 06:30:00",2993,727,3720
"2019-12-03 10:10:46","2019-12-04 07:00:00","2019-12-04 07:30:00",3531,946,4477
"2019-12-03 10:10:46","2019-12-04 08:00:00","2019-12-04 08:30:00",4135,1155,5290
"2019-12-03 10:10:46","2019-12-04 09:00:00","2019-12-04 09:30:00",4131,1183,5314
"2019-12-03 10:10:46","2019-12-04 10:00:00","2019-12-04 10:30:00",4242,1217,5459
"2019-12-03 10:10:46","2019-12-04 11:00:00","2019-12-04 11:30:00",4246,1219,5465
"2019-12-03 10:10:46","2019-12-04 12:00:00","2019-12-04 12:30:00",4251,1221,5472
"2019-12-03 10:10:46","2019-12-04 13:00:00","2019-12-04 13:30:00",4287,1212,5499
"2019-12-03 10:10:46","2019-12-04 14:00:00","2019-12-04 14:30:00",4228,1158,5386
"2019-12-03 10:10:46","2019-12-04 15:00:00","2019-12-04 15:30:00",4297,1147,5444
"2019-12-03 10:10:46","2019-12-04 16:00:00","2019-12-04 16:30:00",4510,1214,5724
"2019-12-03 10:10:46","2019-12-04 17:00:00","2019-12-04 17:30:00",4879,1433,6312
"2019-12-03 10:10:46","2019-12-04 18:00:00","2019-12-04 18:30:00",4932,1399,6331
"2019-12-03 10:10:46","2019-12-04 19:00:00","2019-12-04 19:30:00",4733,1317,6050
"2019-12-03 10:10:46","2019-12-04 20:00:00","2019-12-04 20:30:00",4519,1225,5744
"2019-12-03 10:10:46","2019-12-04 21:00:00","2019-12-04 21:30:00",4296,1151,5447
"2019-12-03 10:10:46","2019-12-04 22:00:00","2019-12-04 22:30:00",3896,1021,4917
"2019-12-04 10:10:40","2019-12-04 23:00:00","2019-12-04 23:30:00",3543,813,4356
"2019-12-04 10:10:40","2019-12-05 00:00:00","2019-12-05 00:30:00",3214,751,3965
"2019-12-04 10:10:40","2019-12-05 01:00:00","2019-12-05 01:30:00",3007,686,3693
"2019-12-04 10:10:40","2019-12-05 02:00:00","2019-12-05 02:30:00",2886,685,3571
"2019-12-04 10:10:40","2019-12-05 03:00:00","2019-12-05 03:30:00",2797,655,3452
"2019-12-04 10:10:40","2019-12-05 04:00:00","2019-12-05 04:30:00",2780,649,3429
"2019-12-04 10:10:40","2019-12-05 05:00:00","2019-12-05 05:30:00",2807,666,3473
"2019-12-04 10:10:40","2019-12-05 06:00:00","2019-12-05 06:30:00",3038,744,3782
"2019-12-04 10:10:40","2019-12-05 07:00:00","2019-12-05 07:30:00",3587,948,4535
"2019-12-04 10:10:40","2019-12-05 08:00:00","2019-12-05 08:30:00",4151,1152,5303
"2019-12-04 10:10:40","2019-12-05 09:00:00","2019-12-05 09:30:00",4177,1156,5333
"2019-12-04 10:10:40","2019-12-05 10:00:00","2019-12-05 10:30:00",4251,1179,5430
"2019-12-04 10:10:40","2019-12-05 11:00:00","2019-12-05 11:30:00",4250,1163,5413
"2019-12-04 10:10:40","2019-12-05 12:00:00","2019-12-05 12:30:00",4248,1151,5399
"2019-12-04 10:10:40","2019-12-05 13:00:00","2019-12-05 13:30:00",4295,1143,5438
"2019-12-04 10:10:40","2019-12-05 14:00:00","2019-12-05 14:30:00",4298,1104,5402
"2019-12-04 10:10:40","2019-12-05 15:00:00","2019-12-05 15:30:00",4346,1096,5442
"2019-12-04 10:10:40","2019-12-05 16:00:00","2019-12-05 16:30:00",4456,1162,5618
"2019-12-04 10:10:40","2019-12-05 17:00:00","2019-12-05 17:30:00",4902,1356,6258
"2019-12-04 10:10:40","2019-12-05 18:00:00","2019-12-05 18:30:00",4955,1320,6275
"2019-12-04 10:10:40","2019-12-05 19:00:00","2019-12-05 19:30:00",4750,1221,5971
"2019-12-04 10:10:40","2019-12-05 20:00:00","2019-12-05 20:30:00",4483,1164,5647
"2019-12-04 10:10:40","2019-12-05 21:00:00","2019-12-05 21:30:00",4239,1101,5340
"2019-12-04 10:10:40","2019-12-05 22:00:00","2019-12-05 22:30:00",3832,965,4797
"2019-12-04 10:10:40","2019-12-05 23:00:00","2019-12-05 23:30:00",3507,817,4324
"2019-12-04 10:10:40","2019-12-06 00:00:00","2019-12-06 00:30:00",3216,708,3924
"2019-12-04 10:10:40","2019-12-06 01:00:00","2019-12-06 01:30:00",3026,658,3684
"2019-12-04 10:10:40","2019-12-06 02:00:00","2019-12-06 02:30:00",2812,649,3461
"2019-12-04 10:10:40","2019-12-06 03:00:00","2019-12-06 03:30:00",2727,624,3351
"2019-12-04 10:10:40","2019-12-06 04:00:00","2019-12-06 04:30:00",2706,622,3328
"2019-12-04 10:10:40","2019-12-06 05:00:00","2019-12-06 05:30:00",2704,639,3343
"2019-12-04 10:10:40","2019-12-06 06:00:00","2019-12-06 06:30:00",2889,700,3589
"2019-12-04 10:10:40","2019-12-06 07:00:00","2019-12-06 07:30:00",3407,900,4307
"2019-12-04 10:10:40","2019-12-06 08:00:00","2019-12-06 08:30:00",3999,1108,5107
"2019-12-04 10:10:40","2019-12-06 09:00:00","2019-12-06 09:30:00",3984,1145,5129
"2019-12-04 10:10:40","2019-12-06 10:00:00","2019-12-06 10:30:00",4036,1162,5198
"2019-12-04 10:10:40","2019-12-06 11:00:00","2019-12-06 11:30:00",4056,1141,5197
"2019-12-04 10:10:40","2019-12-06 12:00:00","2019-12-06 12:30:00",4078,1156,5234
"2019-12-04 10:10:40","2019-12-06 13:00:00","2019-12-06 13:30:00",4075,1152,5227
"2019-12-04 10:10:40","2019-12-06 14:00:00","2019-12-06 14:30:00",4021,1076,5097
"2019-12-04 10:10:40","2019-12-06 15:00:00","2019-12-06 15:30:00",4047,1107,5154
"2019-12-04 10:10:40","2019-12-06 16:00:00","2019-12-06 16:30:00",4165,1148,5313
"2019-12-04 10:10:40","2019-12-06 17:00:00","2019-12-06 17:30:00",4562,1320,5882
"2019-12-04 10:10:40","2019-12-06 18:00:00","2019-12-06 18:30:00",4604,1308,5912
"2019-12-04 10:10:40","2019-12-06 19:00:00","2019-12-06 19:30:00",4402,1221,5623
"2019-12-04 10:10:40","2019-12-06 20:00:00","2019-12-06 20:30:00",4196,1154,5350
"2019-12-04 10:10:40","2019-12-06 21:00:00","2019-12-06 21:30:00",3994,1084,5078
"2019-12-04 10:10:40","2019-12-06 22:00:00","2019-12-06 22:30:00",3705,972,4677
"2019-12-06 10:10:50","2019-12-06 23:00:00","2019-12-06 23:30:00",3543,897,4440
"2019-12-06 10:10:50","2019-12-07 00:00:00","2019-12-07 00:30:00",3406,723,4129
"2019-12-06 10:10:50","2019-12-07 01:00:00","2019-12-07 01:30:00",3093,659,3752
"2019-12-06 10:10:50","2019-12-07 02:00:00","2019-12-07 02:30:00",2915,635,3550
"2019-12-06 10:10:50","2019-12-07 03:00:00","2019-12-07 03:30:00",2783,601,3384
"2019-12-06 10:10:50","2019-12-07 04:00:00","2019-12-07 04:30:00",2718,592,3310
"2019-12-06 10:10:50","2019-12-07 05:00:00","2019-12-07 05:30:00",2658,594,3252
"2019-12-06 10:10:50","2019-12-07 06:00:00","2019-12-07 06:30:00",2727,635,3362
"2019-12-06 10:10:50","2019-12-07 07:00:00","2019-12-07 07:30:00",2951,720,3671
"2019-12-06 10:10:50","2019-12-07 08:00:00","2019-12-07 08:30:00",3249,845,4094
"2019-12-06 10:10:50","2019-12-07 09:00:00","2019-12-07 09:30:00",3498,946,4444
"2019-12-06 10:10:50","2019-12-07 10:00:00","2019-12-07 10:30:00",3685,999,4684
"2019-12-06 10:10:50","2019-12-07 11:00:00","2019-12-07 11:30:00",3767,1026,4793
"2019-12-06 10:10:50","2019-12-07 12:00:00","2019-12-07 12:30:00",3838,1023,4861
"2019-12-06 10:10:50","2019-12-07 13:00:00","2019-12-07 13:30:00",3885,1018,4903
"2019-12-06 10:10:50","2019-12-07 14:00:00","2019-12-07 14:30:00",3782,979,4761
"2019-12-06 10:10:50","2019-12-07 15:00:00","2019-12-07 15:30:00",3786,977,4763
"2019-12-06 10:10:50","2019-12-07 16:00:00","2019-12-07 16:30:00",3866,1025,4891
"2019-12-06 10:10:50","2019-12-07 17:00:00","2019-12-07 17:30:00",4281,1198,5479
"2019-12-06 10:10:50","2019-12-07 18:00:00","2019-12-07 18:30:00",4348,1196,5544
"2019-12-06 10:10:50","2019-12-07 19:00:00","2019-12-07 19:30:00",4136,1083,5219
"2019-12-06 10:10:50","2019-12-07 20:00:00","2019-12-07 20:30:00",3954,979,4933
"2019-12-06 10:10:50","2019-12-07 21:00:00","2019-12-07 21:30:00",3735,939,4674
"2019-12-06 10:10:50","2019-12-07 22:00:00","2019-12-07 22:30:00",3529,855,4384
"2019-12-07 10:10:35","2019-12-07 23:00:00","2019-12-07 23:30:00",3265,842,4107
"2019-12-07 10:10:35","2019-12-08 00:00:00","2019-12-08 00:30:00",3235,686,3921
"2019-12-07 10:10:35","2019-12-08 01:00:00","2019-12-08 01:30:00",3028,625,3653
"2019-12-07 10:10:35","2019-12-08 02:00:00","2019-12-08 02:30:00",2849,612,3461
"2019-12-07 10:10:35","2019-12-08 03:00:00","2019-12-08 03:30:00",2714,593,3307
"2019-12-07 10:10:35","2019-12-08 04:00:00","2019-12-08 04:30:00",2673,593,3266
"2019-12-07 10:10:35","2019-12-08 05:00:00","2019-12-08 05:30:00",2641,589,3230
"2019-12-07 10:10:35","2019-12-08 06:00:00","2019-12-08 06:30:00",2666,621,3287
"2019-12-07 10:10:35","2019-12-08 07:00:00","2019-12-08 07:30:00",2774,681,3455
"2019-12-07 10:10:35","2019-12-08 08:00:00","2019-12-08 08:30:00",2918,769,3687
"2019-12-07 10:10:35","2019-12-08 09:00:00","2019-12-08 09:30:00",3106,861,3967
"2019-12-07 10:10:35","2019-12-08 10:00:00","2019-12-08 10:30:00",3463,968,4431
"2019-12-07 10:10:35","2019-12-08 11:00:00","2019-12-08 11:30:00",3671,1032,4703
"2019-12-07 10:10:35","2019-12-08 12:00:00","2019-12-08 12:30:00",3762,1070,4832
"2019-12-07 10:10:35","2019-12-08 13:00:00","2019-12-08 13:30:00",3796,1067,4863
"2019-12-07 10:10:35","2019-12-08 14:00:00","2019-12-08 14:30:00",3721,1028,4749
"2019-12-07 10:10:35","2019-12-08 15:00:00","2019-12-08 15:30:00",3669,1022,4691
"2019-12-07 10:10:35","2019-12-08 16:00:00","2019-12-08 16:30:00",3721,1065,4786
"2019-12-07 10:10:35","2019-12-08 17:00:00","2019-12-08 17:30:00",4192,1259,5451
"2019-12-07 10:10:35","2019-12-08 18:00:00","2019-12-08 18:30:00",4330,1279,5609
"2019-12-07 10:10:35","2019-12-08 19:00:00","2019-12-08 19:30:00",4229,1188,5417
"2019-12-07 10:10:35","2019-12-08 20:00:00","2019-12-08 20:30:00",4095,1096,5191
"2019-12-07 10:10:35","2019-12-08 21:00:00","2019-12-08 21:30:00",3946,1024,4970
"2019-12-07 10:10:35","2019-12-08 22:00:00","2019-12-08 22:30:00",3632,920,4552
"2019-12-07 10:10:35","2019-12-08 23:00:00","2019-12-08 23:30:00",3364,796,4160
"2019-12-07 10:10:35","2019-12-09 00:00:00","2019-12-09 00:30:00",3171,686,3857
"2019-12-07 10:10:35","2019-12-09 01:00:00","2019-12-09 01:30:00",2953,628,3581
"2019-12-07 10:10:35","2019-12-09 02:00:00","2019-12-09 02:30:00",2821,617,3438
"2019-12-07 10:10:35","2019-12-09 03:00:00","2019-12-09 03:30:00",2740,596,3336
"2019-12-07 10:10:35","2019-12-09 04:00:00","2019-12-09 04:30:00",2704,586,3290
"2019-12-07 10:10:35","2019-12-09 05:00:00","2019-12-09 05:30:00",2722,602,3324
"2019-12-07 10:10:35","2019-12-09 06:00:00","2019-12-09 06:30:00",2914,695,3609
"2019-12-07 10:10:35","2019-12-09 07:00:00","2019-12-09 07:30:00",3475,905,4380
"2019-12-07 10:10:35","2019-12-09 08:00:00","2019-12-09 08:30:00",4051,1130,5181
"2019-12-07 10:10:35","2019-12-09 09:00:00","2019-12-09 09:30:00",4127,1169,5296
"2019-12-07 10:10:35","2019-12-09 10:00:00","2019-12-09 10:30:00",4279,1189,5468
"2019-12-07 10:10:35","2019-12-09 11:00:00","2019-12-09 11:30:00",4284,1196,5480
"2019-12-07 10:10:35","2019-12-09 12:00:00","2019-12-09 12:30:00",4280,1198,5478
"2019-12-07 10:10:35","2019-12-09 13:00:00","2019-12-09 13:30:00",4312,1195,5507
"2019-12-07 10:10:35","2019-12-09 14:00:00","2019-12-09 14:30:00",4203,1165,5368
"2019-12-07 10:10:35","2019-12-09 15:00:00","2019-12-09 15:30:00",4259,1186,5445
"2019-12-07 10:10:35","2019-12-09 16:00:00","2019-12-09 16:30:00",4359,1261,5620
"2019-12-07 10:10:35","2019-12-09 17:00:00","2019-12-09 17:30:00",4863,1481,6344
"2019-12-07 10:10:35","2019-12-09 18:00:00","2019-12-09 18:30:00",4910,1451,6361
"2019-12-07 10:10:35","2019-12-09 19:00:00","2019-12-09 19:30:00",4697,1319,6016
"2019-12-07 10:10:35","2019-12-09 20:00:00","2019-12-09 20:30:00",4470,1239,5709
"2019-12-07 10:10:35","2019-12-09 21:00:00","2019-12-09 21:30:00",4244,1164,5408
"2019-12-07 10:10:35","2019-12-09 22:00:00","2019-12-09 22:30:00",3832,1017,4849
"2019-12-09 10:10:56","2019-12-09 23:00:00","2019-12-09 23:30:00",3527,871,4398
"2019-12-09 10:10:56","2019-12-10 00:00:00","2019-12-10 00:30:00",3347,674,4021
"2019-12-09 10:10:56","2019-12-10 01:00:00","2019-12-10 01:30:00",3117,615,3732
"2019-12-09 10:10:56","2019-12-10 02:00:00","2019-12-10 02:30:00",2933,615,3548
"2019-12-09 10:10:56","2019-12-10 03:00:00","2019-12-10 03:30:00",2836,567,3403
"2019-12-09 10:10:56","2019-12-10 04:00:00","2019-12-10 04:30:00",2801,568,3369
"2019-12-09 10:10:56","2019-12-10 05:00:00","2019-12-10 05:30:00",2820,565,3385
"2019-12-09 10:10:56","2019-12-10 06:00:00","2019-12-10 06:30:00",3020,634,3654
"2019-12-09 10:10:56","2019-12-10 07:00:00","2019-12-10 07:30:00",3553,782,4335
"2019-12-09 10:10:56","2019-12-10 08:00:00","2019-12-10 08:30:00",4120,995,5115
"2019-12-09 10:10:56","2019-12-10 09:00:00","2019-12-10 09:30:00",4148,1010,5158
"2019-12-09 10:10:56","2019-12-10 10:00:00","2019-12-10 10:30:00",4204,1031,5235
"2019-12-09 10:10:56","2019-12-10 11:00:00","2019-12-10 11:30:00",4211,1038,5249
"2019-12-09 10:10:56","2019-12-10 12:00:00","2019-12-10 12:30:00",4198,1066,5264
"2019-12-09 10:10:56","2019-12-10 13:00:00","2019-12-10 13:30:00",4194,1069,5263
"2019-12-09 10:10:56","2019-12-10 14:00:00","2019-12-10 14:30:00",4017,1081,5098
"2019-12-09 10:10:56","2019-12-10 15:00:00","2019-12-10 15:30:00",4111,1126,5237
"2019-12-09 10:10:56","2019-12-10 16:00:00","2019-12-10 16:30:00",4269,1177,5446
"2019-12-09 10:10:56","2019-12-10 17:00:00","2019-12-10 17:30:00",4852,1378,6230
"2019-12-09 10:10:56","2019-12-10 18:00:00","2019-12-10 18:30:00",4850,1337,6187
"2019-12-09 10:10:56","2019-12-10 19:00:00","2019-12-10 19:30:00",4671,1225,5896
"2019-12-09 10:10:56","2019-12-10 20:00:00","2019-12-10 20:30:00",4463,1145,5608
"2019-12-09 10:10:56","2019-12-10 21:00:00","2019-12-10 21:30:00",4251,1075,5326
"2019-12-09 10:10:56","2019-12-10 22:00:00","2019-12-10 22:30:00",3830,957,4787
"2019-12-10 10:11:16","2019-12-10 23:00:00","2019-12-10 23:30:00",3358,846,4204
"2019-12-10 10:11:16","2019-12-11 00:00:00","2019-12-11 00:30:00",3197,685,3882
"2019-12-10 10:11:16","2019-12-11 01:00:00","2019-12-11 01:30:00",2962,638,3600
"2019-12-10 10:11:16","2019-12-11 02:00:00","2019-12-11 02:30:00",2852,635,3487
"2019-12-10 10:11:16","2019-12-11 03:00:00","2019-12-11 03:30:00",2757,606,3363
"2019-12-10 10:11:16","2019-12-11 04:00:00","2019-12-11 04:30:00",2752,596,3348
"2019-12-10 10:11:16","2019-12-11 05:00:00","2019-12-11 05:30:00",2795,599,3394
"2019-12-10 10:11:16","2019-12-11 06:00:00","2019-12-11 06:30:00",2994,686,3680
"2019-12-10 10:11:16","2019-12-11 07:00:00","2019-12-11 07:30:00",3496,861,4357
"2019-12-10 10:11:16","2019-12-11 08:00:00","2019-12-11 08:30:00",4076,1160,5236
"2019-12-10 10:11:16","2019-12-11 09:00:00","2019-12-11 09:30:00",4182,1207,5389
"2019-12-10 10:11:16","2019-12-11 10:00:00","2019-12-11 10:30:00",4230,1218,5448
"2019-12-10 10:11:16","2019-12-11 11:00:00","2019-12-11 11:30:00",4247,1214,5461
"2019-12-10 10:11:16","2019-12-11 12:00:00","2019-12-11 12:30:00",4242,1237,5479
"2019-12-10 10:11:16","2019-12-11 13:00:00","2019-12-11 13:30:00",4271,1228,5499
"2019-12-10 10:11:16","2019-12-11 14:00:00","2019-12-11 14:30:00",4208,1184,5392
"2019-12-10 10:11:16","2019-12-11 15:00:00","2019-12-11 15:30:00",4259,1174,5433
"2019-12-10 10:11:16","2019-12-11 16:00:00","2019-12-11 16:30:00",4511,1265,5776
"2019-12-10 10:11:16","2019-12-11 17:00:00","2019-12-11 17:30:00",4893,1436,6329
"2019-12-10 10:11:16","2019-12-11 18:00:00","2019-12-11 18:30:00",4898,1407,6305
"2019-12-10 10:11:16","2019-12-11 19:00:00","2019-12-11 19:30:00",4708,1278,5986
"2019-12-10 10:11:16","2019-12-11 20:00:00","2019-12-11 20:30:00",4533,1195,5728
"2019-12-10 10:11:16","2019-12-11 21:00:00","2019-12-11 21:30:00",4288,1133,5421
"2019-12-10 10:11:16","2019-12-11 22:00:00","2019-12-11 22:30:00",3887,997,4884
"2019-12-11 10:11:05","2019-12-11 23:00:00","2019-12-11 23:30:00",3451,795,4246
"2019-12-11 10:11:05","2019-12-12 00:00:00","2019-12-12 00:30:00",3317,713,4030
"2019-12-11 10:11:05","2019-12-12 01:00:00","2019-12-12 01:30:00",3092,634,3726
"2019-12-11 10:11:05","2019-12-12 02:00:00","2019-12-12 02:30:00",2913,620,3533
"2019-12-11 10:11:05","2019-12-12 03:00:00","2019-12-12 03:30:00",2818,598,3416
"2019-12-11 10:11:05","2019-12-12 04:00:00","2019-12-12 04:30:00",2784,592,3376
"2019-12-11 10:11:05","2019-12-12 05:00:00","2019-12-12 05:30:00",2802,601,3403
"2019-12-11 10:11:05","2019-12-12 06:00:00","2019-12-12 06:30:00",2997,684,3681
"2019-12-11 10:11:05","2019-12-12 07:00:00","2019-12-12 07:30:00",3519,911,4430
"2019-12-11 10:11:05","2019-12-12 08:00:00","2019-12-12 08:30:00",4073,1170,5243
"2019-12-11 10:11:05","2019-12-12 09:00:00","2019-12-12 09:30:00",4101,1236,5337
"2019-12-11 10:11:05","2019-12-12 10:00:00","2019-12-12 10:30:00",4155,1247,5402
"2019-12-11 10:11:05","2019-12-12 11:00:00","2019-12-12 11:30:00",4162,1234,5396
"2019-12-11 10:11:05","2019-12-12 12:00:00","2019-12-12 12:30:00",4149,1242,5391
"2019-12-11 10:11:05","2019-12-12 13:00:00","2019-12-12 13:30:00",4146,1248,5394
"2019-12-11 10:11:05","2019-12-12 14:00:00","2019-12-12 14:30:00",3973,1214,5187
"2019-12-11 10:11:05","2019-12-12 15:00:00","2019-12-12 15:30:00",4064,1244,5308
"2019-12-11 10:11:05","2019-12-12 16:00:00","2019-12-12 16:30:00",4219,1323,5542
"2019-12-11 10:11:05","2019-12-12 17:00:00","2019-12-12 17:30:00",4788,1482,6270
"2019-12-11 10:11:05","2019-12-12 18:00:00","2019-12-12 18:30:00",4786,1429,6215
"2019-12-11 10:11:05","2019-12-12 19:00:00","2019-12-12 19:30:00",4612,1348,5960
"2019-12-11 10:11:05","2019-12-12 20:00:00","2019-12-12 20:30:00",4408,1286,5694
"2019-12-11 10:11:05","2019-12-12 21:00:00","2019-12-12 21:30:00",4201,1203,5404
"2019-12-11 10:11:05","2019-12-12 22:00:00","2019-12-12 22:30:00",3790,1086,4876
"2019-12-12 10:11:06","2019-12-12 23:00:00","2019-12-12 23:30:00",3451,902,4353
"2019-12-12 10:11:06","2019-12-13 00:00:00","2019-12-13 00:30:00",3293,728,4021
"2019-12-12 10:11:06","2019-12-13 01:00:00","2019-12-13 01:30:00",3038,658,3696
"2019-12-12 10:11:06","2019-12-13 02:00:00","2019-12-13 02:30:00",2834,650,3484
"2019-12-12 10:11:06","2019-12-13 03:00:00","2019-12-13 03:30:00",2748,623,3371
"2019-12-12 10:11:06","2019-12-13 04:00:00","2019-12-13 04:30:00",2691,612,3303
"2019-12-12 10:11:06","2019-12-13 05:00:00","2019-12-13 05:30:00",2719,598,3317
"2019-12-12 10:11:06","2019-12-13 06:00:00","2019-12-13 06:30:00",2958,675,3633
"2019-12-12 10:11:06","2019-12-13 07:00:00","2019-12-13 07:30:00",3421,884,4305
"2019-12-12 10:11:06","2019-12-13 08:00:00","2019-12-13 08:30:00",4016,1111,5127
"2019-12-12 10:11:06","2019-12-13 09:00:00","2019-12-13 09:30:00",4070,1136,5206
"2019-12-12 10:11:06","2019-12-13 10:00:00","2019-12-13 10:30:00",4149,1159,5308
"2019-12-12 10:11:06","2019-12-13 11:00:00","2019-12-13 11:30:00",4154,1157,5311
"2019-12-12 10:11:06","2019-12-13 12:00:00","2019-12-13 12:30:00",4173,1138,5311
"2019-12-12 10:11:06","2019-12-13 13:00:00","2019-12-13 13:30:00",4202,1100,5302
"2019-12-12 10:11:06","2019-12-13 14:00:00","2019-12-13 14:30:00",4172,1049,5221
"2019-12-12 10:11:06","2019-12-13 15:00:00","2019-12-13 15:30:00",4186,1052,5238
"2019-12-12 10:11:06","2019-12-13 16:00:00","2019-12-13 16:30:00",4346,1114,5460
"2019-12-12 10:11:06","2019-12-13 17:00:00","2019-12-13 17:30:00",4621,1292,5913
"2019-12-12 10:11:06","2019-12-13 18:00:00","2019-12-13 18:30:00",4648,1283,5931
"2019-12-12 10:11:06","2019-12-13 19:00:00","2019-12-13 19:30:00",4441,1203,5644
"2019-12-12 10:11:06","2019-12-13 20:00:00","2019-12-13 20:30:00",4249,1089,5338
"2019-12-12 10:11:06","2019-12-13 21:00:00","2019-12-13 21:30:00",4035,1061,5096
"2019-12-12 10:11:06","2019-12-13 22:00:00","2019-12-13 22:30:00",3739,928,4667
"2019-12-13 10:11:26","2019-12-13 23:00:00","2019-12-13 23:30:00",3554,849,4403
"2019-12-13 10:11:26","2019-12-14 00:00:00","2019-12-14 00:30:00",3226,716,3942
"2019-12-13 10:11:26","2019-12-14 01:00:00","2019-12-14 01:30:00",2962,644,3606
"2019-12-13 10:11:26","2019-12-14 02:00:00","2019-12-14 02:30:00",2773,618,3391
"2019-12-13 10:11:26","2019-12-14 03:00:00","2019-12-14 03:30:00",2630,595,3225
"2019-12-13 10:11:26","2019-12-14 04:00:00","2019-12-14 04:30:00",2552,590,3142
"2019-12-13 10:11:26","2019-12-14 05:00:00","2019-12-14 05:30:00",2542,581,3123
"2019-12-13 10:11:26","2019-12-14 06:00:00","2019-12-14 06:30:00",2641,616,3257
"2019-12-13 10:11:26","2019-12-14 07:00:00","2019-12-14 07:30:00",2791,705,3496
"2019-12-13 10:11:26","2019-12-14 08:00:00","2019-12-14 08:30:00",3076,848,3924
"2019-12-13 10:11:26","2019-12-14 09:00:00","2019-12-14 09:30:00",3311,931,4242
"2019-12-13 10:11:26","2019-12-14 10:00:00","2019-12-14 10:30:00",3568,998,4566
"2019-12-13 10:11:26","2019-12-14 11:00:00","2019-12-14 11:30:00",3649,1022,4671
"2019-12-13 10:11:26","2019-12-14 12:00:00","2019-12-14 12:30:00",3777,1020,4797
"2019-12-13 10:11:26","2019-12-14 13:00:00","2019-12-14 13:30:00",3819,1025,4844
"2019-12-13 10:11:26","2019-12-14 14:00:00","2019-12-14 14:30:00",3790,972,4762
"2019-12-13 10:11:26","2019-12-14 15:00:00","2019-12-14 15:30:00",3774,973,4747
"2019-12-13 10:11:26","2019-12-14 16:00:00","2019-12-14 16:30:00",3847,1036,4883
"2019-12-13 10:11:26","2019-12-14 17:00:00","2019-12-14 17:30:00",4248,1185,5433
"2019-12-13 10:11:26","2019-12-14 18:00:00","2019-12-14 18:30:00",4351,1205,5556
"2019-12-13 10:11:26","2019-12-14 19:00:00","2019-12-14 19:30:00",4180,1116,5296
"2019-12-13 10:11:26","2019-12-14 20:00:00","2019-12-14 20:30:00",3953,1042,4995
"2019-12-13 10:11:26","2019-12-14 21:00:00","2019-12-14 21:30:00",3772,978,4750
"2019-12-13 10:11:26","2019-12-14 22:00:00","2019-12-14 22:30:00",3473,897,4370
"2019-12-14 10:11:16","2019-12-14 23:00:00","2019-12-14 23:30:00",3338,828,4166
"2019-12-14 10:11:16","2019-12-15 00:00:00","2019-12-15 00:30:00",3295,680,3975
"2019-12-14 10:11:16","2019-12-15 01:00:00","2019-12-15 01:30:00",3069,604,3673
"2019-12-14 10:11:16","2019-12-15 02:00:00","2019-12-15 02:30:00",2860,583,3443
"2019-12-14 10:11:16","2019-12-15 03:00:00","2019-12-15 03:30:00",2698,565,3263
"2019-12-14 10:11:16","2019-12-15 04:00:00","2019-12-15 04:30:00",2652,533,3185
"2019-12-14 10:11:16","2019-12-15 05:00:00","2019-12-15 05:30:00",2622,536,3158
"2019-12-14 10:11:16","2019-12-15 06:00:00","2019-12-15 06:30:00",2612,565,3177
"2019-12-14 10:11:16","2019-12-15 07:00:00","2019-12-15 07:30:00",2756,639,3395
"2019-12-14 10:11:16","2019-12-15 08:00:00","2019-12-15 08:30:00",2928,733,3661
"2019-12-14 10:11:16","2019-12-15 09:00:00","2019-12-15 09:30:00",3168,826,3994
"2019-12-14 10:11:16","2019-12-15 10:00:00","2019-12-15 10:30:00",3494,919,4413
"2019-12-14 10:11:16","2019-12-15 11:00:00","2019-12-15 11:30:00",3683,1029,4712
"2019-12-14 10:11:16","2019-12-15 12:00:00","2019-12-15 12:30:00",3773,1065,4838
"2019-12-14 10:11:16","2019-12-15 13:00:00","2019-12-15 13:30:00",3848,1098,4946
"2019-12-14 10:11:16","2019-12-15 14:00:00","2019-12-15 14:30:00",3753,1046,4799
"2019-12-14 10:11:16","2019-12-15 15:00:00","2019-12-15 15:30:00",3694,1049,4743
"2019-12-14 10:11:16","2019-12-15 16:00:00","2019-12-15 16:30:00",3725,1141,4866
"2019-12-14 10:11:16","2019-12-15 17:00:00","2019-12-15 17:30:00",4157,1279,5436
"2019-12-14 10:11:16","2019-12-15 18:00:00","2019-12-15 18:30:00",4300,1307,5607
"2019-12-14 10:11:16","2019-12-15 19:00:00","2019-12-15 19:30:00",4194,1208,5402
"2019-12-14 10:11:16","2019-12-15 20:00:00","2019-12-15 20:30:00",4082,1122,5204
"2019-12-14 10:11:16","2019-12-15 21:00:00","2019-12-15 21:30:00",3903,1030,4933
"2019-12-14 10:11:16","2019-12-15 22:00:00","2019-12-15 22:30:00",3647,927,4574
"2019-12-15 10:11:35","2019-12-15 23:00:00","2019-12-15 23:30:00",3447,895,4342
"2019-12-15 10:11:35","2019-12-16 00:00:00","2019-12-16 00:30:00",3240,679,3919
"2019-12-15 10:11:35","2019-12-16 01:00:00","2019-12-16 01:30:00",3034,599,3633
"2019-12-15 10:11:35","2019-12-16 02:00:00","2019-12-16 02:30:00",2865,595,3460
"2019-12-15 10:11:35","2019-12-16 03:00:00","2019-12-16 03:30:00",2783,572,3355
"2019-12-15 10:11:35","2019-12-16 04:00:00","2019-12-16 04:30:00",2730,571,3301
"2019-12-15 10:11:35","2019-12-16 05:00:00","2019-12-16 05:30:00",2739,596,3335
"2019-12-15 10:11:35","2019-12-16 06:00:00","2019-12-16 06:30:00",2950,675,3625
"2019-12-15 10:11:35","2019-12-16 07:00:00","2019-12-16 07:30:00",3457,886,4343
"2019-12-15 10:11:35","2019-12-16 08:00:00","2019-12-16 08:30:00",4003,1131,5134
"2019-12-15 10:11:35","2019-12-16 09:00:00","2019-12-16 09:30:00",4103,1168,5271
"2019-12-15 10:11:35","2019-12-16 10:00:00","2019-12-16 10:30:00",4252,1207,5459
"2019-12-15 10:11:35","2019-12-16 11:00:00","2019-12-16 11:30:00",4262,1236,5498
"2019-12-15 10:11:35","2019-12-16 12:00:00","2019-12-16 12:30:00",4316,1203,5519
"2019-12-15 10:11:35","2019-12-16 13:00:00","2019-12-16 13:30:00",4342,1216,5558
"2019-12-15 10:11:35","2019-12-16 14:00:00","2019-12-16 14:30:00",4289,1174,5463
"2019-12-15 10:11:35","2019-12-16 15:00:00","2019-12-16 15:30:00",4305,1186,5491
"2019-12-15 10:11:35","2019-12-16 16:00:00","2019-12-16 16:30:00",4484,1246,5730
"2019-12-15 10:11:35","2019-12-16 17:00:00","2019-12-16 17:30:00",4894,1481,6375
"2019-12-15 10:11:35","2019-12-16 18:00:00","2019-12-16 18:30:00",4925,1443,6368
"2019-12-15 10:11:35","2019-12-16 19:00:00","2019-12-16 19:30:00",4752,1315,6067
"2019-12-15 10:11:35","2019-12-16 20:00:00","2019-12-16 20:30:00",4574,1236,5810
"2019-12-15 10:11:35","2019-12-16 21:00:00","2019-12-16 21:30:00",4367,1164,5531
"2019-12-15 10:11:35","2019-12-16 22:00:00","2019-12-16 22:30:00",3981,1028,5009
"2019-12-16 10:11:26","2019-12-16 23:00:00","2019-12-16 23:30:00",3649,867,4516
"2019-12-16 10:11:26","2019-12-17 00:00:00","2019-12-17 00:30:00",3432,702,4134
"2019-12-16 10:11:26","2019-12-17 01:00:00","2019-12-17 01:30:00",3113,656,3769
"2019-12-16 10:11:26","2019-12-17 02:00:00","2019-12-17 02:30:00",2940,651,3591
"2019-12-16 10:11:26","2019-12-17 03:00:00","2019-12-17 03:30:00",2844,637,3481
"2019-12-16 10:11:26","2019-12-17 04:00:00","2019-12-17 04:30:00",2800,632,3432
"2019-12-16 10:11:26","2019-12-17 05:00:00","2019-12-17 05:30:00",2861,647,3508
"2019-12-16 10:11:26","2019-12-17 06:00:00","2019-12-17 06:30:00",3054,746,3800
"2019-12-16 10:11:26","2019-12-17 07:00:00","2019-12-17 07:30:00",3588,985,4573
"2019-12-16 10:11:26","2019-12-17 08:00:00","2019-12-17 08:30:00",4218,1241,5459
"2019-12-16 10:11:26","2019-12-17 09:00:00","2019-12-17 09:30:00",4254,1312,5566
"2019-12-16 10:11:26","2019-12-17 10:00:00","2019-12-17 10:30:00",4325,1324,5649
"2019-12-16 10:11:26","2019-12-17 11:00:00","2019-12-17 11:30:00",4291,1293,5584
"2019-12-16 10:11:26","2019-12-17 12:00:00","2019-12-17 12:30:00",4289,1286,5575
"2019-12-16 10:11:26","2019-12-17 13:00:00","2019-12-17 13:30:00",4261,1274,5535
"2019-12-16 10:11:26","2019-12-17 14:00:00","2019-12-17 14:30:00",4192,1252,5444
"2019-12-16 10:11:26","2019-12-17 15:00:00","2019-12-17 15:30:00",4154,1246,5400
"2019-12-16 10:11:26","2019-12-17 16:00:00","2019-12-17 16:30:00",4298,1326,5624
"2019-12-16 10:11:26","2019-12-17 17:00:00","2019-12-17 17:30:00",4871,1504,6375
"2019-12-16 10:11:26","2019-12-17 18:00:00","2019-12-17 18:30:00",4972,1462,6434
"2019-12-16 10:11:26","2019-12-17 19:00:00","2019-12-17 19:30:00",4783,1367,6150
"2019-12-16 10:11:26","2019-12-17 20:00:00","2019-12-17 20:30:00",4610,1270,5880
"2019-12-16 10:11:26","2019-12-17 21:00:00","2019-12-17 21:30:00",4363,1180,5543
"2019-12-16 10:11:26","2019-12-17 22:00:00","2019-12-17 22:30:00",4049,1065,5114
"2019-12-17 10:11:11","2019-12-17 23:00:00","2019-12-17 23:30:00",3646,905,4551
"2019-12-17 10:11:11","2019-12-18 00:00:00","2019-12-18 00:30:00",3224,744,3968
"2019-12-17 10:11:11","2019-12-18 01:00:00","2019-12-18 01:30:00",3018,693,3711
"2019-12-17 10:11:11","2019-12-18 02:00:00","2019-12-18 02:30:00",2894,680,3574
"2019-12-17 10:11:11","2019-12-18 03:00:00","2019-12-18 03:30:00",2818,660,3478
"2019-12-17 10:11:11","2019-12-18 04:00:00","2019-12-18 04:30:00",2784,651,3435
"2019-12-17 10:11:11","2019-12-18 05:00:00","2019-12-18 05:30:00",2800,669,3469
"2019-12-17 10:11:11","2019-12-18 06:00:00","2019-12-18 06:30:00",2982,746,3728
"2019-12-17 10:11:11","2019-12-18 07:00:00","2019-12-18 07:30:00",3510,960,4470
"2019-12-17 10:11:11","2019-12-18 08:00:00","2019-12-18 08:30:00",4053,1215,5268
"2019-12-17 10:11:11","2019-12-18 09:00:00","2019-12-18 09:30:00",4125,1251,5376
"2019-12-17 10:11:11","2019-12-18 10:00:00","2019-12-18 10:30:00",4268,1252,5520
"2019-12-17 10:11:11","2019-12-18 11:00:00","2019-12-18 11:30:00",4273,1219,5492
"2019-12-17 10:11:11","2019-12-18 12:00:00","2019-12-18 12:30:00",4269,1214,5483
"2019-12-17 10:11:11","2019-12-18 13:00:00","2019-12-18 13:30:00",4299,1185,5484
"2019-12-17 10:11:11","2019-12-18 14:00:00","2019-12-18 14:30:00",4196,1171,5367
"2019-12-17 10:11:11","2019-12-18 15:00:00","2019-12-18 15:30:00",4249,1156,5405
"2019-12-17 10:11:11","2019-12-18 16:00:00","2019-12-18 16:30:00",4344,1223,5567
"2019-12-17 10:11:11","2019-12-18 17:00:00","2019-12-18 17:30:00",4818,1394,6212
"2019-12-17 10:11:11","2019-12-18 18:00:00","2019-12-18 18:30:00",4862,1325,6187
"2019-12-17 10:11:11","2019-12-18 19:00:00","2019-12-18 19:30:00",4661,1220,5881
"2019-12-17 10:11:11","2019-12-18 20:00:00","2019-12-18 20:30:00",4448,1142,5590
"2019-12-17 10:11:11","2019-12-18 21:00:00","2019-12-18 21:30:00",4234,1077,5311
"2019-12-17 10:11:11","2019-12-18 22:00:00","2019-12-18 22:30:00",3847,974,4821
"2019-12-18 10:11:06","2019-12-18 23:00:00","2019-12-18 23:30:00",3726,918,4644
"2019-12-18 10:11:06","2019-12-19 00:00:00","2019-12-19 00:30:00",3366,642,4008
"2019-12-18 10:11:06","2019-12-19 01:00:00","2019-12-19 01:30:00",3159,596,3755
"2019-12-18 10:11:06","2019-12-19 02:00:00","2019-12-19 02:30:00",3007,596,3603
"2019-12-18 10:11:06","2019-12-19 03:00:00","2019-12-19 03:30:00",2894,594,3488
"2019-12-18 10:11:06","2019-12-19 04:00:00","2019-12-19 04:30:00",2862,594,3456
"2019-12-18 10:11:06","2019-12-19 05:00:00","2019-12-19 05:30:00",2925,624,3549
"2019-12-18 10:11:06","2019-12-19 06:00:00","2019-12-19 06:30:00",3110,710,3820
"2019-12-18 10:11:06","2019-12-19 07:00:00","2019-12-19 07:30:00",3610,925,4535
"2019-12-18 10:11:06","2019-12-19 08:00:00","2019-12-19 08:30:00",4162,1162,5324
"2019-12-18 10:11:06","2019-12-19 09:00:00","2019-12-19 09:30:00",4223,1205,5428
"2019-12-18 10:11:06","2019-12-19 10:00:00","2019-12-19 10:30:00",4353,1231,5584
"2019-12-18 10:11:06","2019-12-19 11:00:00","2019-12-19 11:30:00",4353,1208,5561
"2019-12-18 10:11:06","2019-12-19 12:00:00","2019-12-19 12:30:00",4301,1209,5510
"2019-12-18 10:11:06","2019-12-19 13:00:00","2019-12-19 13:30:00",4341,1190,5531
"2019-12-18 10:11:06","2019-12-19 14:00:00","2019-12-19 14:30:00",4260,1171,5431
"2019-12-18 10:11:06","2019-12-19 15:00:00","2019-12-19 15:30:00",4283,1178,5461
"2019-12-18 10:11:06","2019-12-19 16:00:00","2019-12-19 16:30:00",4453,1273,5726
"2019-12-18 10:11:06","2019-12-19 17:00:00","2019-12-19 17:30:00",4897,1470,6367
"2019-12-18 10:11:06","2019-12-19 18:00:00","2019-12-19 18:30:00",4975,1427,6402
"2019-12-18 10:11:06","2019-12-19 19:00:00","2019-12-19 19:30:00",4822,1334,6156
"2019-12-18 10:11:06","2019-12-19 20:00:00","2019-12-19 20:30:00",4602,1258,5860
"2019-12-18 10:11:06","2019-12-19 21:00:00","2019-12-19 21:30:00",4394,1179,5573
"2019-12-18 10:11:06","2019-12-19 22:00:00","2019-12-19 22:30:00",4037,1058,5095
"2019-12-19 10:11:26","2019-12-19 23:00:00","2019-12-19 23:30:00",3714,893,4607
"2019-12-19 10:11:26","2019-12-20 00:00:00","2019-12-20 00:30:00",3399,776,4175
"2019-12-19 10:11:26","2019-12-20 01:00:00","2019-12-20 01:30:00",3087,719,3806
"2019-12-19 10:11:26","2019-12-20 02:00:00","2019-12-20 02:30:00",2870,690,3560
"2019-12-19 10:11:26","2019-12-20 03:00:00","2019-12-20 03:30:00",2730,664,3394
"2019-12-19 10:11:26","2019-12-20 04:00:00","2019-12-20 04:30:00",2730,626,3356
"2019-12-19 10:11:26","2019-12-20 05:00:00","2019-12-20 05:30:00",2777,632,3409
"2019-12-19 10:11:26","2019-12-20 06:00:00","2019-12-20 06:30:00",2958,711,3669
"2019-12-19 10:11:26","2019-12-20 07:00:00","2019-12-20 07:30:00",3500,926,4426
"2019-12-19 10:11:26","2019-12-20 08:00:00","2019-12-20 08:30:00",4103,1174,5277
"2019-12-19 10:11:26","2019-12-20 09:00:00","2019-12-20 09:30:00",4155,1215,5370
"2019-12-19 10:11:26","2019-12-20 10:00:00","2019-12-20 10:30:00",4169,1234,5403
"2019-12-19 10:11:26","2019-12-20 11:00:00","2019-12-20 11:30:00",4167,1209,5376
"2019-12-19 10:11:26","2019-12-20 12:00:00","2019-12-20 12:30:00",4075,1228,5303
"2019-12-19 10:11:26","2019-12-20 13:00:00","2019-12-20 13:30:00",4022,1209,5231
"2019-12-19 10:11:26","2019-12-20 14:00:00","2019-12-20 14:30:00",3920,1145,5065
"2019-12-19 10:11:26","2019-12-20 15:00:00","2019-12-20 15:30:00",3867,1136,5003
"2019-12-19 10:11:26","2019-12-20 16:00:00","2019-12-20 16:30:00",3963,1214,5177
"2019-12-19 10:11:26","2019-12-20 17:00:00","2019-12-20 17:30:00",4448,1379,5827
"2019-12-19 10:11:26","2019-12-20 18:00:00","2019-12-20 18:30:00",4576,1379,5955
"2019-12-19 10:11:26","2019-12-20 19:00:00","2019-12-20 19:30:00",4396,1283,5679
"2019-12-19 10:11:26","2019-12-20 20:00:00","2019-12-20 20:30:00",4172,1187,5359
"2019-12-19 10:11:26","2019-12-20 21:00:00","2019-12-20 21:30:00",4011,1090,5101
"2019-12-19 10:11:26","2019-12-20 22:00:00","2019-12-20 22:30:00",3702,999,4701
"2019-12-20 10:11:25","2019-12-20 23:00:00","2019-12-20 23:30:00",3478,814,4292
"2019-12-20 10:11:25","2019-12-21 00:00:00","2019-12-21 00:30:00",3283,738,4021
"2019-12-20 10:11:25","2019-12-21 01:00:00","2019-12-21 01:30:00",3026,665,3691
"2019-12-20 10:11:25","2019-12-21 02:00:00","2019-12-21 02:30:00",2822,647,3469
"2019-12-20 10:11:25","2019-12-21 03:00:00","2019-12-21 03:30:00",2684,613,3297
"2019-12-20 10:11:25","2019-12-21 04:00:00","2019-12-21 04:30:00",2603,610,3213
"2019-12-20 10:11:25","2019-12-21 05:00:00","2019-12-21 05:30:00",2600,591,3191
"2019-12-20 10:11:25","2019-12-21 06:00:00","2019-12-21 06:30:00",2699,630,3329
"2019-12-20 10:11:25","2019-12-21 07:00:00","2019-12-21 07:30:00",2849,735,3584
"2019-12-20 10:11:25","2019-12-21 08:00:00","2019-12-21 08:30:00",3122,875,3997
"2019-12-20 10:11:25","2019-12-21 09:00:00","2019-12-21 09:30:00",3364,1007,4371
"2019-12-20 10:11:25","2019-12-21 10:00:00","2019-12-21 10:30:00",3609,1098,4707
"2019-12-20 10:11:25","2019-12-21 11:00:00","2019-12-21 11:30:00",3659,1140,4799
"2019-12-20 10:11:25","2019-12-21 12:00:00","2019-12-21 12:30:00",3754,1148,4902
"2019-12-20 10:11:25","2019-12-21 13:00:00","2019-12-21 13:30:00",3779,1120,4899
"2019-12-20 10:11:25","2019-12-21 14:00:00","2019-12-21 14:30:00",3721,1060,4781
"2019-12-20 10:11:25","2019-12-21 15:00:00","2019-12-21 15:30:00",3700,1058,4758
"2019-12-20 10:11:25","2019-12-21 16:00:00","2019-12-21 16:30:00",3800,1111,4911
"2019-12-20 10:11:25","2019-12-21 17:00:00","2019-12-21 17:30:00",4212,1305,5517
"2019-12-20 10:11:25","2019-12-21 18:00:00","2019-12-21 18:30:00",4279,1283,5562
"2019-12-20 10:11:25","2019-12-21 19:00:00","2019-12-21 19:30:00",4099,1169,5268
"2019-12-20 10:11:25","2019-12-21 20:00:00","2019-12-21 20:30:00",3884,1120,5004
"2019-12-20 10:11:25","2019-12-21 21:00:00","2019-12-21 21:30:00",3698,1052,4750
"2019-12-20 10:11:25","2019-12-21 22:00:00","2019-12-21 22:30:00",3396,949,4345
"2019-12-21 10:11:21","2019-12-21 23:00:00","2019-12-21 23:30:00",3236,882,4118
"2019-12-21 10:11:21","2019-12-22 00:00:00","2019-12-22 00:30:00",3127,747,3874
"2019-12-21 10:11:21","2019-12-22 01:00:00","2019-12-22 01:30:00",2894,677,3571
"2019-12-21 10:11:21","2019-12-22 02:00:00","2019-12-22 02:30:00",2726,659,3385
"2019-12-21 10:11:21","2019-12-22 03:00:00","2019-12-22 03:30:00",2623,618,3241
"2019-12-21 10:11:21","2019-12-22 04:00:00","2019-12-22 04:30:00",2580,585,3165
"2019-12-21 10:11:21","2019-12-22 05:00:00","2019-12-22 05:30:00",2550,586,3136
"2019-12-21 10:11:21","2019-12-22 06:00:00","2019-12-22 06:30:00",2601,636,3237
"2019-12-21 10:11:21","2019-12-22 07:00:00","2019-12-22 07:30:00",2698,702,3400
"2019-12-21 10:11:21","2019-12-22 08:00:00","2019-12-22 08:30:00",2863,816,3679
"2019-12-21 10:11:21","2019-12-22 09:00:00","2019-12-22 09:30:00",3054,914,3968
"2019-12-21 10:11:21","2019-12-22 10:00:00","2019-12-22 10:30:00",3353,981,4334
"2019-12-21 10:11:21","2019-12-22 11:00:00","2019-12-22 11:30:00",3558,1074,4632
"2019-12-21 10:11:21","2019-12-22 12:00:00","2019-12-22 12:30:00",3681,1120,4801
"2019-12-21 10:11:21","2019-12-22 13:00:00","2019-12-22 13:30:00",3706,1137,4843
"2019-12-21 10:11:21","2019-12-22 14:00:00","2019-12-22 14:30:00",3672,1101,4773
"2019-12-21 10:11:21","2019-12-22 15:00:00","2019-12-22 15:30:00",3698,1074,4772
"2019-12-21 10:11:21","2019-12-22 16:00:00","2019-12-22 16:30:00",3796,1149,4945
"2019-12-21 10:11:21","2019-12-22 17:00:00","2019-12-22 17:30:00",4132,1283,5415
"2019-12-21 10:11:21","2019-12-22 18:00:00","2019-12-22 18:30:00",4191,1293,5484
"2019-12-21 10:11:21","2019-12-22 19:00:00","2019-12-22 19:30:00",4016,1206,5222
"2019-12-21 10:11:21","2019-12-22 20:00:00","2019-12-22 20:30:00",3917,1122,5039
"2019-12-21 10:11:21","2019-12-22 21:00:00","2019-12-22 21:30:00",3761,1064,4825
"2019-12-21 10:11:21","2019-12-22 22:00:00","2019-12-22 22:30:00",3491,947,4438
"2019-12-22 10:11:11","2019-12-22 23:00:00","2019-12-22 23:30:00",3322,837,4159
"2019-12-22 10:11:11","2019-12-23 00:00:00","2019-12-23 00:30:00",3268,707,3975
"2019-12-22 10:11:11","2019-12-23 01:00:00","2019-12-23 01:30:00",2956,646,3602
"2019-12-22 10:11:11","2019-12-23 02:00:00","2019-12-23 02:30:00",2689,638,3327
"2019-12-22 10:11:11","2019-12-23 03:00:00","2019-12-23 03:30:00",2532,616,3148
"2019-12-22 10:11:11","2019-12-23 04:00:00","2019-12-23 04:30:00",2500,604,3104
"2019-12-22 10:11:11","2019-12-23 05:00:00","2019-12-23 05:30:00",2450,594,3044
"2019-12-22 10:11:11","2019-12-23 06:00:00","2019-12-23 06:30:00",2552,668,3220
"2019-12-22 10:11:11","2019-12-23 07:00:00","2019-12-23 07:30:00",2805,893,3698
"2019-12-22 10:11:11","2019-12-23 08:00:00","2019-12-23 08:30:00",3161,1132,4293
"2019-12-22 10:11:11","2019-12-23 09:00:00","2019-12-23 09:30:00",3505,1154,4659
"2019-12-22 10:11:11","2019-12-23 10:00:00","2019-12-23 10:30:00",3801,1196,4997
"2019-12-22 10:11:11","2019-12-23 11:00:00","2019-12-23 11:30:00",3911,1230,5141
"2019-12-22 10:11:11","2019-12-23 12:00:00","2019-12-23 12:30:00",3935,1227,5162
"2019-12-22 10:11:11","2019-12-23 13:00:00","2019-12-23 13:30:00",3963,1221,5184
"2019-12-22 10:11:11","2019-12-23 14:00:00","2019-12-23 14:30:00",3891,1192,5083
"2019-12-22 10:11:11","2019-12-23 15:00:00","2019-12-23 15:30:00",3876,1208,5084
"2019-12-22 10:11:11","2019-12-23 16:00:00","2019-12-23 16:30:00",4010,1298,5308
"2019-12-22 10:11:11","2019-12-23 17:00:00","2019-12-23 17:30:00",4334,1470,5804
"2019-12-22 10:11:11","2019-12-23 18:00:00","2019-12-23 18:30:00",4289,1462,5751
"2019-12-22 10:11:11","2019-12-23 19:00:00","2019-12-23 19:30:00",4069,1348,5417
"2019-12-22 10:11:11","2019-12-23 20:00:00","2019-12-23 20:30:00",3828,1253,5081
"2019-12-22 10:11:11","2019-12-23 21:00:00","2019-12-23 21:30:00",3619,1164,4783
"2019-12-22 10:11:11","2019-12-23 22:00:00","2019-12-23 22:30:00",3413,1050,4463
"2019-12-23 10:11:31","2019-12-23 23:00:00","2019-12-23 23:30:00",3269,781,4050
"2019-12-23 10:11:31","2019-12-24 00:00:00","2019-12-24 00:30:00",3143,774,3917
"2019-12-23 10:11:31","2019-12-24 01:00:00","2019-12-24 01:30:00",2867,687,3554
"2019-12-23 10:11:31","2019-12-24 02:00:00","2019-12-24 02:30:00",2631,654,3285
"2019-12-23 10:11:31","2019-12-24 03:00:00","2019-12-24 03:30:00",2492,601,3093
"2019-12-23 10:11:31","2019-12-24 04:00:00","2019-12-24 04:30:00",2464,576,3040
"2019-12-23 10:11:31","2019-12-24 05:00:00","2019-12-24 05:30:00",2420,577,2997
"2019-12-23 10:11:31","2019-12-24 06:00:00","2019-12-24 06:30:00",2510,630,3140
"2019-12-23 10:11:31","2019-12-24 07:00:00","2019-12-24 07:30:00",2734,748,3482
"2019-12-23 10:11:31","2019-12-24 08:00:00","2019-12-24 08:30:00",3022,904,3926
"2019-12-23 10:11:31","2019-12-24 09:00:00","2019-12-24 09:30:00",3318,1013,4331
"2019-12-23 10:11:31","2019-12-24 10:00:00","2019-12-24 10:30:00",3589,1090,4679
"2019-12-23 10:11:31","2019-12-24 11:00:00","2019-12-24 11:30:00",3704,1107,4811
"2019-12-23 10:11:31","2019-12-24 12:00:00","2019-12-24 12:30:00",3733,1108,4841
"2019-12-23 10:11:31","2019-12-24 13:00:00","2019-12-24 13:30:00",3757,1129,4886
"2019-12-23 10:11:31","2019-12-24 14:00:00","2019-12-24 14:30:00",3694,1119,4813
"2019-12-23 10:11:31","2019-12-24 15:00:00","2019-12-24 15:30:00",3681,1114,4795
"2019-12-23 10:11:31","2019-12-24 16:00:00","2019-12-24 16:30:00",3799,1169,4968
"2019-12-23 10:11:31","2019-12-24 17:00:00","2019-12-24 17:30:00",4086,1347,5433
"2019-12-23 10:11:31","2019-12-24 18:00:00","2019-12-24 18:30:00",4046,1328,5374
"2019-12-23 10:11:31","2019-12-24 19:00:00","2019-12-24 19:30:00",3851,1243,5094
"2019-12-23 10:11:31","2019-12-24 20:00:00","2019-12-24 20:30:00",3639,1159,4798
"2019-12-23 10:11:31","2019-12-24 21:00:00","2019-12-24 21:30:00",3454,1083,4537
"2019-12-23 10:11:31","2019-12-24 22:00:00","2019-12-24 22:30:00",3272,1002,4274
"2019-12-24 10:11:25","2019-12-24 23:00:00","2019-12-24 23:30:00",3144,904,4048
"2019-12-24 10:11:25","2019-12-25 00:00:00","2019-12-25 00:30:00",3065,786,3851
"2019-12-24 10:11:25","2019-12-25 01:00:00","2019-12-25 01:30:00",2753,683,3436
"2019-12-24 10:11:25","2019-12-25 02:00:00","2019-12-25 02:30:00",2526,636,3162
"2019-12-24 10:11:25","2019-12-25 03:00:00","2019-12-25 03:30:00",2405,593,2998
"2019-12-24 10:11:25","2019-12-25 04:00:00","2019-12-25 04:30:00",2351,572,2923
"2019-12-24 10:11:25","2019-12-25 05:00:00","2019-12-25 05:30:00",2310,570,2880
"2019-12-24 10:11:25","2019-12-25 06:00:00","2019-12-25 06:30:00",2371,594,2965
"2019-12-24 10:11:25","2019-12-25 07:00:00","2019-12-25 07:30:00",2525,674,3199
"2019-12-24 10:11:25","2019-12-25 08:00:00","2019-12-25 08:30:00",2801,806,3607
"2019-12-24 10:11:25","2019-12-25 09:00:00","2019-12-25 09:30:00",3143,949,4092
"2019-12-24 10:11:25","2019-12-25 10:00:00","2019-12-25 10:30:00",3515,1065,4580
"2019-12-24 10:11:25","2019-12-25 11:00:00","2019-12-25 11:30:00",3627,1084,4711
"2019-12-24 10:11:25","2019-12-25 12:00:00","2019-12-25 12:30:00",3707,1122,4829
"2019-12-24 10:11:25","2019-12-25 13:00:00","2019-12-25 13:30:00",3774,1196,4970
"2019-12-24 10:11:25","2019-12-25 14:00:00","2019-12-25 14:30:00",3782,1166,4948
"2019-12-24 10:11:25","2019-12-25 15:00:00","2019-12-25 15:30:00",3571,1067,4638
"2019-12-24 10:11:25","2019-12-25 16:00:00","2019-12-25 16:30:00",3372,968,4340
"2019-12-24 10:11:25","2019-12-25 17:00:00","2019-12-25 17:30:00",3351,946,4297
"2019-12-24 10:11:25","2019-12-25 18:00:00","2019-12-25 18:30:00",3249,916,4165
"2019-12-24 10:11:25","2019-12-25 19:00:00","2019-12-25 19:30:00",3139,885,4024
"2019-12-24 10:11:25","2019-12-25 20:00:00","2019-12-25 20:30:00",3062,859,3921
"2019-12-24 10:11:25","2019-12-25 21:00:00","2019-12-25 21:30:00",3003,849,3852
"2019-12-24 10:11:25","2019-12-25 22:00:00","2019-12-25 22:30:00",2925,809,3734
"2019-12-25 10:11:15","2019-12-25 23:00:00","2019-12-25 23:30:00",2969,771,3740
"2019-12-25 10:11:15","2019-12-26 00:00:00","2019-12-26 00:30:00",2751,721,3472
"2019-12-25 10:11:15","2019-12-26 01:00:00","2019-12-26 01:30:00",2531,630,3161
"2019-12-25 10:11:15","2019-12-26 02:00:00","2019-12-26 02:30:00",2335,629,2964
"2019-12-25 10:11:15","2019-12-26 03:00:00","2019-12-26 03:30:00",2203,598,2801
"2019-12-25 10:11:15","2019-12-26 04:00:00","2019-12-26 04:30:00",2154,595,2749
"2019-12-25 10:11:15","2019-12-26 05:00:00","2019-12-26 05:30:00",2146,610,2756
"2019-12-25 10:11:15","2019-12-26 06:00:00","2019-12-26 06:30:00",2195,686,2881
"2019-12-25 10:11:15","2019-12-26 07:00:00","2019-12-26 07:30:00",2282,831,3113
"2019-12-25 10:11:15","2019-12-26 08:00:00","2019-12-26 08:30:00",2372,1024,3396
"2019-12-25 10:11:15","2019-12-26 09:00:00","2019-12-26 09:30:00",2467,1086,3553
"2019-12-25 10:11:15","2019-12-26 10:00:00","2019-12-26 10:30:00",2766,1152,3918
"2019-12-25 10:11:15","2019-12-26 11:00:00","2019-12-26 11:30:00",2994,1173,4167
"2019-12-25 10:11:15","2019-12-26 12:00:00","2019-12-26 12:30:00",3137,1160,4297
"2019-12-25 10:11:15","2019-12-26 13:00:00","2019-12-26 13:30:00",3258,1152,4410
"2019-12-25 10:11:15","2019-12-26 14:00:00","2019-12-26 14:30:00",3222,1140,4362
"2019-12-25 10:11:15","2019-12-26 15:00:00","2019-12-26 15:30:00",3178,1126,4304
"2019-12-25 10:11:15","2019-12-26 16:00:00","2019-12-26 16:30:00",3263,1207,4470
"2019-12-25 10:11:15","2019-12-26 17:00:00","2019-12-26 17:30:00",3534,1362,4896
"2019-12-25 10:11:15","2019-12-26 18:00:00","2019-12-26 18:30:00",3558,1359,4917
"2019-12-25 10:11:15","2019-12-26 19:00:00","2019-12-26 19:30:00",3431,1257,4688
"2019-12-25 10:11:15","2019-12-26 20:00:00","2019-12-26 20:30:00",3281,1190,4471
"2019-12-25 10:11:15","2019-12-26 21:00:00","2019-12-26 21:30:00",3152,1104,4256
"2019-12-25 10:11:15","2019-12-26 22:00:00","2019-12-26 22:30:00",2996,1004,4000
"2019-12-26 10:11:10","2019-12-26 23:00:00","2019-12-26 23:30:00",3027,765,3792
"2019-12-26 10:11:10","2019-12-27 00:00:00","2019-12-27 00:30:00",2978,735,3713
"2019-12-26 10:11:10","2019-12-27 01:00:00","2019-12-27 01:30:00",2745,666,3411
"2019-12-26 10:11:10","2019-12-27 02:00:00","2019-12-27 02:30:00",2551,648,3199
"2019-12-26 10:11:10","2019-12-27 03:00:00","2019-12-27 03:30:00",2389,607,2996
"2019-12-26 10:11:10","2019-12-27 04:00:00","2019-12-27 04:30:00",2350,596,2946
"2019-12-26 10:11:10","2019-12-27 05:00:00","2019-12-27 05:30:00",2355,615,2970
"2019-12-26 10:11:10","2019-12-27 06:00:00","2019-12-27 06:30:00",2474,680,3154
"2019-12-26 10:11:10","2019-12-27 07:00:00","2019-12-27 07:30:00",2673,827,3500
"2019-12-26 10:11:10","2019-12-27 08:00:00","2019-12-27 08:30:00",2923,1014,3937
"2019-12-26 10:11:10","2019-12-27 09:00:00","2019-12-27 09:30:00",3092,1067,4159
"2019-12-26 10:11:10","2019-12-27 10:00:00","2019-12-27 10:30:00",3396,1060,4456
"2019-12-26 10:11:10","2019-12-27 11:00:00","2019-12-27 11:30:00",3547,1068,4615
"2019-12-26 10:11:10","2019-12-27 12:00:00","2019-12-27 12:30:00",3632,1044,4676
"2019-12-26 10:11:10","2019-12-27 13:00:00","2019-12-27 13:30:00",3654,1028,4682
"2019-12-26 10:11:10","2019-12-27 14:00:00","2019-12-27 14:30:00",3580,989,4569
"2019-12-26 10:11:10","2019-12-27 15:00:00","2019-12-27 15:30:00",3560,990,4550
"2019-12-26 10:11:10","2019-12-27 16:00:00","2019-12-27 16:30:00",3635,1053,4688
"2019-12-26 10:11:10","2019-12-27 17:00:00","2019-12-27 17:30:00",4015,1184,5199
"2019-12-26 10:11:10","2019-12-27 18:00:00","2019-12-27 18:30:00",4063,1186,5249
"2019-12-26 10:11:10","2019-12-27 19:00:00","2019-12-27 19:30:00",3911,1115,5026
"2019-12-26 10:11:10","2019-12-27 20:00:00","2019-12-27 20:30:00",3709,1039,4748
"2019-12-26 10:11:10","2019-12-27 21:00:00","2019-12-27 21:30:00",3526,980,4506
"2019-12-26 10:11:10","2019-12-27 22:00:00","2019-12-27 22:30:00",3318,885,4203
"2019-12-27 10:11:26","2019-12-27 23:00:00","2019-12-27 23:30:00",3101,803,3904
"2019-12-27 10:11:26","2019-12-28 00:00:00","2019-12-28 00:30:00",3052,639,3691
"2019-12-27 10:11:26","2019-12-28 01:00:00","2019-12-28 01:30:00",2792,573,3365
"2019-12-27 10:11:26","2019-12-28 02:00:00","2019-12-28 02:30:00",2613,547,3160
"2019-12-27 10:11:26","2019-12-28 03:00:00","2019-12-28 03:30:00",2496,517,3013
"2019-12-27 10:11:26","2019-12-28 04:00:00","2019-12-28 04:30:00",2462,506,2968
"2019-12-27 10:11:26","2019-12-28 05:00:00","2019-12-28 05:30:00",2400,495,2895
"2019-12-27 10:11:26","2019-12-28 06:00:00","2019-12-28 06:30:00",2455,517,2972
"2019-12-27 10:11:26","2019-12-28 07:00:00","2019-12-28 07:30:00",2606,589,3195
"2019-12-27 10:11:26","2019-12-28 08:00:00","2019-12-28 08:30:00",2765,693,3458
"2019-12-27 10:11:26","2019-12-28 09:00:00","2019-12-28 09:30:00",2996,793,3789
"2019-12-27 10:11:26","2019-12-28 10:00:00","2019-12-28 10:30:00",3257,855,4112
"2019-12-27 10:11:26","2019-12-28 11:00:00","2019-12-28 11:30:00",3488,897,4385
"2019-12-27 10:11:26","2019-12-28 12:00:00","2019-12-28 12:30:00",3591,918,4509
"2019-12-27 10:11:26","2019-12-28 13:00:00","2019-12-28 13:30:00",3623,908,4531
"2019-12-27 10:11:26","2019-12-28 14:00:00","2019-12-28 14:30:00",3555,885,4440
"2019-12-27 10:11:26","2019-12-28 15:00:00","2019-12-28 15:30:00",3526,884,4410
"2019-12-27 10:11:26","2019-12-28 16:00:00","2019-12-28 16:30:00",3632,944,4576
"2019-12-27 10:11:26","2019-12-28 17:00:00","2019-12-28 17:30:00",4064,1049,5113
"2019-12-27 10:11:26","2019-12-28 18:00:00","2019-12-28 18:30:00",4106,1040,5146
"2019-12-27 10:11:26","2019-12-28 19:00:00","2019-12-28 19:30:00",3926,978,4904
"2019-12-27 10:11:26","2019-12-28 20:00:00","2019-12-28 20:30:00",3724,901,4625
"2019-12-27 10:11:26","2019-12-28 21:00:00","2019-12-28 21:30:00",3519,848,4367
"2019-12-27 10:11:26","2019-12-28 22:00:00","2019-12-28 22:30:00",3276,781,4057
"2019-12-28 10:11:25","2019-12-28 23:00:00","2019-12-28 23:30:00",3134,773,3907
"2019-12-28 10:11:25","2019-12-29 00:00:00","2019-12-29 00:30:00",3036,578,3614
"2019-12-28 10:11:25","2019-12-29 01:00:00","2019-12-29 01:30:00",2815,534,3349
"2019-12-28 10:11:25","2019-12-29 02:00:00","2019-12-29 02:30:00",2602,518,3120
"2019-12-28 10:11:25","2019-12-29 03:00:00","2019-12-29 03:30:00",2512,487,2999
"2019-12-28 10:11:25","2019-12-29 04:00:00","2019-12-29 04:30:00",2424,459,2883
"2019-12-28 10:11:25","2019-12-29 05:00:00","2019-12-29 05:30:00",2414,457,2871
"2019-12-28 10:11:25","2019-12-29 06:00:00","2019-12-29 06:30:00",2483,472,2955
"2019-12-28 10:11:25","2019-12-29 07:00:00","2019-12-29 07:30:00",2602,507,3109
"2019-12-28 10:11:25","2019-12-29 08:00:00","2019-12-29 08:30:00",2780,583,3363
"2019-12-28 10:11:25","2019-12-29 09:00:00","2019-12-29 09:30:00",2973,673,3646
"2019-12-28 10:11:25","2019-12-29 10:00:00","2019-12-29 10:30:00",3282,779,4061
"2019-12-28 10:11:25","2019-12-29 11:00:00","2019-12-29 11:30:00",3376,844,4220
"2019-12-28 10:11:25","2019-12-29 12:00:00","2019-12-29 12:30:00",3432,871,4303
"2019-12-28 10:11:25","2019-12-29 13:00:00","2019-12-29 13:30:00",3419,881,4300
"2019-12-28 10:11:25","2019-12-29 14:00:00","2019-12-29 14:30:00",3361,800,4161
"2019-12-28 10:11:25","2019-12-29 15:00:00","2019-12-29 15:30:00",3329,814,4143
"2019-12-28 10:11:25","2019-12-29 16:00:00","2019-12-29 16:30:00",3458,863,4321
"2019-12-28 10:11:25","2019-12-29 17:00:00","2019-12-29 17:30:00",3835,1010,4845
"2019-12-28 10:11:25","2019-12-29 18:00:00","2019-12-29 18:30:00",3928,1031,4959
"2019-12-28 10:11:25","2019-12-29 19:00:00","2019-12-29 19:30:00",3784,942,4726
"2019-12-28 10:11:25","2019-12-29 20:00:00","2019-12-29 20:30:00",3650,906,4556
"2019-12-28 10:11:25","2019-12-29 21:00:00","2019-12-29 21:30:00",3522,861,4383
"2019-12-28 10:11:25","2019-12-29 22:00:00","2019-12-29 22:30:00",3306,779,4085
"2019-12-29 10:11:15","2019-12-29 23:00:00","2019-12-29 23:30:00",3055,737,3792
"2019-12-29 10:11:15","2019-12-30 00:00:00","2019-12-30 00:30:00",3059,724,3783
"2019-12-29 10:11:15","2019-12-30 01:00:00","2019-12-30 01:30:00",2780,640,3420
"2019-12-29 10:11:15","2019-12-30 02:00:00","2019-12-30 02:30:00",2546,617,3163
"2019-12-29 10:11:15","2019-12-30 03:00:00","2019-12-30 03:30:00",2412,568,2980
"2019-12-29 10:11:15","2019-12-30 04:00:00","2019-12-30 04:30:00",2344,550,2894
"2019-12-29 10:11:15","2019-12-30 05:00:00","2019-12-30 05:30:00",2300,556,2856
"2019-12-29 10:11:15","2019-12-30 06:00:00","2019-12-30 06:30:00",2353,615,2968
"2019-12-29 10:11:15","2019-12-30 07:00:00","2019-12-30 07:30:00",2523,750,3273
"2019-12-29 10:11:15","2019-12-30 08:00:00","2019-12-30 08:30:00",2737,928,3665
"2019-12-29 10:11:15","2019-12-30 09:00:00","2019-12-30 09:30:00",2917,1049,3966
"2019-12-29 10:11:15","2019-12-30 10:00:00","2019-12-30 10:30:00",3282,1131,4413
"2019-12-29 10:11:15","2019-12-30 11:00:00","2019-12-30 11:30:00",3465,1142,4607
"2019-12-29 10:11:15","2019-12-30 12:00:00","2019-12-30 12:30:00",3535,1135,4670
"2019-12-29 10:11:15","2019-12-30 13:00:00","2019-12-30 13:30:00",3582,1150,4732
"2019-12-29 10:11:15","2019-12-30 14:00:00","2019-12-30 14:30:00",3514,1131,4645
"2019-12-29 10:11:15","2019-12-30 15:00:00","2019-12-30 15:30:00",3458,1116,4574
"2019-12-29 10:11:15","2019-12-30 16:00:00","2019-12-30 16:30:00",3540,1171,4711
"2019-12-29 10:11:15","2019-12-30 17:00:00","2019-12-30 17:30:00",4052,1360,5412
"2019-12-29 10:11:15","2019-12-30 18:00:00","2019-12-30 18:30:00",4200,1335,5535
"2019-12-29 10:11:15","2019-12-30 19:00:00","2019-12-30 19:30:00",4042,1242,5284
"2019-12-29 10:11:15","2019-12-30 20:00:00","2019-12-30 20:30:00",3815,1150,4965
"2019-12-29 10:11:15","2019-12-30 21:00:00","2019-12-30 21:30:00",3609,1066,4675
"2019-12-29 10:11:15","2019-12-30 22:00:00","2019-12-30 22:30:00",3361,978,4339
"2019-12-30 10:11:36","2019-12-30 23:00:00","2019-12-30 23:30:00",3213,763,3976
"2019-12-30 10:11:36","2019-12-31 00:00:00","2019-12-31 00:30:00",2904,686,3590
"2019-12-30 10:11:36","2019-12-31 01:00:00","2019-12-31 01:30:00",2663,623,3286
"2019-12-30 10:11:36","2019-12-31 02:00:00","2019-12-31 02:30:00",2494,600,3094
"2019-12-30 10:11:36","2019-12-31 03:00:00","2019-12-31 03:30:00",2387,580,2967
"2019-12-30 10:11:36","2019-12-31 04:00:00","2019-12-31 04:30:00",2322,567,2889
"2019-12-30 10:11:36","2019-12-31 05:00:00","2019-12-31 05:30:00",2319,568,2887
"2019-12-30 10:11:36","2019-12-31 06:00:00","2019-12-31 06:30:00",2415,616,3031
"2019-12-30 10:11:36","2019-12-31 07:00:00","2019-12-31 07:30:00",2624,702,3326
"2019-12-30 10:11:36","2019-12-31 08:00:00","2019-12-31 08:30:00",2852,803,3655
"2019-12-30 10:11:36","2019-12-31 09:00:00","2019-12-31 09:30:00",3003,901,3904
"2019-12-30 10:11:36","2019-12-31 10:00:00","2019-12-31 10:30:00",3256,978,4234
"2019-12-30 10:11:36","2019-12-31 11:00:00","2019-12-31 11:30:00",3400,1026,4426
"2019-12-30 10:11:36","2019-12-31 12:00:00","2019-12-31 12:30:00",3519,1038,4557
"2019-12-30 10:11:36","2019-12-31 13:00:00","2019-12-31 13:30:00",3561,1030,4591
"2019-12-30 10:11:36","2019-12-31 14:00:00","2019-12-31 14:30:00",3521,998,4519
"2019-12-30 10:11:36","2019-12-31 15:00:00","2019-12-31 15:30:00",3559,995,4554
"2019-12-30 10:11:36","2019-12-31 16:00:00","2019-12-31 16:30:00",3642,1043,4685
"2019-12-30 10:11:36","2019-12-31 17:00:00","2019-12-31 17:30:00",4032,1245,5277
"2019-12-30 10:11:36","2019-12-31 18:00:00","2019-12-31 18:30:00",4105,1245,5350
"2019-12-30 10:11:36","2019-12-31 19:00:00","2019-12-31 19:30:00",3889,1130,5019
"2019-12-30 10:11:36","2019-12-31 20:00:00","2019-12-31 20:30:00",3592,1010,4602
"2019-12-30 10:11:36","2019-12-31 21:00:00","2019-12-31 21:30:00",3347,923,4270
"2019-12-30 10:11:36","2019-12-31 22:00:00","2019-12-31 22:30:00",3123,836,3959
"2019-12-31 10:11:31","2019-12-31 23:00:00","2019-12-31 23:30:00",3064,806,3870
"2019-12-31 10:11:31","2020-01-01 00:00:00","2020-01-01 00:30:00",3030,692,3722
"2019-12-31 10:11:31","2020-01-01 01:00:00","2020-01-01 01:30:00",2884,636,3520
"2019-12-31 10:11:31","2020-01-01 02:00:00","2020-01-01 02:30:00",2617,624,3241
"2019-12-31 10:11:31","2020-01-01 03:00:00","2020-01-01 03:30:00",2457,585,3042
"2019-12-31 10:11:31","2020-01-01 04:00:00","2020-01-01 04:30:00",2369,559,2928
"2019-12-31 10:11:31","2020-01-01 05:00:00","2020-01-01 05:30:00",2300,555,2855
"2019-12-31 10:11:31","2020-01-01 06:00:00","2020-01-01 06:30:00",2318,574,2892
"2019-12-31 10:11:31","2020-01-01 07:00:00","2020-01-01 07:30:00",2400,626,3026
"2019-12-31 10:11:31","2020-01-01 08:00:00","2020-01-01 08:30:00",2436,670,3106
"2019-12-31 10:11:31","2020-01-01 09:00:00","2020-01-01 09:30:00",2492,712,3204
"2019-12-31 10:11:31","2020-01-01 10:00:00","2020-01-01 10:30:00",2753,792,3545
"2019-12-31 10:11:31","2020-01-01 11:00:00","2020-01-01 11:30:00",3046,875,3921
"2019-12-31 10:11:31","2020-01-01 12:00:00","2020-01-01 12:30:00",3293,953,4246
"2019-12-31 10:11:31","2020-01-01 13:00:00","2020-01-01 13:30:00",3464,1002,4466
"2019-12-31 10:11:31","2020-01-01 14:00:00","2020-01-01 14:30:00",3427,988,4415
"2019-12-31 10:11:31","2020-01-01 15:00:00","2020-01-01 15:30:00",3392,982,4374
"2019-12-31 10:11:31","2020-01-01 16:00:00","2020-01-01 16:30:00",3426,1006,4432
"2019-12-31 10:11:31","2020-01-01 17:00:00","2020-01-01 17:30:00",3785,1188,4973
"2019-12-31 10:11:31","2020-01-01 18:00:00","2020-01-01 18:30:00",3874,1177,5051
"2019-12-31 10:11:31","2020-01-01 19:00:00","2020-01-01 19:30:00",3724,1112,4836
"2019-12-31 10:11:31","2020-01-01 20:00:00","2020-01-01 20:30:00",3561,1050,4611
"2019-12-31 10:11:31","2020-01-01 21:00:00","2020-01-01 21:30:00",3402,993,4395
"2019-12-31 10:11:31","2020-01-01 22:00:00","2020-01-01 22:30:00",3200,919,4119
"2020-01-01 10:11:16","2020-01-01 23:00:00","2020-01-01 23:30:00",3073,832,3905
"2020-01-01 10:11:16","2020-01-02 00:00:00","2020-01-02 00:30:00",2913,700,3613
"2020-01-01 10:11:16","2020-01-02 01:00:00","2020-01-02 01:30:00",2694,650,3344
"2020-01-01 10:11:16","2020-01-02 02:00:00","2020-01-02 02:30:00",2514,620,3134
"2020-01-01 10:11:16","2020-01-02 03:00:00","2020-01-02 03:30:00",2430,600,3030
"2020-01-01 10:11:16","2020-01-02 04:00:00","2020-01-02 04:30:00",2416,580,2996
"2020-01-01 10:11:16","2020-01-02 05:00:00","2020-01-02 05:30:00",2412,590,3002
"2020-01-01 10:11:16","2020-01-02 06:00:00","2020-01-02 06:30:00",2547,690,3237
"2020-01-01 10:11:16","2020-01-02 07:00:00","2020-01-02 07:30:00",2898,841,3739
"2020-01-01 10:11:16","2020-01-02 08:00:00","2020-01-02 08:30:00",3287,990,4277
"2020-01-01 10:11:16","2020-01-02 09:00:00","2020-01-02 09:30:00",3536,1095,4631
"2020-01-01 10:11:16","2020-01-02 10:00:00","2020-01-02 10:30:00",3786,1145,4931
"2020-01-01 10:11:16","2020-01-02 11:00:00","2020-01-02 11:30:00",3942,1170,5112
"2020-01-01 10:11:16","2020-01-02 12:00:00","2020-01-02 12:30:00",4005,1190,5195
"2020-01-01 10:11:16","2020-01-02 13:00:00","2020-01-02 13:30:00",4059,1205,5264
"2020-01-01 10:11:16","2020-01-02 14:00:00","2020-01-02 14:30:00",3986,1205,5191
"2020-01-01 10:11:16","2020-01-02 15:00:00","2020-01-02 15:30:00",3969,1210,5179
"2020-01-01 10:11:16","2020-01-02 16:00:00","2020-01-02 16:30:00",4059,1314,5373
"2020-01-01 10:11:16","2020-01-02 17:00:00","2020-01-02 17:30:00",4481,1470,5951
"2020-01-01 10:11:16","2020-01-02 18:00:00","2020-01-02 18:30:00",4620,1435,6055
"2020-01-01 10:11:16","2020-01-02 19:00:00","2020-01-02 19:30:00",4408,1330,5738
"2020-01-01 10:11:16","2020-01-02 20:00:00","2020-01-02 20:30:00",4161,1240,5401
"2020-01-01 10:11:16","2020-01-02 21:00:00","2020-01-02 21:30:00",3953,1140,5093
"2020-01-01 10:11:16","2020-01-02 22:00:00","2020-01-02 22:30:00",3635,1000,4635
"2020-01-02 10:11:06","2020-01-02 23:00:00","2020-01-02 23:30:00",3381,786,4167
"2020-01-02 10:11:06","2020-01-03 00:00:00","2020-01-03 00:30:00",3142,668,3810
"2020-01-02 10:11:06","2020-01-03 01:00:00","2020-01-03 01:30:00",2873,604,3477
"2020-01-02 10:11:06","2020-01-03 02:00:00","2020-01-03 02:30:00",2690,615,3305
"2020-01-02 10:11:06","2020-01-03 03:00:00","2020-01-03 03:30:00",2585,556,3141
"2020-01-02 10:11:06","2020-01-03 04:00:00","2020-01-03 04:30:00",2571,525,3096
"2020-01-02 10:11:06","2020-01-03 05:00:00","2020-01-03 05:30:00",2552,520,3072
"2020-01-02 10:11:06","2020-01-03 06:00:00","2020-01-03 06:30:00",2696,590,3286
"2020-01-02 10:11:06","2020-01-03 07:00:00","2020-01-03 07:30:00",3056,730,3786
"2020-01-02 10:11:06","2020-01-03 08:00:00","2020-01-03 08:30:00",3466,860,4326
"2020-01-02 10:11:06","2020-01-03 09:00:00","2020-01-03 09:30:00",3709,990,4699
"2020-01-02 10:11:06","2020-01-03 10:00:00","2020-01-03 10:30:00",3927,1110,5037
"2020-01-02 10:11:06","2020-01-03 11:00:00","2020-01-03 11:30:00",4022,1120,5142
"2020-01-02 10:11:06","2020-01-03 12:00:00","2020-01-03 12:30:00",4091,1145,5236
"2020-01-02 10:11:06","2020-01-03 13:00:00","2020-01-03 13:30:00",4146,1159,5305
"2020-01-02 10:11:06","2020-01-03 14:00:00","2020-01-03 14:30:00",4047,1120,5167
"2020-01-02 10:11:06","2020-01-03 15:00:00","2020-01-03 15:30:00",4027,1126,5153
"2020-01-02 10:11:06","2020-01-03 16:00:00","2020-01-03 16:30:00",4111,1190,5301
"2020-01-02 10:11:06","2020-01-03 17:00:00","2020-01-03 17:30:00",4464,1370,5834
"2020-01-02 10:11:06","2020-01-03 18:00:00","2020-01-03 18:30:00",4575,1365,5940
"2020-01-02 10:11:06","2020-01-03 19:00:00","2020-01-03 19:30:00",4360,1250,5610
"2020-01-02 10:11:06","2020-01-03 20:00:00","2020-01-03 20:30:00",4112,1155,5267
"2020-01-02 10:11:06","2020-01-03 21:00:00","2020-01-03 21:30:00",3871,1060,4931
"2020-01-02 10:11:06","2020-01-03 22:00:00","2020-01-03 22:30:00",3551,920,4471
"2020-01-03 10:11:11","2020-01-03 23:00:00","2020-01-03 23:30:00",3347,870,4217
"2020-01-03 10:11:11","2020-01-04 00:00:00","2020-01-04 00:30:00",3202,730,3932
"2020-01-03 10:11:11","2020-01-04 01:00:00","2020-01-04 01:30:00",2934,670,3604
"2020-01-03 10:11:11","2020-01-04 02:00:00","2020-01-04 02:30:00",2728,635,3363
"2020-01-03 10:11:11","2020-01-04 03:00:00","2020-01-04 03:30:00",2607,600,3207
"2020-01-03 10:11:11","2020-01-04 04:00:00","2020-01-04 04:30:00",2539,585,3124
"2020-01-03 10:11:11","2020-01-04 05:00:00","2020-01-04 05:30:00",2520,600,3120
"2020-01-03 10:11:11","2020-01-04 06:00:00","2020-01-04 06:30:00",2560,650,3210
"2020-01-03 10:11:11","2020-01-04 07:00:00","2020-01-04 07:30:00",2689,730,3419
"2020-01-03 10:11:11","2020-01-04 08:00:00","2020-01-04 08:30:00",2900,830,3730
"2020-01-03 10:11:11","2020-01-04 09:00:00","2020-01-04 09:30:00",3117,930,4047
"2020-01-03 10:11:11","2020-01-04 10:00:00","2020-01-04 10:30:00",3416,1040,4456
"2020-01-03 10:11:11","2020-01-04 11:00:00","2020-01-04 11:30:00",3599,1080,4679
"2020-01-03 10:11:11","2020-01-04 12:00:00","2020-01-04 12:30:00",3692,1105,4797
"2020-01-03 10:11:11","2020-01-04 13:00:00","2020-01-04 13:30:00",3721,1104,4825
"2020-01-03 10:11:11","2020-01-04 14:00:00","2020-01-04 14:30:00",3678,1060,4738
"2020-01-03 10:11:11","2020-01-04 15:00:00","2020-01-04 15:30:00",3674,1049,4723
"2020-01-03 10:11:11","2020-01-04 16:00:00","2020-01-04 16:30:00",3735,1140,4875
"2020-01-03 10:11:11","2020-01-04 17:00:00","2020-01-04 17:30:00",4162,1290,5452
"2020-01-03 10:11:11","2020-01-04 18:00:00","2020-01-04 18:30:00",4291,1295,5586
"2020-01-03 10:11:11","2020-01-04 19:00:00","2020-01-04 19:30:00",4081,1180,5261
"2020-01-03 10:11:11","2020-01-04 20:00:00","2020-01-04 20:30:00",3836,1095,4931
"2020-01-03 10:11:11","2020-01-04 21:00:00","2020-01-04 21:30:00",3587,990,4577
"2020-01-03 10:11:11","2020-01-04 22:00:00","2020-01-04 22:30:00",3366,870,4236
"2020-01-04 10:11:36","2020-01-04 23:00:00","2020-01-04 23:30:00",3198,885,4083
"2020-01-04 10:11:36","2020-01-05 00:00:00","2020-01-05 00:30:00",3123,661,3784
"2020-01-04 10:11:36","2020-01-05 01:00:00","2020-01-05 01:30:00",2882,581,3463
"2020-01-04 10:11:36","2020-01-05 02:00:00","2020-01-05 02:30:00",2652,548,3200
"2020-01-04 10:11:36","2020-01-05 03:00:00","2020-01-05 03:30:00",2512,527,3039
"2020-01-04 10:11:36","2020-01-05 04:00:00","2020-01-05 04:30:00",2454,481,2935
"2020-01-04 10:11:36","2020-01-05 05:00:00","2020-01-05 05:30:00",2420,481,2901
"2020-01-04 10:11:36","2020-01-05 06:00:00","2020-01-05 06:30:00",2461,510,2971
"2020-01-04 10:11:36","2020-01-05 07:00:00","2020-01-05 07:30:00",2532,565,3097
"2020-01-04 10:11:36","2020-01-05 08:00:00","2020-01-05 08:30:00",2633,634,3267
"2020-01-04 10:11:36","2020-01-05 09:00:00","2020-01-05 09:30:00",2753,696,3449
"2020-01-04 10:11:36","2020-01-05 10:00:00","2020-01-05 10:30:00",3049,797,3846
"2020-01-04 10:11:36","2020-01-05 11:00:00","2020-01-05 11:30:00",3310,914,4224
"2020-01-04 10:11:36","2020-01-05 12:00:00","2020-01-05 12:30:00",3488,991,4479
"2020-01-04 10:11:36","2020-01-05 13:00:00","2020-01-05 13:30:00",3592,1019,4611
"2020-01-04 10:11:36","2020-01-05 14:00:00","2020-01-05 14:30:00",3530,965,4495
"2020-01-04 10:11:36","2020-01-05 15:00:00","2020-01-05 15:30:00",3458,954,4412
"2020-01-04 10:11:36","2020-01-05 16:00:00","2020-01-05 16:30:00",3528,997,4525
"2020-01-04 10:11:36","2020-01-05 17:00:00","2020-01-05 17:30:00",3968,1102,5070
"2020-01-04 10:11:36","2020-01-05 18:00:00","2020-01-05 18:30:00",4150,1109,5259
"2020-01-04 10:11:36","2020-01-05 19:00:00","2020-01-05 19:30:00",3970,1036,5006
"2020-01-04 10:11:36","2020-01-05 20:00:00","2020-01-05 20:30:00",3817,991,4808
"2020-01-04 10:11:36","2020-01-05 21:00:00","2020-01-05 21:30:00",3619,920,4539
"2020-01-04 10:11:36","2020-01-05 22:00:00","2020-01-05 22:30:00",3287,832,4119
"2020-01-05 10:11:31","2020-01-05 23:00:00","2020-01-05 23:30:00",3059,778,3837
"2020-01-05 10:11:31","2020-01-06 00:00:00","2020-01-06 00:30:00",2883,645,3528
"2020-01-05 10:11:31","2020-01-06 01:00:00","2020-01-06 01:30:00",2668,569,3237
"2020-01-05 10:11:31","2020-01-06 02:00:00","2020-01-06 02:30:00",2550,546,3096
"2020-01-05 10:11:31","2020-01-06 03:00:00","2020-01-06 03:30:00",2452,515,2967
"2020-01-05 10:11:31","2020-01-06 04:00:00","2020-01-06 04:30:00",2452,500,2952
"2020-01-05 10:11:31","2020-01-06 05:00:00","2020-01-06 05:30:00",2488,509,2997
"2020-01-05 10:11:31","2020-01-06 06:00:00","2020-01-06 06:30:00",2677,550,3227
"2020-01-05 10:11:31","2020-01-06 07:00:00","2020-01-06 07:30:00",3199,646,3845
"2020-01-05 10:11:31","2020-01-06 08:00:00","2020-01-06 08:30:00",3830,787,4617
"2020-01-05 10:11:31","2020-01-06 09:00:00","2020-01-06 09:30:00",3865,883,4748
"2020-01-05 10:11:31","2020-01-06 10:00:00","2020-01-06 10:30:00",3917,942,4859
"2020-01-05 10:11:31","2020-01-06 11:00:00","2020-01-06 11:30:00",3946,1028,4974
"2020-01-05 10:11:31","2020-01-06 12:00:00","2020-01-06 12:30:00",4044,1040,5084
"2020-01-05 10:11:31","2020-01-06 13:00:00","2020-01-06 13:30:00",4091,1082,5173
"2020-01-05 10:11:31","2020-01-06 14:00:00","2020-01-06 14:30:00",4048,1019,5067
"2020-01-05 10:11:31","2020-01-06 15:00:00","2020-01-06 15:30:00",4096,1012,5108
"2020-01-05 10:11:31","2020-01-06 16:00:00","2020-01-06 16:30:00",4199,1041,5240
"2020-01-05 10:11:31","2020-01-06 17:00:00","2020-01-06 17:30:00",4642,1174,5816
"2020-01-05 10:11:31","2020-01-06 18:00:00","2020-01-06 18:30:00",4720,1215,5935
"2020-01-05 10:11:31","2020-01-06 19:00:00","2020-01-06 19:30:00",4461,1117,5578
"2020-01-05 10:11:31","2020-01-06 20:00:00","2020-01-06 20:30:00",4231,1018,5249
"2020-01-05 10:11:31","2020-01-06 21:00:00","2020-01-06 21:30:00",3985,962,4947
"2020-01-05 10:11:31","2020-01-06 22:00:00","2020-01-06 22:30:00",3572,853,4425
"2020-01-06 10:11:25","2020-01-06 23:00:00","2020-01-06 23:30:00",3276,774,4050
"2020-01-06 10:11:25","2020-01-07 00:00:00","2020-01-07 00:30:00",3159,691,3850
"2020-01-06 10:11:25","2020-01-07 01:00:00","2020-01-07 01:30:00",2903,628,3531
"2020-01-06 10:11:25","2020-01-07 02:00:00","2020-01-07 02:30:00",2717,598,3315
"2020-01-06 10:11:25","2020-01-07 03:00:00","2020-01-07 03:30:00",2629,555,3184
"2020-01-06 10:11:25","2020-01-07 04:00:00","2020-01-07 04:30:00",2611,543,3154
"2020-01-06 10:11:25","2020-01-07 05:00:00","2020-01-07 05:30:00",2615,540,3155
"2020-01-06 10:11:25","2020-01-07 06:00:00","2020-01-07 06:30:00",2802,584,3386
"2020-01-06 10:11:25","2020-01-07 07:00:00","2020-01-07 07:30:00",3325,660,3985
"2020-01-06 10:11:25","2020-01-07 08:00:00","2020-01-07 08:30:00",3961,769,4730
"2020-01-06 10:11:25","2020-01-07 09:00:00","2020-01-07 09:30:00",3969,858,4827
"2020-01-06 10:11:25","2020-01-07 10:00:00","2020-01-07 10:30:00",4037,949,4986
"2020-01-06 10:11:25","2020-01-07 11:00:00","2020-01-07 11:30:00",4061,1002,5063
"2020-01-06 10:11:25","2020-01-07 12:00:00","2020-01-07 12:30:00",4063,1044,5107
"2020-01-06 10:11:25","2020-01-07 13:00:00","2020-01-07 13:30:00",4079,1062,5141
"2020-01-06 10:11:25","2020-01-07 14:00:00","2020-01-07 14:30:00",4026,1048,5074
"2020-01-06 10:11:25","2020-01-07 15:00:00","2020-01-07 15:30:00",4075,1036,5111
"2020-01-06 10:11:25","2020-01-07 16:00:00","2020-01-07 16:30:00",4223,1071,5294
"2020-01-06 10:11:25","2020-01-07 17:00:00","2020-01-07 17:30:00",4650,1210,5860
"2020-01-06 10:11:25","2020-01-07 18:00:00","2020-01-07 18:30:00",4781,1190,5971
"2020-01-06 10:11:25","2020-01-07 19:00:00","2020-01-07 19:30:00",4570,1107,5677
"2020-01-06 10:11:25","2020-01-07 20:00:00","2020-01-07 20:30:00",4328,1008,5336
"2020-01-06 10:11:25","2020-01-07 21:00:00","2020-01-07 21:30:00",4071,965,5036
"2020-01-06 10:11:25","2020-01-07 22:00:00","2020-01-07 22:30:00",3675,872,4547
"2020-01-07 10:11:20","2020-01-07 23:00:00","2020-01-07 23:30:00",3335,787,4122
"2020-01-07 10:11:20","2020-01-08 00:00:00","2020-01-08 00:30:00",3169,695,3864
"2020-01-07 10:11:20","2020-01-08 01:00:00","2020-01-08 01:30:00",2922,630,3552
"2020-01-07 10:11:20","2020-01-08 02:00:00","2020-01-08 02:30:00",2742,601,3343
"2020-01-07 10:11:20","2020-01-08 03:00:00","2020-01-08 03:30:00",2658,572,3230
"2020-01-07 10:11:20","2020-01-08 04:00:00","2020-01-08 04:30:00",2641,581,3222
"2020-01-07 10:11:20","2020-01-08 05:00:00","2020-01-08 05:30:00",2644,570,3214
"2020-01-07 10:11:20","2020-01-08 06:00:00","2020-01-08 06:30:00",2824,624,3448
"2020-01-07 10:11:20","2020-01-08 07:00:00","2020-01-08 07:30:00",3329,706,4035
"2020-01-07 10:11:20","2020-01-08 08:00:00","2020-01-08 08:30:00",3941,822,4763
"2020-01-07 10:11:20","2020-01-08 09:00:00","2020-01-08 09:30:00",3949,921,4870
"2020-01-07 10:11:20","2020-01-08 10:00:00","2020-01-08 10:30:00",4015,1048,5063
"2020-01-07 10:11:20","2020-01-08 11:00:00","2020-01-08 11:30:00",4038,1091,5129
"2020-01-07 10:11:20","2020-01-08 12:00:00","2020-01-08 12:30:00",4040,1152,5192
"2020-01-07 10:11:20","2020-01-08 13:00:00","2020-01-08 13:30:00",4056,1161,5217
"2020-01-07 10:11:20","2020-01-08 14:00:00","2020-01-08 14:30:00",4004,1140,5144
"2020-01-07 10:11:20","2020-01-08 15:00:00","2020-01-08 15:30:00",4051,1128,5179
"2020-01-07 10:11:20","2020-01-08 16:00:00","2020-01-08 16:30:00",4194,1180,5374
"2020-01-07 10:11:20","2020-01-08 17:00:00","2020-01-08 17:30:00",4605,1391,5996
"2020-01-07 10:11:20","2020-01-08 18:00:00","2020-01-08 18:30:00",4690,1377,6067
"2020-01-07 10:11:20","2020-01-08 19:00:00","2020-01-08 19:30:00",4528,1252,5780
"2020-01-07 10:11:20","2020-01-08 20:00:00","2020-01-08 20:30:00",4295,1174,5469
"2020-01-07 10:11:20","2020-01-08 21:00:00","2020-01-08 21:30:00",4048,1099,5147
"2020-01-07 10:11:20","2020-01-08 22:00:00","2020-01-08 22:30:00",3666,982,4648
"2020-01-08 10:11:15","2020-01-08 23:00:00","2020-01-08 23:30:00",3355,884,4239
"2020-01-08 10:11:15","2020-01-09 00:00:00","2020-01-09 00:30:00",3199,728,3927
"2020-01-08 10:11:15","2020-01-09 01:00:00","2020-01-09 01:30:00",2939,657,3596
"2020-01-08 10:11:15","2020-01-09 02:00:00","2020-01-09 02:30:00",2763,638,3401
"2020-01-08 10:11:15","2020-01-09 03:00:00","2020-01-09 03:30:00",2659,598,3257
"2020-01-08 10:11:15","2020-01-09 04:00:00","2020-01-09 04:30:00",2638,594,3232
"2020-01-08 10:11:15","2020-01-09 05:00:00","2020-01-09 05:30:00",2650,594,3244
"2020-01-08 10:11:15","2020-01-09 06:00:00","2020-01-09 06:30:00",2853,654,3507
"2020-01-08 10:11:15","2020-01-09 07:00:00","2020-01-09 07:30:00",3366,822,4188
"2020-01-08 10:11:15","2020-01-09 08:00:00","2020-01-09 08:30:00",3962,1014,4976
"2020-01-08 10:11:15","2020-01-09 09:00:00","2020-01-09 09:30:00",4016,1103,5119
"2020-01-08 10:11:15","2020-01-09 10:00:00","2020-01-09 10:30:00",4102,1170,5272
"2020-01-08 10:11:15","2020-01-09 11:00:00","2020-01-09 11:30:00",4102,1187,5289
"2020-01-08 10:11:15","2020-01-09 12:00:00","2020-01-09 12:30:00",4103,1201,5304
"2020-01-08 10:11:15","2020-01-09 13:00:00","2020-01-09 13:30:00",4124,1217,5341
"2020-01-08 10:11:15","2020-01-09 14:00:00","2020-01-09 14:30:00",4040,1154,5194
"2020-01-08 10:11:15","2020-01-09 15:00:00","2020-01-09 15:30:00",4053,1153,5206
"2020-01-08 10:11:15","2020-01-09 16:00:00","2020-01-09 16:30:00",4176,1223,5399
"2020-01-08 10:11:15","2020-01-09 17:00:00","2020-01-09 17:30:00",4602,1416,6018
"2020-01-08 10:11:15","2020-01-09 18:00:00","2020-01-09 18:30:00",4690,1388,6078
"2020-01-08 10:11:15","2020-01-09 19:00:00","2020-01-09 19:30:00",4587,1285,5872
"2020-01-08 10:11:15","2020-01-09 20:00:00","2020-01-09 20:30:00",4361,1189,5550
"2020-01-08 10:11:15","2020-01-09 21:00:00","2020-01-09 21:30:00",4105,1111,5216
"2020-01-08 10:11:15","2020-01-09 22:00:00","2020-01-09 22:30:00",3710,988,4698
"2020-01-09 10:11:31","2020-01-09 23:00:00","2020-01-09 23:30:00",3471,875,4346
"2020-01-09 10:11:31","2020-01-10 00:00:00","2020-01-10 00:30:00",3182,826,4008
"2020-01-09 10:11:31","2020-01-10 01:00:00","2020-01-10 01:30:00",2933,731,3664
"2020-01-09 10:11:31","2020-01-10 02:00:00","2020-01-10 02:30:00",2760,706,3466
"2020-01-09 10:11:31","2020-01-10 03:00:00","2020-01-10 03:30:00",2663,666,3329
"2020-01-09 10:11:31","2020-01-10 04:00:00","2020-01-10 04:30:00",2637,652,3289
"2020-01-09 10:11:31","2020-01-10 05:00:00","2020-01-10 05:30:00",2636,666,3302
"2020-01-09 10:11:31","2020-01-10 06:00:00","2020-01-10 06:30:00",2812,726,3538
"2020-01-09 10:11:31","2020-01-10 07:00:00","2020-01-10 07:30:00",3344,882,4226
"2020-01-09 10:11:31","2020-01-10 08:00:00","2020-01-10 08:30:00",3938,1101,5039
"2020-01-09 10:11:31","2020-01-10 09:00:00","2020-01-10 09:30:00",3979,1192,5171
"2020-01-09 10:11:31","2020-01-10 10:00:00","2020-01-10 10:30:00",4032,1216,5248
"2020-01-09 10:11:31","2020-01-10 11:00:00","2020-01-10 11:30:00",4030,1275,5305
"2020-01-09 10:11:31","2020-01-10 12:00:00","2020-01-10 12:30:00",4036,1252,5288
"2020-01-09 10:11:31","2020-01-10 13:00:00","2020-01-10 13:30:00",4020,1244,5264
"2020-01-09 10:11:31","2020-01-10 14:00:00","2020-01-10 14:30:00",3935,1185,5120
"2020-01-09 10:11:31","2020-01-10 15:00:00","2020-01-10 15:30:00",3958,1171,5129
"2020-01-09 10:11:31","2020-01-10 16:00:00","2020-01-10 16:30:00",4032,1161,5193
"2020-01-09 10:11:31","2020-01-10 17:00:00","2020-01-10 17:30:00",4413,1386,5799
"2020-01-09 10:11:31","2020-01-10 18:00:00","2020-01-10 18:30:00",4550,1405,5955
"2020-01-09 10:11:31","2020-01-10 19:00:00","2020-01-10 19:30:00",4378,1307,5685
"2020-01-09 10:11:31","2020-01-10 20:00:00","2020-01-10 20:30:00",4164,1182,5346
"2020-01-09 10:11:31","2020-01-10 21:00:00","2020-01-10 21:30:00",3911,1118,5029
"2020-01-09 10:11:31","2020-01-10 22:00:00","2020-01-10 22:30:00",3643,994,4637
"2020-01-10 10:11:15","2020-01-10 23:00:00","2020-01-10 23:30:00",3518,882,4400
"2020-01-10 10:11:15","2020-01-11 00:00:00","2020-01-11 00:30:00",3320,739,4059
"2020-01-10 10:11:15","2020-01-11 01:00:00","2020-01-11 01:30:00",3101,662,3763
"2020-01-10 10:11:15","2020-01-11 02:00:00","2020-01-11 02:30:00",2892,625,3517
"2020-01-10 10:11:15","2020-01-11 03:00:00","2020-01-11 03:30:00",2755,596,3351
"2020-01-10 10:11:15","2020-01-11 04:00:00","2020-01-11 04:30:00",2728,587,3315
"2020-01-10 10:11:15","2020-01-11 05:00:00","2020-01-11 05:30:00",2729,582,3311
"2020-01-10 10:11:15","2020-01-11 06:00:00","2020-01-11 06:30:00",2769,616,3385
"2020-01-10 10:11:15","2020-01-11 07:00:00","2020-01-11 07:30:00",2935,696,3631
"2020-01-10 10:11:15","2020-01-11 08:00:00","2020-01-11 08:30:00",3180,803,3983
"2020-01-10 10:11:15","2020-01-11 09:00:00","2020-01-11 09:30:00",3465,908,4373
"2020-01-10 10:11:15","2020-01-11 10:00:00","2020-01-11 10:30:00",3715,1000,4715
"2020-01-10 10:11:15","2020-01-11 11:00:00","2020-01-11 11:30:00",3860,1055,4915
"2020-01-10 10:11:15","2020-01-11 12:00:00","2020-01-11 12:30:00",3895,1092,4987
"2020-01-10 10:11:15","2020-01-11 13:00:00","2020-01-11 13:30:00",3915,1127,5042
"2020-01-10 10:11:15","2020-01-11 14:00:00","2020-01-11 14:30:00",3835,1082,4917
"2020-01-10 10:11:15","2020-01-11 15:00:00","2020-01-11 15:30:00",3753,1090,4843
"2020-01-10 10:11:15","2020-01-11 16:00:00","2020-01-11 16:30:00",3809,1117,4926
"2020-01-10 10:11:15","2020-01-11 17:00:00","2020-01-11 17:30:00",4204,1325,5529
"2020-01-10 10:11:15","2020-01-11 18:00:00","2020-01-11 18:30:00",4380,1353,5733
"2020-01-10 10:11:15","2020-01-11 19:00:00","2020-01-11 19:30:00",4177,1243,5420
"2020-01-10 10:11:15","2020-01-11 20:00:00","2020-01-11 20:30:00",3946,1148,5094
"2020-01-10 10:11:15","2020-01-11 21:00:00","2020-01-11 21:30:00",3761,1070,4831
"2020-01-10 10:11:15","2020-01-11 22:00:00","2020-01-11 22:30:00",3520,978,4498
"2020-01-11 10:11:06","2020-01-11 23:00:00","2020-01-11 23:30:00",3383,774,4157
"2020-01-11 10:11:06","2020-01-12 00:00:00","2020-01-12 00:30:00",3276,770,4046
"2020-01-11 10:11:06","2020-01-12 01:00:00","2020-01-12 01:30:00",3023,701,3724
"2020-01-11 10:11:06","2020-01-12 02:00:00","2020-01-12 02:30:00",2838,672,3510
"2020-01-11 10:11:06","2020-01-12 03:00:00","2020-01-12 03:30:00",2693,626,3319
"2020-01-11 10:11:06","2020-01-12 04:00:00","2020-01-12 04:30:00",2645,609,3254
"2020-01-11 10:11:06","2020-01-12 05:00:00","2020-01-12 05:30:00",2626,610,3236
"2020-01-11 10:11:06","2020-01-12 06:00:00","2020-01-12 06:30:00",2649,623,3272
"2020-01-11 10:11:06","2020-01-12 07:00:00","2020-01-12 07:30:00",2728,689,3417
"2020-01-11 10:11:06","2020-01-12 08:00:00","2020-01-12 08:30:00",2866,794,3660
"2020-01-11 10:11:06","2020-01-12 09:00:00","2020-01-12 09:30:00",3029,878,3907
"2020-01-11 10:11:06","2020-01-12 10:00:00","2020-01-12 10:30:00",3365,949,4314
"2020-01-11 10:11:06","2020-01-12 11:00:00","2020-01-12 11:30:00",3592,1025,4617
"2020-01-11 10:11:06","2020-01-12 12:00:00","2020-01-12 12:30:00",3747,1112,4859
"2020-01-11 10:11:06","2020-01-12 13:00:00","2020-01-12 13:30:00",3830,1141,4971
"2020-01-11 10:11:06","2020-01-12 14:00:00","2020-01-12 14:30:00",3757,1111,4868
"2020-01-11 10:11:06","2020-01-12 15:00:00","2020-01-12 15:30:00",3711,1092,4803
"2020-01-11 10:11:06","2020-01-12 16:00:00","2020-01-12 16:30:00",3757,1145,4902
"2020-01-11 10:11:06","2020-01-12 17:00:00","2020-01-12 17:30:00",4119,1358,5477
"2020-01-11 10:11:06","2020-01-12 18:00:00","2020-01-12 18:30:00",4330,1329,5659
"2020-01-11 10:11:06","2020-01-12 19:00:00","2020-01-12 19:30:00",4181,1266,5447
"2020-01-11 10:11:06","2020-01-12 20:00:00","2020-01-12 20:30:00",3967,1192,5159
"2020-01-11 10:11:06","2020-01-12 21:00:00","2020-01-12 21:30:00",3777,1069,4846
"2020-01-11 10:11:06","2020-01-12 22:00:00","2020-01-12 22:30:00",3433,964,4397
"2020-01-12 10:11:26","2020-01-12 23:00:00","2020-01-12 23:30:00",3064,768,3832
"2020-01-12 10:11:26","2020-01-13 00:00:00","2020-01-13 00:30:00",3079,704,3783
"2020-01-12 10:11:26","2020-01-13 01:00:00","2020-01-13 01:30:00",2894,640,3534
"2020-01-12 10:11:26","2020-01-13 02:00:00","2020-01-13 02:30:00",2721,619,3340
"2020-01-12 10:11:26","2020-01-13 03:00:00","2020-01-13 03:30:00",2640,576,3216
"2020-01-12 10:11:26","2020-01-13 04:00:00","2020-01-13 04:30:00",2624,591,3215
"2020-01-12 10:11:26","2020-01-13 05:00:00","2020-01-13 05:30:00",2663,603,3266
"2020-01-12 10:11:26","2020-01-13 06:00:00","2020-01-13 06:30:00",2841,673,3514
"2020-01-12 10:11:26","2020-01-13 07:00:00","2020-01-13 07:30:00",3366,868,4234
"2020-01-12 10:11:26","2020-01-13 08:00:00","2020-01-13 08:30:00",3985,1074,5059
"2020-01-12 10:11:26","2020-01-13 09:00:00","2020-01-13 09:30:00",4028,1156,5184
"2020-01-12 10:11:26","2020-01-13 10:00:00","2020-01-13 10:30:00",4129,1239,5368
"2020-01-12 10:11:26","2020-01-13 11:00:00","2020-01-13 11:30:00",4139,1278,5417
"2020-01-12 10:11:26","2020-01-13 12:00:00","2020-01-13 12:30:00",4186,1272,5458
"2020-01-12 10:11:26","2020-01-13 13:00:00","2020-01-13 13:30:00",4209,1238,5447
"2020-01-12 10:11:26","2020-01-13 14:00:00","2020-01-13 14:30:00",4122,1196,5318
"2020-01-12 10:11:26","2020-01-13 15:00:00","2020-01-13 15:30:00",4153,1220,5373
"2020-01-12 10:11:26","2020-01-13 16:00:00","2020-01-13 16:30:00",4262,1276,5538
"2020-01-12 10:11:26","2020-01-13 17:00:00","2020-01-13 17:30:00",4674,1528,6202
"2020-01-12 10:11:26","2020-01-13 18:00:00","2020-01-13 18:30:00",4828,1514,6342
"2020-01-12 10:11:26","2020-01-13 19:00:00","2020-01-13 19:30:00",4632,1376,6008
"2020-01-12 10:11:26","2020-01-13 20:00:00","2020-01-13 20:30:00",4405,1311,5716
"2020-01-12 10:11:26","2020-01-13 21:00:00","2020-01-13 21:30:00",4112,1203,5315
"2020-01-12 10:11:26","2020-01-13 22:00:00","2020-01-13 22:30:00",3735,1061,4796
"2020-01-13 10:11:16","2020-01-13 23:00:00","2020-01-13 23:30:00",3276,801,4077
"2020-01-13 10:11:16","2020-01-14 00:00:00","2020-01-14 00:30:00",3160,762,3922
"2020-01-13 10:11:16","2020-01-14 01:00:00","2020-01-14 01:30:00",2973,703,3676
"2020-01-13 10:11:16","2020-01-14 02:00:00","2020-01-14 02:30:00",2805,671,3476
"2020-01-13 10:11:16","2020-01-14 03:00:00","2020-01-14 03:30:00",2710,662,3372
"2020-01-13 10:11:16","2020-01-14 04:00:00","2020-01-14 04:30:00",2711,654,3365
"2020-01-13 10:11:16","2020-01-14 05:00:00","2020-01-14 05:30:00",2738,667,3405
"2020-01-13 10:11:16","2020-01-14 06:00:00","2020-01-14 06:30:00",2945,732,3677
"2020-01-13 10:11:16","2020-01-14 07:00:00","2020-01-14 07:30:00",3476,931,4407
"2020-01-13 10:11:16","2020-01-14 08:00:00","2020-01-14 08:30:00",4054,1167,5221
"2020-01-13 10:11:16","2020-01-14 09:00:00","2020-01-14 09:30:00",4128,1201,5329
"2020-01-13 10:11:16","2020-01-14 10:00:00","2020-01-14 10:30:00",4234,1235,5469
"2020-01-13 10:11:16","2020-01-14 11:00:00","2020-01-14 11:30:00",4258,1242,5500
"2020-01-13 10:11:16","2020-01-14 12:00:00","2020-01-14 12:30:00",4266,1271,5537
"2020-01-13 10:11:16","2020-01-14 13:00:00","2020-01-14 13:30:00",4282,1273,5555
"2020-01-13 10:11:16","2020-01-14 14:00:00","2020-01-14 14:30:00",4212,1217,5429
"2020-01-13 10:11:16","2020-01-14 15:00:00","2020-01-14 15:30:00",4244,1261,5505
"2020-01-13 10:11:16","2020-01-14 16:00:00","2020-01-14 16:30:00",4364,1322,5686
"2020-01-13 10:11:16","2020-01-14 17:00:00","2020-01-14 17:30:00",4757,1522,6279
"2020-01-13 10:11:16","2020-01-14 18:00:00","2020-01-14 18:30:00",4851,1490,6341
"2020-01-13 10:11:16","2020-01-14 19:00:00","2020-01-14 19:30:00",4635,1364,5999
"2020-01-13 10:11:16","2020-01-14 20:00:00","2020-01-14 20:30:00",4395,1273,5668
"2020-01-13 10:11:16","2020-01-14 21:00:00","2020-01-14 21:30:00",4113,1156,5269
"2020-01-13 10:11:16","2020-01-14 22:00:00","2020-01-14 22:30:00",3809,1011,4820
"2020-01-14 10:11:10","2020-01-14 23:00:00","2020-01-14 23:30:00",3402,889,4291
"2020-01-14 10:11:10","2020-01-15 00:00:00","2020-01-15 00:30:00",3209,763,3972
"2020-01-14 10:11:10","2020-01-15 01:00:00","2020-01-15 01:30:00",2953,695,3648
"2020-01-14 10:11:10","2020-01-15 02:00:00","2020-01-15 02:30:00",2767,675,3442
"2020-01-14 10:11:10","2020-01-15 03:00:00","2020-01-15 03:30:00",2679,659,3338
"2020-01-14 10:11:10","2020-01-15 04:00:00","2020-01-15 04:30:00",2661,653,3314
"2020-01-14 10:11:10","2020-01-15 05:00:00","2020-01-15 05:30:00",2665,672,3337
"2020-01-14 10:11:10","2020-01-15 06:00:00","2020-01-15 06:30:00",2852,727,3579
"2020-01-14 10:11:10","2020-01-15 07:00:00","2020-01-15 07:30:00",3375,914,4289
"2020-01-14 10:11:10","2020-01-15 08:00:00","2020-01-15 08:30:00",4011,1158,5169
"2020-01-14 10:11:10","2020-01-15 09:00:00","2020-01-15 09:30:00",4019,1175,5194
"2020-01-14 10:11:10","2020-01-15 10:00:00","2020-01-15 10:30:00",4087,1207,5294
"2020-01-14 10:11:10","2020-01-15 11:00:00","2020-01-15 11:30:00",4111,1190,5301
"2020-01-14 10:11:10","2020-01-15 12:00:00","2020-01-15 12:30:00",4113,1221,5334
"2020-01-14 10:11:10","2020-01-15 13:00:00","2020-01-15 13:30:00",4129,1228,5357
"2020-01-14 10:11:10","2020-01-15 14:00:00","2020-01-15 14:30:00",4076,1191,5267
"2020-01-14 10:11:10","2020-01-15 15:00:00","2020-01-15 15:30:00",4125,1223,5348
"2020-01-14 10:11:10","2020-01-15 16:00:00","2020-01-15 16:30:00",4273,1275,5548
"2020-01-14 10:11:10","2020-01-15 17:00:00","2020-01-15 17:30:00",4700,1464,6164
"2020-01-14 10:11:10","2020-01-15 18:00:00","2020-01-15 18:30:00",4831,1448,6279
"2020-01-14 10:11:10","2020-01-15 19:00:00","2020-01-15 19:30:00",4620,1323,5943
"2020-01-14 10:11:10","2020-01-15 20:00:00","2020-01-15 20:30:00",4378,1261,5639
"2020-01-14 10:11:10","2020-01-15 21:00:00","2020-01-15 21:30:00",4121,1150,5271
"2020-01-14 10:11:10","2020-01-15 22:00:00","2020-01-15 22:30:00",3725,999,4724
"2020-01-15 10:11:31","2020-01-15 23:00:00","2020-01-15 23:30:00",3402,799,4201
"2020-01-15 10:11:31","2020-01-16 00:00:00","2020-01-16 00:30:00",3129,683,3812
"2020-01-15 10:11:31","2020-01-16 01:00:00","2020-01-16 01:30:00",2954,648,3602
"2020-01-15 10:11:31","2020-01-16 02:00:00","2020-01-16 02:30:00",2798,618,3416
"2020-01-15 10:11:31","2020-01-16 03:00:00","2020-01-16 03:30:00",2710,603,3313
"2020-01-15 10:11:31","2020-01-16 04:00:00","2020-01-16 04:30:00",2711,590,3301
"2020-01-15 10:11:31","2020-01-16 05:00:00","2020-01-16 05:30:00",2735,607,3342
"2020-01-15 10:11:31","2020-01-16 06:00:00","2020-01-16 06:30:00",2928,683,3611
"2020-01-15 10:11:31","2020-01-16 07:00:00","2020-01-16 07:30:00",3423,884,4307
"2020-01-15 10:11:31","2020-01-16 08:00:00","2020-01-16 08:30:00",3962,1108,5070
"2020-01-15 10:11:31","2020-01-16 09:00:00","2020-01-16 09:30:00",4031,1149,5180
"2020-01-15 10:11:31","2020-01-16 10:00:00","2020-01-16 10:30:00",4130,1194,5324
"2020-01-15 10:11:31","2020-01-16 11:00:00","2020-01-16 11:30:00",4152,1195,5347
"2020-01-15 10:11:31","2020-01-16 12:00:00","2020-01-16 12:30:00",4160,1218,5378
"2020-01-15 10:11:31","2020-01-16 13:00:00","2020-01-16 13:30:00",4174,1213,5387
"2020-01-15 10:11:31","2020-01-16 14:00:00","2020-01-16 14:30:00",4109,1178,5287
"2020-01-15 10:11:31","2020-01-16 15:00:00","2020-01-16 15:30:00",4139,1198,5337
"2020-01-15 10:11:31","2020-01-16 16:00:00","2020-01-16 16:30:00",4251,1236,5487
"2020-01-15 10:11:31","2020-01-16 17:00:00","2020-01-16 17:30:00",4617,1392,6009
"2020-01-15 10:11:31","2020-01-16 18:00:00","2020-01-16 18:30:00",4704,1401,6105
"2020-01-15 10:11:31","2020-01-16 19:00:00","2020-01-16 19:30:00",4503,1276,5779
"2020-01-15 10:11:31","2020-01-16 20:00:00","2020-01-16 20:30:00",4279,1227,5506
"2020-01-15 10:11:31","2020-01-16 21:00:00","2020-01-16 21:30:00",4017,1128,5145
"2020-01-15 10:11:31","2020-01-16 22:00:00","2020-01-16 22:30:00",3734,986,4720
"2020-01-16 10:11:21","2020-01-16 23:00:00","2020-01-16 23:30:00",3381,812,4193
"2020-01-16 10:11:21","2020-01-17 00:00:00","2020-01-17 00:30:00",3533,717,4250
"2020-01-16 10:11:21","2020-01-17 01:00:00","2020-01-17 01:30:00",3291,676,3967
"2020-01-16 10:11:21","2020-01-17 02:00:00","2020-01-17 02:30:00",3061,667,3728
"2020-01-16 10:11:21","2020-01-17 03:00:00","2020-01-17 03:30:00",2911,666,3577
"2020-01-16 10:11:21","2020-01-17 04:00:00","2020-01-17 04:30:00",2880,662,3542
"2020-01-16 10:11:21","2020-01-17 05:00:00","2020-01-17 05:30:00",2882,686,3568
"2020-01-16 10:11:21","2020-01-17 06:00:00","2020-01-17 06:30:00",2926,745,3671
"2020-01-16 10:11:21","2020-01-17 07:00:00","2020-01-17 07:30:00",3109,913,4022
"2020-01-16 10:11:21","2020-01-17 08:00:00","2020-01-17 08:30:00",3379,1155,4534
"2020-01-16 10:11:21","2020-01-17 09:00:00","2020-01-17 09:30:00",3693,1195,4888
"2020-01-16 10:11:21","2020-01-17 10:00:00","2020-01-17 10:30:00",3967,1219,5186
"2020-01-16 10:11:21","2020-01-17 11:00:00","2020-01-17 11:30:00",4127,1264,5391
"2020-01-16 10:11:21","2020-01-17 12:00:00","2020-01-17 12:30:00",4166,1265,5431
"2020-01-16 10:11:21","2020-01-17 13:00:00","2020-01-17 13:30:00",4188,1225,5413
"2020-01-16 10:11:21","2020-01-17 14:00:00","2020-01-17 14:30:00",4100,1164,5264
"2020-01-16 10:11:21","2020-01-17 15:00:00","2020-01-17 15:30:00",4009,1187,5196
"2020-01-16 10:11:21","2020-01-17 16:00:00","2020-01-17 16:30:00",4072,1235,5307
"2020-01-16 10:11:21","2020-01-17 17:00:00","2020-01-17 17:30:00",4506,1429,5935
"2020-01-16 10:11:21","2020-01-17 18:00:00","2020-01-17 18:30:00",4700,1422,6122
"2020-01-16 10:11:21","2020-01-17 19:00:00","2020-01-17 19:30:00",4477,1314,5791
"2020-01-16 10:11:21","2020-01-17 20:00:00","2020-01-17 20:30:00",4223,1238,5461
"2020-01-16 10:11:21","2020-01-17 21:00:00","2020-01-17 21:30:00",4018,1118,5136
"2020-01-16 10:11:21","2020-01-17 22:00:00","2020-01-17 22:30:00",3753,1017,4770
"2020-01-17 10:11:05","2020-01-17 23:00:00","2020-01-17 23:30:00",3580,820,4400
"2020-01-17 10:11:05","2020-01-18 00:00:00","2020-01-18 00:30:00",3366,749,4115
"2020-01-17 10:11:05","2020-01-18 01:00:00","2020-01-18 01:30:00",3106,681,3787
"2020-01-17 10:11:05","2020-01-18 02:00:00","2020-01-18 02:30:00",2888,645,3533
"2020-01-17 10:11:05","2020-01-18 03:00:00","2020-01-18 03:30:00",2774,608,3382
"2020-01-17 10:11:05","2020-01-18 04:00:00","2020-01-18 04:30:00",2725,602,3327
"2020-01-17 10:11:05","2020-01-18 05:00:00","2020-01-18 05:30:00",2700,618,3318
"2020-01-17 10:11:05","2020-01-18 06:00:00","2020-01-18 06:30:00",2764,651,3415
"2020-01-17 10:11:05","2020-01-18 07:00:00","2020-01-18 07:30:00",2928,749,3677
"2020-01-17 10:11:05","2020-01-18 08:00:00","2020-01-18 08:30:00",3178,931,4109
"2020-01-17 10:11:05","2020-01-18 09:00:00","2020-01-18 09:30:00",3468,1064,4532
"2020-01-17 10:11:05","2020-01-18 10:00:00","2020-01-18 10:30:00",3755,1175,4930
"2020-01-17 10:11:05","2020-01-18 11:00:00","2020-01-18 11:30:00",3878,1176,5054
"2020-01-17 10:11:05","2020-01-18 12:00:00","2020-01-18 12:30:00",3920,1176,5096
"2020-01-17 10:11:05","2020-01-18 13:00:00","2020-01-18 13:30:00",3918,1167,5085
"2020-01-17 10:11:05","2020-01-18 14:00:00","2020-01-18 14:30:00",3810,1112,4922
"2020-01-17 10:11:05","2020-01-18 15:00:00","2020-01-18 15:30:00",3774,1110,4884
"2020-01-17 10:11:05","2020-01-18 16:00:00","2020-01-18 16:30:00",3844,1127,4971
"2020-01-17 10:11:05","2020-01-18 17:00:00","2020-01-18 17:30:00",4167,1323,5490
"2020-01-17 10:11:05","2020-01-18 18:00:00","2020-01-18 18:30:00",4400,1356,5756
"2020-01-17 10:11:05","2020-01-18 19:00:00","2020-01-18 19:30:00",4203,1243,5446
"2020-01-17 10:11:05","2020-01-18 20:00:00","2020-01-18 20:30:00",3978,1180,5158
"2020-01-17 10:11:05","2020-01-18 21:00:00","2020-01-18 21:30:00",3735,1115,4850
"2020-01-17 10:11:05","2020-01-18 22:00:00","2020-01-18 22:30:00",3501,1030,4531
"2020-01-18 10:11:26","2020-01-18 23:00:00","2020-01-18 23:30:00",3344,878,4222
"2020-01-18 10:11:26","2020-01-19 00:00:00","2020-01-19 00:30:00",3294,809,4103
"2020-01-18 10:11:26","2020-01-19 01:00:00","2020-01-19 01:30:00",3059,743,3802
"2020-01-18 10:11:26","2020-01-19 02:00:00","2020-01-19 02:30:00",2834,728,3562
"2020-01-18 10:11:26","2020-01-19 03:00:00","2020-01-19 03:30:00",2735,665,3400
"2020-01-18 10:11:26","2020-01-19 04:00:00","2020-01-19 04:30:00",2703,647,3350
"2020-01-18 10:11:26","2020-01-19 05:00:00","2020-01-19 05:30:00",2640,637,3277
"2020-01-18 10:11:26","2020-01-19 06:00:00","2020-01-19 06:30:00",2704,662,3366
"2020-01-18 10:11:26","2020-01-19 07:00:00","2020-01-19 07:30:00",2801,744,3545
"2020-01-18 10:11:26","2020-01-19 08:00:00","2020-01-19 08:30:00",2922,837,3759
"2020-01-18 10:11:26","2020-01-19 09:00:00","2020-01-19 09:30:00",3046,922,3968
"2020-01-18 10:11:26","2020-01-19 10:00:00","2020-01-19 10:30:00",3373,1013,4386
"2020-01-18 10:11:26","2020-01-19 11:00:00","2020-01-19 11:30:00",3592,1076,4668
"2020-01-18 10:11:26","2020-01-19 12:00:00","2020-01-19 12:30:00",3723,1094,4817
"2020-01-18 10:11:26","2020-01-19 13:00:00","2020-01-19 13:30:00",3800,1116,4916
"2020-01-18 10:11:26","2020-01-19 14:00:00","2020-01-19 14:30:00",3672,1074,4746
"2020-01-18 10:11:26","2020-01-19 15:00:00","2020-01-19 15:30:00",3619,1057,4676
"2020-01-18 10:11:26","2020-01-19 16:00:00","2020-01-19 16:30:00",3626,1092,4718
"2020-01-18 10:11:26","2020-01-19 17:00:00","2020-01-19 17:30:00",3888,1259,5147
"2020-01-18 10:11:26","2020-01-19 18:00:00","2020-01-19 18:30:00",4320,1319,5639
"2020-01-18 10:11:26","2020-01-19 19:00:00","2020-01-19 19:30:00",4211,1216,5427
"2020-01-18 10:11:26","2020-01-19 20:00:00","2020-01-19 20:30:00",4039,1113,5152
"2020-01-18 10:11:26","2020-01-19 21:00:00","2020-01-19 21:30:00",3862,1015,4877
"2020-01-18 10:11:26","2020-01-19 22:00:00","2020-01-19 22:30:00",3588,938,4526
"2020-01-19 10:11:16","2020-01-19 23:00:00","2020-01-19 23:30:00",3471,817,4288
"2020-01-19 10:11:16","2020-01-20 00:00:00","2020-01-20 00:30:00",3259,691,3950
"2020-01-19 10:11:16","2020-01-20 01:00:00","2020-01-20 01:30:00",3066,633,3699
"2020-01-19 10:11:16","2020-01-20 02:00:00","2020-01-20 02:30:00",2927,623,3550
"2020-01-19 10:11:16","2020-01-20 03:00:00","2020-01-20 03:30:00",2828,588,3416
"2020-01-19 10:11:16","2020-01-20 04:00:00","2020-01-20 04:30:00",2770,587,3357
"2020-01-19 10:11:16","2020-01-20 05:00:00","2020-01-20 05:30:00",2795,588,3383
"2020-01-19 10:11:16","2020-01-20 06:00:00","2020-01-20 06:30:00",2972,684,3656
"2020-01-19 10:11:16","2020-01-20 07:00:00","2020-01-20 07:30:00",3499,909,4408
"2020-01-19 10:11:16","2020-01-20 08:00:00","2020-01-20 08:30:00",4069,1115,5184
"2020-01-19 10:11:16","2020-01-20 09:00:00","2020-01-20 09:30:00",4163,1167,5330
"2020-01-19 10:11:16","2020-01-20 10:00:00","2020-01-20 10:30:00",4275,1179,5454
"2020-01-19 10:11:16","2020-01-20 11:00:00","2020-01-20 11:30:00",4296,1163,5459
"2020-01-19 10:11:16","2020-01-20 12:00:00","2020-01-20 12:30:00",4368,1154,5522
"2020-01-19 10:11:16","2020-01-20 13:00:00","2020-01-20 13:30:00",4403,1170,5573
"2020-01-19 10:11:16","2020-01-20 14:00:00","2020-01-20 14:30:00",4391,1087,5478
"2020-01-19 10:11:16","2020-01-20 15:00:00","2020-01-20 15:30:00",4452,1211,5663
"2020-01-19 10:11:16","2020-01-20 16:00:00","2020-01-20 16:30:00",4536,1223,5759
"2020-01-19 10:11:16","2020-01-20 17:00:00","2020-01-20 17:30:00",4842,1436,6278
"2020-01-19 10:11:16","2020-01-20 18:00:00","2020-01-20 18:30:00",4938,1403,6341
"2020-01-19 10:11:16","2020-01-20 19:00:00","2020-01-20 19:30:00",4729,1259,5988
"2020-01-19 10:11:16","2020-01-20 20:00:00","2020-01-20 20:30:00",4503,1117,5620
"2020-01-19 10:11:16","2020-01-20 21:00:00","2020-01-20 21:30:00",4221,1104,5325
"2020-01-19 10:11:16","2020-01-20 22:00:00","2020-01-20 22:30:00",3864,976,4840
"2020-01-20 10:11:06","2020-01-20 23:00:00","2020-01-20 23:30:00",3652,868,4520
"2020-01-20 10:11:06","2020-01-21 00:00:00","2020-01-21 00:30:00",3403,697,4100
"2020-01-20 10:11:06","2020-01-21 01:00:00","2020-01-21 01:30:00",3206,639,3845
"2020-01-20 10:11:06","2020-01-21 02:00:00","2020-01-21 02:30:00",3072,642,3714
"2020-01-20 10:11:06","2020-01-21 03:00:00","2020-01-21 03:30:00",2989,628,3617
"2020-01-20 10:11:06","2020-01-21 04:00:00","2020-01-21 04:30:00",2913,630,3543
"2020-01-20 10:11:06","2020-01-21 05:00:00","2020-01-21 05:30:00",2937,655,3592
"2020-01-20 10:11:06","2020-01-21 06:00:00","2020-01-21 06:30:00",3145,765,3910
"2020-01-20 10:11:06","2020-01-21 07:00:00","2020-01-21 07:30:00",3670,1000,4670
"2020-01-20 10:11:06","2020-01-21 08:00:00","2020-01-21 08:30:00",4219,1220,5439
"2020-01-20 10:11:06","2020-01-21 09:00:00","2020-01-21 09:30:00",4244,1288,5532
"2020-01-20 10:11:06","2020-01-21 10:00:00","2020-01-21 10:30:00",4349,1305,5654
"2020-01-20 10:11:06","2020-01-21 11:00:00","2020-01-21 11:30:00",4352,1300,5652
"2020-01-20 10:11:06","2020-01-21 12:00:00","2020-01-21 12:30:00",4379,1275,5654
"2020-01-20 10:11:06","2020-01-21 13:00:00","2020-01-21 13:30:00",4408,1255,5663
"2020-01-20 10:11:06","2020-01-21 14:00:00","2020-01-21 14:30:00",4334,1210,5544
"2020-01-20 10:11:06","2020-01-21 15:00:00","2020-01-21 15:30:00",4376,1220,5596
"2020-01-20 10:11:06","2020-01-21 16:00:00","2020-01-21 16:30:00",4483,1328,5811
"2020-01-20 10:11:06","2020-01-21 17:00:00","2020-01-21 17:30:00",4796,1464,6260
"2020-01-20 10:11:06","2020-01-21 18:00:00","2020-01-21 18:30:00",4990,1490,6480
"2020-01-20 10:11:06","2020-01-21 19:00:00","2020-01-21 19:30:00",4828,1400,6228
"2020-01-20 10:11:06","2020-01-21 20:00:00","2020-01-21 20:30:00",4567,1300,5867
"2020-01-20 10:11:06","2020-01-21 21:00:00","2020-01-21 21:30:00",4332,1195,5527
"2020-01-20 10:11:06","2020-01-21 22:00:00","2020-01-21 22:30:00",3948,1070,5018
"2020-01-21 10:11:31","2020-01-21 23:00:00","2020-01-21 23:30:00",3630,874,4504
"2020-01-21 10:11:31","2020-01-22 00:00:00","2020-01-22 00:30:00",3403,720,4123
"2020-01-21 10:11:31","2020-01-22 01:00:00","2020-01-22 01:30:00",3206,662,3868
"2020-01-21 10:11:31","2020-01-22 02:00:00","2020-01-22 02:30:00",3072,667,3739
"2020-01-21 10:11:31","2020-01-22 03:00:00","2020-01-22 03:30:00",2989,650,3639
"2020-01-21 10:11:31","2020-01-22 04:00:00","2020-01-22 04:30:00",2913,640,3553
"2020-01-21 10:11:31","2020-01-22 05:00:00","2020-01-22 05:30:00",2937,670,3607
"2020-01-21 10:11:31","2020-01-22 06:00:00","2020-01-22 06:30:00",3145,745,3890
"2020-01-21 10:11:31","2020-01-22 07:00:00","2020-01-22 07:30:00",3670,985,4655
"2020-01-21 10:11:31","2020-01-22 08:00:00","2020-01-22 08:30:00",4219,1236,5455
"2020-01-21 10:11:31","2020-01-22 09:00:00","2020-01-22 09:30:00",4244,1262,5506
"2020-01-21 10:11:31","2020-01-22 10:00:00","2020-01-22 10:30:00",4349,1279,5628
"2020-01-21 10:11:31","2020-01-22 11:00:00","2020-01-22 11:30:00",4352,1262,5614
"2020-01-21 10:11:31","2020-01-22 12:00:00","2020-01-22 12:30:00",4379,1257,5636
"2020-01-21 10:11:31","2020-01-22 13:00:00","2020-01-22 13:30:00",4408,1237,5645
"2020-01-21 10:11:31","2020-01-22 14:00:00","2020-01-22 14:30:00",4334,1218,5552
"2020-01-21 10:11:31","2020-01-22 15:00:00","2020-01-22 15:30:00",4376,1240,5616
"2020-01-21 10:11:31","2020-01-22 16:00:00","2020-01-22 16:30:00",4483,1302,5785
"2020-01-21 10:11:31","2020-01-22 17:00:00","2020-01-22 17:30:00",4796,1480,6276
"2020-01-21 10:11:31","2020-01-22 18:00:00","2020-01-22 18:30:00",4990,1480,6470
"2020-01-21 10:11:31","2020-01-22 19:00:00","2020-01-22 19:30:00",4828,1362,6190
"2020-01-21 10:11:31","2020-01-22 20:00:00","2020-01-22 20:30:00",4567,1277,5844
"2020-01-21 10:11:31","2020-01-22 21:00:00","2020-01-22 21:30:00",4332,1190,5522
"2020-01-21 10:11:31","2020-01-22 22:00:00","2020-01-22 22:30:00",3948,1016,4964
"2020-01-22 10:11:21","2020-01-22 23:00:00","2020-01-22 23:30:00",3630,886,4516
"2020-01-22 10:11:21","2020-01-23 00:00:00","2020-01-23 00:30:00",3393,695,4088
"2020-01-22 10:11:21","2020-01-23 01:00:00","2020-01-23 01:30:00",3200,650,3850
"2020-01-22 10:11:21","2020-01-23 02:00:00","2020-01-23 02:30:00",3069,649,3718
"2020-01-22 10:11:21","2020-01-23 03:00:00","2020-01-23 03:30:00",2987,627,3614
"2020-01-22 10:11:21","2020-01-23 04:00:00","2020-01-23 04:30:00",2913,620,3533
"2020-01-22 10:11:21","2020-01-23 05:00:00","2020-01-23 05:30:00",2937,645,3582
"2020-01-22 10:11:21","2020-01-23 06:00:00","2020-01-23 06:30:00",3140,730,3870
"2020-01-22 10:11:21","2020-01-23 07:00:00","2020-01-23 07:30:00",3655,953,4608
"2020-01-22 10:11:21","2020-01-23 08:00:00","2020-01-23 08:30:00",4193,1206,5399
"2020-01-22 10:11:21","2020-01-23 09:00:00","2020-01-23 09:30:00",4219,1253,5472
"2020-01-22 10:11:21","2020-01-23 10:00:00","2020-01-23 10:30:00",4321,1289,5610
"2020-01-22 10:11:21","2020-01-23 11:00:00","2020-01-23 11:30:00",4325,1270,5595
"2020-01-22 10:11:21","2020-01-23 12:00:00","2020-01-23 12:30:00",4351,1238,5589
"2020-01-22 10:11:21","2020-01-23 13:00:00","2020-01-23 13:30:00",4379,1229,5608
"2020-01-22 10:11:21","2020-01-23 14:00:00","2020-01-23 14:30:00",4307,1192,5499
"2020-01-22 10:11:21","2020-01-23 15:00:00","2020-01-23 15:30:00",4347,1200,5547
"2020-01-22 10:11:21","2020-01-23 16:00:00","2020-01-23 16:30:00",4453,1269,5722
"2020-01-22 10:11:21","2020-01-23 17:00:00","2020-01-23 17:30:00",4760,1422,6182
"2020-01-22 10:11:21","2020-01-23 18:00:00","2020-01-23 18:30:00",4950,1487,6437
"2020-01-22 10:11:21","2020-01-23 19:00:00","2020-01-23 19:30:00",4791,1370,6161
"2020-01-22 10:11:21","2020-01-23 20:00:00","2020-01-23 20:30:00",4535,1280,5815
"2020-01-22 10:11:21","2020-01-23 21:00:00","2020-01-23 21:30:00",4304,1182,5486
"2020-01-22 10:11:21","2020-01-23 22:00:00","2020-01-23 22:30:00",3928,1032,4960
"2020-01-23 10:11:11","2020-01-23 23:00:00","2020-01-23 23:30:00",3616,901,4517
"2020-01-23 10:11:11","2020-01-24 00:00:00","2020-01-24 00:30:00",3414,756,4170
"2020-01-23 10:11:11","2020-01-24 01:00:00","2020-01-24 01:30:00",3134,714,3848
"2020-01-23 10:11:11","2020-01-24 02:00:00","2020-01-24 02:30:00",2922,706,3628
"2020-01-23 10:11:11","2020-01-24 03:00:00","2020-01-24 03:30:00",2864,678,3542
"2020-01-23 10:11:11","2020-01-24 04:00:00","2020-01-24 04:30:00",2846,678,3524
"2020-01-23 10:11:11","2020-01-24 05:00:00","2020-01-24 05:30:00",2896,700,3596
"2020-01-23 10:11:11","2020-01-24 06:00:00","2020-01-24 06:30:00",3066,776,3842
"2020-01-23 10:11:11","2020-01-24 07:00:00","2020-01-24 07:30:00",3578,969,4547
"2020-01-23 10:11:11","2020-01-24 08:00:00","2020-01-24 08:30:00",4168,1197,5365
"2020-01-23 10:11:11","2020-01-24 09:00:00","2020-01-24 09:30:00",4107,1242,5349
"2020-01-23 10:11:11","2020-01-24 10:00:00","2020-01-24 10:30:00",4175,1258,5433
"2020-01-23 10:11:11","2020-01-24 11:00:00","2020-01-24 11:30:00",4159,1222,5381
"2020-01-23 10:11:11","2020-01-24 12:00:00","2020-01-24 12:30:00",4198,1214,5412
"2020-01-23 10:11:11","2020-01-24 13:00:00","2020-01-24 13:30:00",4188,1220,5408
"2020-01-23 10:11:11","2020-01-24 14:00:00","2020-01-24 14:30:00",4120,1199,5319
"2020-01-23 10:11:11","2020-01-24 15:00:00","2020-01-24 15:30:00",4089,1206,5295
"2020-01-23 10:11:11","2020-01-24 16:00:00","2020-01-24 16:30:00",4149,1216,5365
"2020-01-23 10:11:11","2020-01-24 17:00:00","2020-01-24 17:30:00",4409,1348,5757
"2020-01-23 10:11:11","2020-01-24 18:00:00","2020-01-24 18:30:00",4720,1380,6100
"2020-01-23 10:11:11","2020-01-24 19:00:00","2020-01-24 19:30:00",4544,1292,5836
"2020-01-23 10:11:11","2020-01-24 20:00:00","2020-01-24 20:30:00",4275,1200,5475
"2020-01-23 10:11:11","2020-01-24 21:00:00","2020-01-24 21:30:00",4058,1130,5188
"2020-01-23 10:11:11","2020-01-24 22:00:00","2020-01-24 22:30:00",3720,1004,4724
"2020-01-24 10:11:30","2020-01-24 23:00:00","2020-01-24 23:30:00",3509,900,4409
"2020-01-24 10:11:30","2020-01-25 00:00:00","2020-01-25 00:30:00",3334,763,4097
"2020-01-24 10:11:30","2020-01-25 01:00:00","2020-01-25 01:30:00",3119,686,3805
"2020-01-24 10:11:30","2020-01-25 02:00:00","2020-01-25 02:30:00",2982,668,3650
"2020-01-24 10:11:30","2020-01-25 03:00:00","2020-01-25 03:30:00",2812,652,3464
"2020-01-24 10:11:30","2020-01-25 04:00:00","2020-01-25 04:30:00",2760,640,3400
"2020-01-24 10:11:30","2020-01-25 05:00:00","2020-01-25 05:30:00",2737,631,3368
"2020-01-24 10:11:30","2020-01-25 06:00:00","2020-01-25 06:30:00",2805,654,3459
"2020-01-24 10:11:30","2020-01-25 07:00:00","2020-01-25 07:30:00",2918,747,3665
"2020-01-24 10:11:30","2020-01-25 08:00:00","2020-01-25 08:30:00",3192,856,4048
"2020-01-24 10:11:30","2020-01-25 09:00:00","2020-01-25 09:30:00",3461,991,4452
"2020-01-24 10:11:30","2020-01-25 10:00:00","2020-01-25 10:30:00",3751,1078,4829
"2020-01-24 10:11:30","2020-01-25 11:00:00","2020-01-25 11:30:00",3832,1133,4965
"2020-01-24 10:11:30","2020-01-25 12:00:00","2020-01-25 12:30:00",3929,1142,5071
"2020-01-24 10:11:30","2020-01-25 13:00:00","2020-01-25 13:30:00",3914,1133,5047
"2020-01-24 10:11:30","2020-01-25 14:00:00","2020-01-25 14:30:00",3792,1064,4856
"2020-01-24 10:11:30","2020-01-25 15:00:00","2020-01-25 15:30:00",3724,1076,4800
"2020-01-24 10:11:30","2020-01-25 16:00:00","2020-01-25 16:30:00",3736,1112,4848
"2020-01-24 10:11:30","2020-01-25 17:00:00","2020-01-25 17:30:00",4016,1246,5262
"2020-01-24 10:11:30","2020-01-25 18:00:00","2020-01-25 18:30:00",4319,1315,5634
"2020-01-24 10:11:30","2020-01-25 19:00:00","2020-01-25 19:30:00",4289,1197,5486
"2020-01-24 10:11:30","2020-01-25 20:00:00","2020-01-25 20:30:00",4023,1112,5135
"2020-01-24 10:11:30","2020-01-25 21:00:00","2020-01-25 21:30:00",3780,1038,4818
"2020-01-24 10:11:30","2020-01-25 22:00:00","2020-01-25 22:30:00",3571,963,4534
"2020-01-25 10:11:26","2020-01-25 23:00:00","2020-01-25 23:30:00",3431,785,4216
"2020-01-25 10:11:26","2020-01-26 00:00:00","2020-01-26 00:30:00",3283,721,4004
"2020-01-25 10:11:26","2020-01-26 01:00:00","2020-01-26 01:30:00",3048,685,3733
"2020-01-25 10:11:26","2020-01-26 02:00:00","2020-01-26 02:30:00",2887,668,3555
"2020-01-25 10:11:26","2020-01-26 03:00:00","2020-01-26 03:30:00",2786,627,3413
"2020-01-25 10:11:26","2020-01-26 04:00:00","2020-01-26 04:30:00",2737,597,3334
"2020-01-25 10:11:26","2020-01-26 05:00:00","2020-01-26 05:30:00",2703,613,3316
"2020-01-25 10:11:26","2020-01-26 06:00:00","2020-01-26 06:30:00",2719,626,3345
"2020-01-25 10:11:26","2020-01-26 07:00:00","2020-01-26 07:30:00",2782,684,3466
"2020-01-25 10:11:26","2020-01-26 08:00:00","2020-01-26 08:30:00",2920,799,3719
"2020-01-25 10:11:26","2020-01-26 09:00:00","2020-01-26 09:30:00",3137,879,4016
"2020-01-25 10:11:26","2020-01-26 10:00:00","2020-01-26 10:30:00",3446,1007,4453
"2020-01-25 10:11:26","2020-01-26 11:00:00","2020-01-26 11:30:00",3629,1051,4680
"2020-01-25 10:11:26","2020-01-26 12:00:00","2020-01-26 12:30:00",3674,1105,4779
"2020-01-25 10:11:26","2020-01-26 13:00:00","2020-01-26 13:30:00",3750,1136,4886
"2020-01-25 10:11:26","2020-01-26 14:00:00","2020-01-26 14:30:00",3723,1088,4811
"2020-01-25 10:11:26","2020-01-26 15:00:00","2020-01-26 15:30:00",3634,1088,4722
"2020-01-25 10:11:26","2020-01-26 16:00:00","2020-01-26 16:30:00",3671,1109,4780
"2020-01-25 10:11:26","2020-01-26 17:00:00","2020-01-26 17:30:00",3872,1291,5163
"2020-01-25 10:11:26","2020-01-26 18:00:00","2020-01-26 18:30:00",4280,1377,5657
"2020-01-25 10:11:26","2020-01-26 19:00:00","2020-01-26 19:30:00",4192,1272,5464
"2020-01-25 10:11:26","2020-01-26 20:00:00","2020-01-26 20:30:00",4004,1212,5216
"2020-01-25 10:11:26","2020-01-26 21:00:00","2020-01-26 21:30:00",3830,1089,4919
"2020-01-25 10:11:26","2020-01-26 22:00:00","2020-01-26 22:30:00",3526,984,4510
"2020-01-26 10:11:45","2020-01-26 23:00:00","2020-01-26 23:30:00",3313,850,4163
"2020-01-26 10:11:45","2020-01-27 00:00:00","2020-01-27 00:30:00",3263,710,3973
"2020-01-26 10:11:45","2020-01-27 01:00:00","2020-01-27 01:30:00",3052,671,3723
"2020-01-26 10:11:45","2020-01-27 02:00:00","2020-01-27 02:30:00",2935,673,3608
"2020-01-26 10:11:45","2020-01-27 03:00:00","2020-01-27 03:30:00",2832,648,3480
"2020-01-26 10:11:45","2020-01-27 04:00:00","2020-01-27 04:30:00",2814,650,3464
"2020-01-26 10:11:45","2020-01-27 05:00:00","2020-01-27 05:30:00",2835,654,3489
"2020-01-26 10:11:45","2020-01-27 06:00:00","2020-01-27 06:30:00",3043,733,3776
"2020-01-26 10:11:45","2020-01-27 07:00:00","2020-01-27 07:30:00",3620,942,4562
"2020-01-26 10:11:45","2020-01-27 08:00:00","2020-01-27 08:30:00",4190,1208,5398
"2020-01-26 10:11:45","2020-01-27 09:00:00","2020-01-27 09:30:00",4239,1265,5504
"2020-01-26 10:11:45","2020-01-27 10:00:00","2020-01-27 10:30:00",4323,1288,5611
"2020-01-26 10:11:45","2020-01-27 11:00:00","2020-01-27 11:30:00",4331,1286,5617
"2020-01-26 10:11:45","2020-01-27 12:00:00","2020-01-27 12:30:00",4345,1297,5642
"2020-01-26 10:11:45","2020-01-27 13:00:00","2020-01-27 13:30:00",4391,1292,5683
"2020-01-26 10:11:45","2020-01-27 14:00:00","2020-01-27 14:30:00",4294,1259,5553
"2020-01-26 10:11:45","2020-01-27 15:00:00","2020-01-27 15:30:00",4318,1272,5590
"2020-01-26 10:11:45","2020-01-27 16:00:00","2020-01-27 16:30:00",4390,1358,5748
"2020-01-26 10:11:45","2020-01-27 17:00:00","2020-01-27 17:30:00",4707,1575,6282
"2020-01-26 10:11:45","2020-01-27 18:00:00","2020-01-27 18:30:00",4975,1552,6527
"2020-01-26 10:11:45","2020-01-27 19:00:00","2020-01-27 19:30:00",4770,1443,6213
"2020-01-26 10:11:45","2020-01-27 20:00:00","2020-01-27 20:30:00",4557,1335,5892
"2020-01-26 10:11:45","2020-01-27 21:00:00","2020-01-27 21:30:00",4266,1256,5522
"2020-01-26 10:11:45","2020-01-27 22:00:00","2020-01-27 22:30:00",3868,1082,4950
"2020-01-27 10:11:06","2020-01-27 23:00:00","2020-01-27 23:30:00",3389,835,4224
"2020-01-27 10:11:06","2020-01-28 00:00:00","2020-01-28 00:30:00",3290,783,4073
"2020-01-27 10:11:06","2020-01-28 01:00:00","2020-01-28 01:30:00",3045,731,3776
"2020-01-27 10:11:06","2020-01-28 02:00:00","2020-01-28 02:30:00",2908,705,3613
"2020-01-27 10:11:06","2020-01-28 03:00:00","2020-01-28 03:30:00",2829,677,3506
"2020-01-27 10:11:06","2020-01-28 04:00:00","2020-01-28 04:30:00",2817,669,3486
"2020-01-27 10:11:06","2020-01-28 05:00:00","2020-01-28 05:30:00",2858,686,3544
"2020-01-27 10:11:06","2020-01-28 06:00:00","2020-01-28 06:30:00",3065,763,3828
"2020-01-27 10:11:06","2020-01-28 07:00:00","2020-01-28 07:30:00",3623,973,4596
"2020-01-27 10:11:06","2020-01-28 08:00:00","2020-01-28 08:30:00",4237,1213,5450
"2020-01-27 10:11:06","2020-01-28 09:00:00","2020-01-28 09:30:00",4248,1237,5485
"2020-01-27 10:11:06","2020-01-28 10:00:00","2020-01-28 10:30:00",4359,1244,5603
"2020-01-27 10:11:06","2020-01-28 11:00:00","2020-01-28 11:30:00",4379,1225,5604
"2020-01-27 10:11:06","2020-01-28 12:00:00","2020-01-28 12:30:00",4395,1225,5620
"2020-01-27 10:11:06","2020-01-28 13:00:00","2020-01-28 13:30:00",4425,1209,5634
"2020-01-27 10:11:06","2020-01-28 14:00:00","2020-01-28 14:30:00",4325,1171,5496
"2020-01-27 10:11:06","2020-01-28 15:00:00","2020-01-28 15:30:00",4338,1182,5520
"2020-01-27 10:11:06","2020-01-28 16:00:00","2020-01-28 16:30:00",4453,1215,5668
"2020-01-27 10:11:06","2020-01-28 17:00:00","2020-01-28 17:30:00",4783,1402,6185
"2020-01-27 10:11:06","2020-01-28 18:00:00","2020-01-28 18:30:00",4960,1414,6374
"2020-01-27 10:11:06","2020-01-28 19:00:00","2020-01-28 19:30:00",4788,1322,6110
"2020-01-27 10:11:06","2020-01-28 20:00:00","2020-01-28 20:30:00",4571,1233,5804
"2020-01-27 10:11:06","2020-01-28 21:00:00","2020-01-28 21:30:00",4321,1164,5485
"2020-01-27 10:11:06","2020-01-28 22:00:00","2020-01-28 22:30:00",3884,1008,4892
"2020-01-28 10:11:26","2020-01-28 23:00:00","2020-01-28 23:30:00",3541,861,4402
"2020-01-28 10:11:26","2020-01-29 00:00:00","2020-01-29 00:30:00",3328,748,4076
"2020-01-28 10:11:26","2020-01-29 01:00:00","2020-01-29 01:30:00",3084,698,3782
"2020-01-28 10:11:26","2020-01-29 02:00:00","2020-01-29 02:30:00",2926,694,3620
"2020-01-28 10:11:26","2020-01-29 03:00:00","2020-01-29 03:30:00",2835,664,3499
"2020-01-28 10:11:26","2020-01-29 04:00:00","2020-01-29 04:30:00",2813,648,3461
"2020-01-28 10:11:26","2020-01-29 05:00:00","2020-01-29 05:30:00",2817,665,3482
"2020-01-28 10:11:26","2020-01-29 06:00:00","2020-01-29 06:30:00",3018,739,3757
"2020-01-28 10:11:26","2020-01-29 07:00:00","2020-01-29 07:30:00",3579,954,4533
"2020-01-28 10:11:26","2020-01-29 08:00:00","2020-01-29 08:30:00",4163,1193,5356
"2020-01-28 10:11:26","2020-01-29 09:00:00","2020-01-29 09:30:00",4184,1215,5399
"2020-01-28 10:11:26","2020-01-29 10:00:00","2020-01-29 10:30:00",4284,1229,5513
"2020-01-28 10:11:26","2020-01-29 11:00:00","2020-01-29 11:30:00",4277,1193,5470
"2020-01-28 10:11:26","2020-01-29 12:00:00","2020-01-29 12:30:00",4256,1194,5450
"2020-01-28 10:11:26","2020-01-29 13:00:00","2020-01-29 13:30:00",4260,1160,5420
"2020-01-28 10:11:26","2020-01-29 14:00:00","2020-01-29 14:30:00",4166,1134,5300
"2020-01-28 10:11:26","2020-01-29 15:00:00","2020-01-29 15:30:00",4185,1137,5322
"2020-01-28 10:11:26","2020-01-29 16:00:00","2020-01-29 16:30:00",4289,1163,5452
"2020-01-28 10:11:26","2020-01-29 17:00:00","2020-01-29 17:30:00",4602,1331,5933
"2020-01-28 10:11:26","2020-01-29 18:00:00","2020-01-29 18:30:00",4880,1351,6231
"2020-01-28 10:11:26","2020-01-29 19:00:00","2020-01-29 19:30:00",4693,1262,5955
"2020-01-28 10:11:26","2020-01-29 20:00:00","2020-01-29 20:30:00",4463,1174,5637
"2020-01-28 10:11:26","2020-01-29 21:00:00","2020-01-29 21:30:00",4223,1107,5330
"2020-01-28 10:11:26","2020-01-29 22:00:00","2020-01-29 22:30:00",3828,954,4782
"2020-01-29 10:11:21","2020-01-29 23:00:00","2020-01-29 23:30:00",3580,860,4440
"2020-01-29 10:11:21","2020-01-30 00:00:00","2020-01-30 00:30:00",3336,684,4020
"2020-01-29 10:11:21","2020-01-30 01:00:00","2020-01-30 01:30:00",3109,642,3751
"2020-01-29 10:11:21","2020-01-30 02:00:00","2020-01-30 02:30:00",2981,630,3611
"2020-01-29 10:11:21","2020-01-30 03:00:00","2020-01-30 03:30:00",2907,617,3524
"2020-01-29 10:11:21","2020-01-30 04:00:00","2020-01-30 04:30:00",2896,613,3509
"2020-01-29 10:11:21","2020-01-30 05:00:00","2020-01-30 05:30:00",2934,615,3549
"2020-01-29 10:11:21","2020-01-30 06:00:00","2020-01-30 06:30:00",3127,700,3827
"2020-01-29 10:11:21","2020-01-30 07:00:00","2020-01-30 07:30:00",3646,890,4536
"2020-01-29 10:11:21","2020-01-30 08:00:00","2020-01-30 08:30:00",4218,1098,5316
"2020-01-29 10:11:21","2020-01-30 09:00:00","2020-01-30 09:30:00",4229,1120,5349
"2020-01-29 10:11:21","2020-01-30 10:00:00","2020-01-30 10:30:00",4332,1142,5474
"2020-01-29 10:11:21","2020-01-30 11:00:00","2020-01-30 11:30:00",4351,1140,5491
"2020-01-29 10:11:21","2020-01-30 12:00:00","2020-01-30 12:30:00",4366,1142,5508
"2020-01-29 10:11:21","2020-01-30 13:00:00","2020-01-30 13:30:00",4394,1130,5524
"2020-01-29 10:11:21","2020-01-30 14:00:00","2020-01-30 14:30:00",4301,1093,5394
"2020-01-29 10:11:21","2020-01-30 15:00:00","2020-01-30 15:30:00",4313,1097,5410
"2020-01-29 10:11:21","2020-01-30 16:00:00","2020-01-30 16:30:00",4420,1138,5558
"2020-01-29 10:11:21","2020-01-30 17:00:00","2020-01-30 17:30:00",4728,1295,6023
"2020-01-29 10:11:21","2020-01-30 18:00:00","2020-01-30 18:30:00",4892,1347,6239
"2020-01-29 10:11:21","2020-01-30 19:00:00","2020-01-30 19:30:00",4732,1263,5995
"2020-01-29 10:11:21","2020-01-30 20:00:00","2020-01-30 20:30:00",4530,1188,5718
"2020-01-29 10:11:21","2020-01-30 21:00:00","2020-01-30 21:30:00",4297,1111,5408
"2020-01-29 10:11:21","2020-01-30 22:00:00","2020-01-30 22:30:00",3890,957,4847
"2020-01-30 10:11:15","2020-01-30 23:00:00","2020-01-30 23:30:00",3570,791,4361
"2020-01-30 10:11:15","2020-01-31 00:00:00","2020-01-31 00:30:00",3368,698,4066
"2020-01-30 10:11:15","2020-01-31 01:00:00","2020-01-31 01:30:00",3154,639,3793
"2020-01-30 10:11:15","2020-01-31 02:00:00","2020-01-31 02:30:00",3002,619,3621
"2020-01-30 10:11:15","2020-01-31 03:00:00","2020-01-31 03:30:00",2900,581,3481
"2020-01-30 10:11:15","2020-01-31 04:00:00","2020-01-31 04:30:00",2880,595,3475
"2020-01-30 10:11:15","2020-01-31 05:00:00","2020-01-31 05:30:00",2893,591,3484
"2020-01-30 10:11:15","2020-01-31 06:00:00","2020-01-31 06:30:00",3090,665,3755
"2020-01-30 10:11:15","2020-01-31 07:00:00","2020-01-31 07:30:00",3630,837,4467
"2020-01-30 10:11:15","2020-01-31 08:00:00","2020-01-31 08:30:00",4179,1053,5232
"2020-01-30 10:11:15","2020-01-31 09:00:00","2020-01-31 09:30:00",4210,1093,5303
"2020-01-30 10:11:15","2020-01-31 10:00:00","2020-01-31 10:30:00",4305,1106,5411
"2020-01-30 10:11:15","2020-01-31 11:00:00","2020-01-31 11:30:00",4313,1111,5424
"2020-01-30 10:11:15","2020-01-31 12:00:00","2020-01-31 12:30:00",4306,1090,5396
"2020-01-30 10:11:15","2020-01-31 13:00:00","2020-01-31 13:30:00",4305,1090,5395
"2020-01-30 10:11:15","2020-01-31 14:00:00","2020-01-31 14:30:00",4221,1040,5261
"2020-01-30 10:11:15","2020-01-31 15:00:00","2020-01-31 15:30:00",4220,1042,5262
"2020-01-30 10:11:15","2020-01-31 16:00:00","2020-01-31 16:30:00",4293,1053,5346
"2020-01-30 10:11:15","2020-01-31 17:00:00","2020-01-31 17:30:00",4543,1170,5713
"2020-01-30 10:11:15","2020-01-31 18:00:00","2020-01-31 18:30:00",4760,1234,5994
"2020-01-30 10:11:15","2020-01-31 19:00:00","2020-01-31 19:30:00",4599,1172,5771
"2020-01-30 10:11:15","2020-01-31 20:00:00","2020-01-31 20:30:00",4393,1114,5507
"2020-01-30 10:11:15","2020-01-31 21:00:00","2020-01-31 21:30:00",4153,1031,5184
"2020-01-30 10:11:15","2020-01-31 22:00:00","2020-01-31 22:30:00",3812,910,4722
"2020-01-31 10:11:36","2020-01-31 23:00:00","2020-01-31 23:30:00",3473,834,4307
"2020-01-31 10:11:36","2020-02-01 00:00:00","2020-02-01 00:30:00",3374,679,4053
"2020-01-31 10:11:36","2020-02-01 01:00:00","2020-02-01 01:30:00",3146,602,3748
"2020-01-31 10:11:36","2020-02-01 02:00:00","2020-02-01 02:30:00",2978,573,3551
"2020-01-31 10:11:36","2020-02-01 03:00:00","2020-02-01 03:30:00",2857,553,3410
"2020-01-31 10:11:36","2020-02-01 04:00:00","2020-02-01 04:30:00",2822,560,3382
"2020-01-31 10:11:36","2020-02-01 05:00:00","2020-02-01 05:30:00",2790,553,3343
"2020-01-31 10:11:36","2020-02-01 06:00:00","2020-02-01 06:30:00",2881,582,3463
"2020-01-31 10:11:36","2020-02-01 07:00:00","2020-02-01 07:30:00",3067,665,3732
"2020-01-31 10:11:36","2020-02-01 08:00:00","2020-02-01 08:30:00",3320,799,4119
"2020-01-31 10:11:36","2020-02-01 09:00:00","2020-02-01 09:30:00",3555,906,4461
"2020-01-31 10:11:36","2020-02-01 10:00:00","2020-02-01 10:30:00",3779,982,4761
"2020-01-31 10:11:36","2020-02-01 11:00:00","2020-02-01 11:30:00",3882,1010,4892
"2020-01-31 10:11:36","2020-02-01 12:00:00","2020-02-01 12:30:00",3947,1020,4967
"2020-01-31 10:11:36","2020-02-01 13:00:00","2020-02-01 13:30:00",3936,999,4935
"2020-01-31 10:11:36","2020-02-01 14:00:00","2020-02-01 14:30:00",3879,959,4838
"2020-01-31 10:11:36","2020-02-01 15:00:00","2020-02-01 15:30:00",3856,967,4823
"2020-01-31 10:11:36","2020-02-01 16:00:00","2020-02-01 16:30:00",3855,1014,4869
"2020-01-31 10:11:36","2020-02-01 17:00:00","2020-02-01 17:30:00",4128,1163,5291
"2020-01-31 10:11:36","2020-02-01 18:00:00","2020-02-01 18:30:00",4380,1253,5633
"2020-01-31 10:11:36","2020-02-01 19:00:00","2020-02-01 19:30:00",4287,1153,5440
"2020-01-31 10:11:36","2020-02-01 20:00:00","2020-02-01 20:30:00",4032,1046,5078
"2020-01-31 10:11:36","2020-02-01 21:00:00","2020-02-01 21:30:00",3744,960,4704
"2020-01-31 10:11:36","2020-02-01 22:00:00","2020-02-01 22:30:00",3509,927,4436
"2020-02-01 10:11:31","2020-02-01 23:00:00","2020-02-01 23:30:00",3288,843,4131
"2020-02-01 10:11:31","2020-02-02 00:00:00","2020-02-02 00:30:00",3198,661,3859
"2020-02-01 10:11:31","2020-02-02 01:00:00","2020-02-02 01:30:00",2999,597,3596
"2020-02-01 10:11:31","2020-02-02 02:00:00","2020-02-02 02:30:00",2860,577,3437
"2020-02-01 10:11:31","2020-02-02 03:00:00","2020-02-02 03:30:00",2725,539,3264
"2020-02-01 10:11:31","2020-02-02 04:00:00","2020-02-02 04:30:00",2692,533,3225
"2020-02-01 10:11:31","2020-02-02 05:00:00","2020-02-02 05:30:00",2655,555,3210
"2020-02-01 10:11:31","2020-02-02 06:00:00","2020-02-02 06:30:00",2695,583,3278
"2020-02-01 10:11:31","2020-02-02 07:00:00","2020-02-02 07:30:00",2743,653,3396
"2020-02-01 10:11:31","2020-02-02 08:00:00","2020-02-02 08:30:00",2872,738,3610
"2020-02-01 10:11:31","2020-02-02 09:00:00","2020-02-02 09:30:00",3048,806,3854
"2020-02-01 10:11:31","2020-02-02 10:00:00","2020-02-02 10:30:00",3382,878,4260
"2020-02-01 10:11:31","2020-02-02 11:00:00","2020-02-02 11:30:00",3558,944,4502
"2020-02-01 10:11:31","2020-02-02 12:00:00","2020-02-02 12:30:00",3684,990,4674
"2020-02-01 10:11:31","2020-02-02 13:00:00","2020-02-02 13:30:00",3750,1027,4777
"2020-02-01 10:11:31","2020-02-02 14:00:00","2020-02-02 14:30:00",3670,980,4650
"2020-02-01 10:11:31","2020-02-02 15:00:00","2020-02-02 15:30:00",3557,936,4493
"2020-02-01 10:11:31","2020-02-02 16:00:00","2020-02-02 16:30:00",3575,971,4546
"2020-02-01 10:11:31","2020-02-02 17:00:00","2020-02-02 17:30:00",3861,1109,4970
"2020-02-01 10:11:31","2020-02-02 18:00:00","2020-02-02 18:30:00",4360,1183,5543
"2020-02-01 10:11:31","2020-02-02 19:00:00","2020-02-02 19:30:00",4150,1104,5254
"2020-02-01 10:11:31","2020-02-02 20:00:00","2020-02-02 20:30:00",4013,1030,5043
"2020-02-01 10:11:31","2020-02-02 21:00:00","2020-02-02 21:30:00",3770,946,4716
"2020-02-01 10:11:31","2020-02-02 22:00:00","2020-02-02 22:30:00",3470,806,4276
"2020-02-02 10:11:25","2020-02-02 23:00:00","2020-02-02 23:30:00",3262,712,3974
"2020-02-02 10:11:25","2020-02-03 00:00:00","2020-02-03 00:30:00",3036,563,3599
"2020-02-02 10:11:25","2020-02-03 01:00:00","2020-02-03 01:30:00",2908,524,3432
"2020-02-02 10:11:25","2020-02-03 02:00:00","2020-02-03 02:30:00",2722,542,3264
"2020-02-02 10:11:25","2020-02-03 03:00:00","2020-02-03 03:30:00",2683,509,3192
"2020-02-02 10:11:25","2020-02-03 04:00:00","2020-02-03 04:30:00",2577,529,3106
"2020-02-02 10:11:25","2020-02-03 05:00:00","2020-02-03 05:30:00",2663,536,3199
"2020-02-02 10:11:25","2020-02-03 06:00:00","2020-02-03 06:30:00",2872,627,3499
"2020-02-02 10:11:25","2020-02-03 07:00:00","2020-02-03 07:30:00",3461,847,4308
"2020-02-02 10:11:25","2020-02-03 08:00:00","2020-02-03 08:30:00",4003,1072,5075
"2020-02-02 10:11:25","2020-02-03 09:00:00","2020-02-03 09:30:00",4006,1109,5115
"2020-02-02 10:11:25","2020-02-03 10:00:00","2020-02-03 10:30:00",4126,1132,5258
"2020-02-02 10:11:25","2020-02-03 11:00:00","2020-02-03 11:30:00",4129,1124,5253
"2020-02-02 10:11:25","2020-02-03 12:00:00","2020-02-03 12:30:00",4157,1140,5297
"2020-02-02 10:11:25","2020-02-03 13:00:00","2020-02-03 13:30:00",4142,1130,5272
"2020-02-02 10:11:25","2020-02-03 14:00:00","2020-02-03 14:30:00",4090,1137,5227
"2020-02-02 10:11:25","2020-02-03 15:00:00","2020-02-03 15:30:00",4118,1150,5268
"2020-02-02 10:11:25","2020-02-03 16:00:00","2020-02-03 16:30:00",4192,1219,5411
"2020-02-02 10:11:25","2020-02-03 17:00:00","2020-02-03 17:30:00",4518,1378,5896
"2020-02-02 10:11:25","2020-02-03 18:00:00","2020-02-03 18:30:00",4759,1391,6150
"2020-02-02 10:11:25","2020-02-03 19:00:00","2020-02-03 19:30:00",4560,1270,5830
"2020-02-02 10:11:25","2020-02-03 20:00:00","2020-02-03 20:30:00",4327,1211,5538
"2020-02-02 10:11:25","2020-02-03 21:00:00","2020-02-03 21:30:00",4091,1127,5218
"2020-02-02 10:11:25","2020-02-03 22:00:00","2020-02-03 22:30:00",3665,973,4638
"2020-02-03 10:11:20","2020-02-03 23:00:00","2020-02-03 23:30:00",3514,830,4344
"2020-02-03 10:11:20","2020-02-04 00:00:00","2020-02-04 00:30:00",3248,694,3942
"2020-02-03 10:11:20","2020-02-04 01:00:00","2020-02-04 01:30:00",3017,648,3665
"2020-02-03 10:11:20","2020-02-04 02:00:00","2020-02-04 02:30:00",2936,623,3559
"2020-02-03 10:11:20","2020-02-04 03:00:00","2020-02-04 03:30:00",2861,601,3462
"2020-02-03 10:11:20","2020-02-04 04:00:00","2020-02-04 04:30:00",2840,594,3434
"2020-02-03 10:11:20","2020-02-04 05:00:00","2020-02-04 05:30:00",2836,609,3445
"2020-02-03 10:11:20","2020-02-04 06:00:00","2020-02-04 06:30:00",3016,686,3702
"2020-02-03 10:11:20","2020-02-04 07:00:00","2020-02-04 07:30:00",3583,888,4471
"2020-02-03 10:11:20","2020-02-04 08:00:00","2020-02-04 08:30:00",4085,1100,5185
"2020-02-03 10:11:20","2020-02-04 09:00:00","2020-02-04 09:30:00",4130,1116,5246
"2020-02-03 10:11:20","2020-02-04 10:00:00","2020-02-04 10:30:00",4255,1146,5401
"2020-02-03 10:11:20","2020-02-04 11:00:00","2020-02-04 11:30:00",4264,1140,5404
"2020-02-03 10:11:20","2020-02-04 12:00:00","2020-02-04 12:30:00",4217,1135,5352
"2020-02-03 10:11:20","2020-02-04 13:00:00","2020-02-04 13:30:00",4256,1111,5367
"2020-02-03 10:11:20","2020-02-04 14:00:00","2020-02-04 14:30:00",4200,1074,5274
"2020-02-03 10:11:20","2020-02-04 15:00:00","2020-02-04 15:30:00",4199,1066,5265
"2020-02-03 10:11:20","2020-02-04 16:00:00","2020-02-04 16:30:00",4269,1142,5411
"2020-02-03 10:11:20","2020-02-04 17:00:00","2020-02-04 17:30:00",4492,1305,5797
"2020-02-03 10:11:20","2020-02-04 18:00:00","2020-02-04 18:30:00",4880,1418,6298
"2020-02-03 10:11:20","2020-02-04 19:00:00","2020-02-04 19:30:00",4726,1308,6034
"2020-02-03 10:11:20","2020-02-04 20:00:00","2020-02-04 20:30:00",4496,1247,5743
"2020-02-03 10:11:20","2020-02-04 21:00:00","2020-02-04 21:30:00",4314,1179,5493
"2020-02-03 10:11:20","2020-02-04 22:00:00","2020-02-04 22:30:00",3893,1045,4938
"2020-02-04 10:11:16","2020-02-04 23:00:00","2020-02-04 23:30:00",3524,828,4352
"2020-02-04 10:11:16","2020-02-05 00:00:00","2020-02-05 00:30:00",3354,736,4090
"2020-02-04 10:11:16","2020-02-05 01:00:00","2020-02-05 01:30:00",3122,674,3796
"2020-02-04 10:11:16","2020-02-05 02:00:00","2020-02-05 02:30:00",2969,654,3623
"2020-02-04 10:11:16","2020-02-05 03:00:00","2020-02-05 03:30:00",2890,648,3538
"2020-02-04 10:11:16","2020-02-05 04:00:00","2020-02-05 04:30:00",2873,647,3520
"2020-02-04 10:11:16","2020-02-05 05:00:00","2020-02-05 05:30:00",2847,661,3508
"2020-02-04 10:11:16","2020-02-05 06:00:00","2020-02-05 06:30:00",3057,770,3827
"2020-02-04 10:11:16","2020-02-05 07:00:00","2020-02-05 07:30:00",3585,1000,4585
"2020-02-04 10:11:16","2020-02-05 08:00:00","2020-02-05 08:30:00",4181,1200,5381
"2020-02-04 10:11:16","2020-02-05 09:00:00","2020-02-05 09:30:00",4145,1210,5355
"2020-02-04 10:11:16","2020-02-05 10:00:00","2020-02-05 10:30:00",4224,1239,5463
"2020-02-04 10:11:16","2020-02-05 11:00:00","2020-02-05 11:30:00",4262,1219,5481
"2020-02-04 10:11:16","2020-02-05 12:00:00","2020-02-05 12:30:00",4309,1209,5518
"2020-02-04 10:11:16","2020-02-05 13:00:00","2020-02-05 13:30:00",4334,1148,5482
"2020-02-04 10:11:16","2020-02-05 14:00:00","2020-02-05 14:30:00",4263,1110,5373
"2020-02-04 10:11:16","2020-02-05 15:00:00","2020-02-05 15:30:00",4343,1094,5437
"2020-02-04 10:11:16","2020-02-05 16:00:00","2020-02-05 16:30:00",4416,1156,5572
"2020-02-04 10:11:16","2020-02-05 17:00:00","2020-02-05 17:30:00",4635,1304,5939
"2020-02-04 10:11:16","2020-02-05 18:00:00","2020-02-05 18:30:00",4907,1470,6377
"2020-02-04 10:11:16","2020-02-05 19:00:00","2020-02-05 19:30:00",4785,1300,6085
"2020-02-04 10:11:16","2020-02-05 20:00:00","2020-02-05 20:30:00",4527,1226,5753
"2020-02-04 10:11:16","2020-02-05 21:00:00","2020-02-05 21:30:00",4290,1153,5443
"2020-02-04 10:11:16","2020-02-05 22:00:00","2020-02-05 22:30:00",3864,1019,4883
"2020-02-05 10:10:36","2020-02-05 23:00:00","2020-02-05 23:30:00",3511,909,4420
"2020-02-05 10:10:36","2020-02-06 00:00:00","2020-02-06 00:30:00",3335,700,4035
"2020-02-05 10:10:36","2020-02-06 01:00:00","2020-02-06 01:30:00",3102,655,3757
"2020-02-05 10:10:36","2020-02-06 02:00:00","2020-02-06 02:30:00",2955,638,3593
"2020-02-05 10:10:36","2020-02-06 03:00:00","2020-02-06 03:30:00",2877,613,3490
"2020-02-05 10:10:36","2020-02-06 04:00:00","2020-02-06 04:30:00",2850,616,3466
"2020-02-05 10:10:36","2020-02-06 05:00:00","2020-02-06 05:30:00",2882,629,3511
"2020-02-05 10:10:36","2020-02-06 06:00:00","2020-02-06 06:30:00",3082,720,3802
"2020-02-05 10:10:36","2020-02-06 07:00:00","2020-02-06 07:30:00",3617,960,4577
"2020-02-05 10:10:36","2020-02-06 08:00:00","2020-02-06 08:30:00",4199,1204,5403
"2020-02-05 10:10:36","2020-02-06 09:00:00","2020-02-06 09:30:00",4181,1232,5413
"2020-02-05 10:10:36","2020-02-06 10:00:00","2020-02-06 10:30:00",4270,1254,5524
"2020-02-05 10:10:36","2020-02-06 11:00:00","2020-02-06 11:30:00",4223,1210,5433
"2020-02-05 10:10:36","2020-02-06 12:00:00","2020-02-06 12:30:00",4233,1196,5429
"2020-02-05 10:10:36","2020-02-06 13:00:00","2020-02-06 13:30:00",4235,1169,5404
"2020-02-05 10:10:36","2020-02-06 14:00:00","2020-02-06 14:30:00",4119,1130,5249
"2020-02-05 10:10:36","2020-02-06 15:00:00","2020-02-06 15:30:00",4147,1106,5253
"2020-02-05 10:10:36","2020-02-06 16:00:00","2020-02-06 16:30:00",4258,1178,5436
"2020-02-05 10:10:36","2020-02-06 17:00:00","2020-02-06 17:30:00",4512,1325,5837
"2020-02-05 10:10:36","2020-02-06 18:00:00","2020-02-06 18:30:00",4850,1392,6242
"2020-02-05 10:10:36","2020-02-06 19:00:00","2020-02-06 19:30:00",4669,1281,5950
"2020-02-05 10:10:36","2020-02-06 20:00:00","2020-02-06 20:30:00",4444,1210,5654
"2020-02-05 10:10:36","2020-02-06 21:00:00","2020-02-06 21:30:00",4221,1119,5340
"2020-02-05 10:10:36","2020-02-06 22:00:00","2020-02-06 22:30:00",3760,983,4743
"2020-02-06 10:10:55","2020-02-06 23:00:00","2020-02-06 23:30:00",3561,886,4447
"2020-02-06 10:10:55","2020-02-07 00:00:00","2020-02-07 00:30:00",3301,685,3986
"2020-02-06 10:10:55","2020-02-07 01:00:00","2020-02-07 01:30:00",3090,610,3700
"2020-02-06 10:10:55","2020-02-07 02:00:00","2020-02-07 02:30:00",2975,596,3571
"2020-02-06 10:10:55","2020-02-07 03:00:00","2020-02-07 03:30:00",2893,580,3473
"2020-02-06 10:10:55","2020-02-07 04:00:00","2020-02-07 04:30:00",2877,582,3459
"2020-02-06 10:10:55","2020-02-07 05:00:00","2020-02-07 05:30:00",2879,598,3477
"2020-02-06 10:10:55","2020-02-07 06:00:00","2020-02-07 06:30:00",3086,697,3783
"2020-02-06 10:10:55","2020-02-07 07:00:00","2020-02-07 07:30:00",3584,893,4477
"2020-02-06 10:10:55","2020-02-07 08:00:00","2020-02-07 08:30:00",4149,1124,5273
"2020-02-06 10:10:55","2020-02-07 09:00:00","2020-02-07 09:30:00",4142,1133,5275
"2020-02-06 10:10:55","2020-02-07 10:00:00","2020-02-07 10:30:00",4218,1160,5378
"2020-02-06 10:10:55","2020-02-07 11:00:00","2020-02-07 11:30:00",4169,1107,5276
"2020-02-06 10:10:55","2020-02-07 12:00:00","2020-02-07 12:30:00",4197,1098,5295
"2020-02-06 10:10:55","2020-02-07 13:00:00","2020-02-07 13:30:00",4199,1072,5271
"2020-02-06 10:10:55","2020-02-07 14:00:00","2020-02-07 14:30:00",4126,1039,5165
"2020-02-06 10:10:55","2020-02-07 15:00:00","2020-02-07 15:30:00",4115,1007,5122
"2020-02-06 10:10:55","2020-02-07 16:00:00","2020-02-07 16:30:00",4208,1021,5229
"2020-02-06 10:10:55","2020-02-07 17:00:00","2020-02-07 17:30:00",4405,1144,5549
"2020-02-06 10:10:55","2020-02-07 18:00:00","2020-02-07 18:30:00",4720,1211,5931
"2020-02-06 10:10:55","2020-02-07 19:00:00","2020-02-07 19:30:00",4594,1125,5719
"2020-02-06 10:10:55","2020-02-07 20:00:00","2020-02-07 20:30:00",4383,1048,5431
"2020-02-06 10:10:55","2020-02-07 21:00:00","2020-02-07 21:30:00",4118,970,5088
"2020-02-06 10:10:55","2020-02-07 22:00:00","2020-02-07 22:30:00",3775,841,4616
"2020-02-07 10:11:21","2020-02-07 23:00:00","2020-02-07 23:30:00",3564,840,4404
"2020-02-07 10:11:21","2020-02-08 00:00:00","2020-02-08 00:30:00",3454,637,4091
"2020-02-07 10:11:21","2020-02-08 01:00:00","2020-02-08 01:30:00",3192,574,3766
"2020-02-07 10:11:21","2020-02-08 02:00:00","2020-02-08 02:30:00",2979,544,3523
"2020-02-07 10:11:21","2020-02-08 03:00:00","2020-02-08 03:30:00",2823,529,3352
"2020-02-07 10:11:21","2020-02-08 04:00:00","2020-02-08 04:30:00",2756,518,3274
"2020-02-07 10:11:21","2020-02-08 05:00:00","2020-02-08 05:30:00",2740,525,3265
"2020-02-07 10:11:21","2020-02-08 06:00:00","2020-02-08 06:30:00",2805,558,3363
"2020-02-07 10:11:21","2020-02-08 07:00:00","2020-02-08 07:30:00",2969,653,3622
"2020-02-07 10:11:21","2020-02-08 08:00:00","2020-02-08 08:30:00",3248,777,4025
"2020-02-07 10:11:21","2020-02-08 09:00:00","2020-02-08 09:30:00",3593,903,4496
"2020-02-07 10:11:21","2020-02-08 10:00:00","2020-02-08 10:30:00",3828,970,4798
"2020-02-07 10:11:21","2020-02-08 11:00:00","2020-02-08 11:30:00",3887,992,4879
"2020-02-07 10:11:21","2020-02-08 12:00:00","2020-02-08 12:30:00",3883,982,4865
"2020-02-07 10:11:21","2020-02-08 13:00:00","2020-02-08 13:30:00",3825,961,4786
"2020-02-07 10:11:21","2020-02-08 14:00:00","2020-02-08 14:30:00",3731,951,4682
"2020-02-07 10:11:21","2020-02-08 15:00:00","2020-02-08 15:30:00",3567,920,4487
"2020-02-07 10:11:21","2020-02-08 16:00:00","2020-02-08 16:30:00",3579,961,4540
"2020-02-07 10:11:21","2020-02-08 17:00:00","2020-02-08 17:30:00",3816,1045,4861
"2020-02-07 10:11:21","2020-02-08 18:00:00","2020-02-08 18:30:00",4258,1148,5406
"2020-02-07 10:11:21","2020-02-08 19:00:00","2020-02-08 19:30:00",4206,1085,5291
"2020-02-07 10:11:21","2020-02-08 20:00:00","2020-02-08 20:30:00",3923,976,4899
"2020-02-07 10:11:21","2020-02-08 21:00:00","2020-02-08 21:30:00",3701,911,4612
"2020-02-07 10:11:21","2020-02-08 22:00:00","2020-02-08 22:30:00",3461,847,4308
"2020-02-08 10:11:45","2020-02-08 23:00:00","2020-02-08 23:30:00",3291,858,4149
"2020-02-08 10:11:45","2020-02-09 00:00:00","2020-02-09 00:30:00",3248,655,3903
"2020-02-08 10:11:45","2020-02-09 01:00:00","2020-02-09 01:30:00",3010,593,3603
"2020-02-08 10:11:45","2020-02-09 02:00:00","2020-02-09 02:30:00",2857,586,3443
"2020-02-08 10:11:45","2020-02-09 03:00:00","2020-02-09 03:30:00",2786,558,3344
"2020-02-08 10:11:45","2020-02-09 04:00:00","2020-02-09 04:30:00",2738,548,3286
"2020-02-08 10:11:45","2020-02-09 05:00:00","2020-02-09 05:30:00",2680,562,3242
"2020-02-08 10:11:45","2020-02-09 06:00:00","2020-02-09 06:30:00",2731,577,3308
"2020-02-08 10:11:45","2020-02-09 07:00:00","2020-02-09 07:30:00",2782,610,3392
"2020-02-08 10:11:45","2020-02-09 08:00:00","2020-02-09 08:30:00",2864,675,3539
"2020-02-08 10:11:45","2020-02-09 09:00:00","2020-02-09 09:30:00",3117,778,3895
"2020-02-08 10:11:45","2020-02-09 10:00:00","2020-02-09 10:30:00",3427,860,4287
"2020-02-08 10:11:45","2020-02-09 11:00:00","2020-02-09 11:30:00",3596,906,4502
"2020-02-08 10:11:45","2020-02-09 12:00:00","2020-02-09 12:30:00",3665,949,4614
"2020-02-08 10:11:45","2020-02-09 13:00:00","2020-02-09 13:30:00",3785,1006,4791
"2020-02-08 10:11:45","2020-02-09 14:00:00","2020-02-09 14:30:00",3662,969,4631
"2020-02-08 10:11:45","2020-02-09 15:00:00","2020-02-09 15:30:00",3588,914,4502
"2020-02-08 10:11:45","2020-02-09 16:00:00","2020-02-09 16:30:00",3566,935,4501
"2020-02-08 10:11:45","2020-02-09 17:00:00","2020-02-09 17:30:00",3782,1012,4794
"2020-02-08 10:11:45","2020-02-09 18:00:00","2020-02-09 18:30:00",4304,1142,5446
"2020-02-08 10:11:45","2020-02-09 19:00:00","2020-02-09 19:30:00",4234,1105,5339
"2020-02-08 10:11:45","2020-02-09 20:00:00","2020-02-09 20:30:00",4061,1028,5089
"2020-02-08 10:11:45","2020-02-09 21:00:00","2020-02-09 21:30:00",3870,918,4788
"2020-02-08 10:11:45","2020-02-09 22:00:00","2020-02-09 22:30:00",3494,827,4321
"2020-02-09 10:11:16","2020-02-09 23:00:00","2020-02-09 23:30:00",3276,715,3991
"2020-02-09 10:11:16","2020-02-10 00:00:00","2020-02-10 00:30:00",3076,593,3669
"2020-02-09 10:11:16","2020-02-10 01:00:00","2020-02-10 01:30:00",2908,540,3448
"2020-02-09 10:11:16","2020-02-10 02:00:00","2020-02-10 02:30:00",2763,546,3309
"2020-02-09 10:11:16","2020-02-10 03:00:00","2020-02-10 03:30:00",2701,529,3230
"2020-02-09 10:11:16","2020-02-10 04:00:00","2020-02-10 04:30:00",2703,522,3225
"2020-02-09 10:11:16","2020-02-10 05:00:00","2020-02-10 05:30:00",2749,533,3282
"2020-02-09 10:11:16","2020-02-10 06:00:00","2020-02-10 06:30:00",2953,636,3589
"2020-02-09 10:11:16","2020-02-10 07:00:00","2020-02-10 07:30:00",3519,864,4383
"2020-02-09 10:11:16","2020-02-10 08:00:00","2020-02-10 08:30:00",4037,1092,5129
"2020-02-09 10:11:16","2020-02-10 09:00:00","2020-02-10 09:30:00",4081,1119,5200
"2020-02-09 10:11:16","2020-02-10 10:00:00","2020-02-10 10:30:00",4127,1136,5263
"2020-02-09 10:11:16","2020-02-10 11:00:00","2020-02-10 11:30:00",4152,1106,5258
"2020-02-09 10:11:16","2020-02-10 12:00:00","2020-02-10 12:30:00",4200,1084,5284
"2020-02-09 10:11:16","2020-02-10 13:00:00","2020-02-10 13:30:00",4203,1076,5279
"2020-02-09 10:11:16","2020-02-10 14:00:00","2020-02-10 14:30:00",4118,1050,5168
"2020-02-09 10:11:16","2020-02-10 15:00:00","2020-02-10 15:30:00",4150,1078,5228
"2020-02-09 10:11:16","2020-02-10 16:00:00","2020-02-10 16:30:00",4197,1112,5309
"2020-02-09 10:11:16","2020-02-10 17:00:00","2020-02-10 17:30:00",4468,1253,5721
"2020-02-09 10:11:16","2020-02-10 18:00:00","2020-02-10 18:30:00",4850,1320,6170
"2020-02-09 10:11:16","2020-02-10 19:00:00","2020-02-10 19:30:00",4701,1182,5883
"2020-02-09 10:11:16","2020-02-10 20:00:00","2020-02-10 20:30:00",4508,1129,5637
"2020-02-09 10:11:16","2020-02-10 21:00:00","2020-02-10 21:30:00",4289,1063,5352
"2020-02-09 10:11:16","2020-02-10 22:00:00","2020-02-10 22:30:00",3870,931,4801
"2020-02-10 10:11:36","2020-02-10 23:00:00","2020-02-10 23:30:00",3603,854,4457
"2020-02-10 10:11:36","2020-02-11 00:00:00","2020-02-11 00:30:00",3366,673,4039
"2020-02-10 10:11:36","2020-02-11 01:00:00","2020-02-11 01:30:00",3153,627,3780
"2020-02-10 10:11:36","2020-02-11 02:00:00","2020-02-11 02:30:00",3020,620,3640
"2020-02-10 10:11:36","2020-02-11 03:00:00","2020-02-11 03:30:00",2943,595,3538
"2020-02-10 10:11:36","2020-02-11 04:00:00","2020-02-11 04:30:00",2914,592,3506
"2020-02-10 10:11:36","2020-02-11 05:00:00","2020-02-11 05:30:00",2919,600,3519
"2020-02-10 10:11:36","2020-02-11 06:00:00","2020-02-11 06:30:00",3128,653,3781
"2020-02-10 10:11:36","2020-02-11 07:00:00","2020-02-11 07:30:00",3717,884,4601
"2020-02-10 10:11:36","2020-02-11 08:00:00","2020-02-11 08:30:00",4221,1096,5317
"2020-02-10 10:11:36","2020-02-11 09:00:00","2020-02-11 09:30:00",4279,1138,5417
"2020-02-10 10:11:36","2020-02-11 10:00:00","2020-02-11 10:30:00",4350,1162,5512
"2020-02-10 10:11:36","2020-02-11 11:00:00","2020-02-11 11:30:00",4305,1152,5457
"2020-02-10 10:11:36","2020-02-11 12:00:00","2020-02-11 12:30:00",4306,1135,5441
"2020-02-10 10:11:36","2020-02-11 13:00:00","2020-02-11 13:30:00",4298,1108,5406
"2020-02-10 10:11:36","2020-02-11 14:00:00","2020-02-11 14:30:00",4133,1077,5210
"2020-02-10 10:11:36","2020-02-11 15:00:00","2020-02-11 15:30:00",4197,1072,5269
"2020-02-10 10:11:36","2020-02-11 16:00:00","2020-02-11 16:30:00",4258,1128,5386
"2020-02-10 10:11:36","2020-02-11 17:00:00","2020-02-11 17:30:00",4486,1265,5751
"2020-02-10 10:11:36","2020-02-11 18:00:00","2020-02-11 18:30:00",4950,1334,6284
"2020-02-10 10:11:36","2020-02-11 19:00:00","2020-02-11 19:30:00",4854,1229,6083
"2020-02-10 10:11:36","2020-02-11 20:00:00","2020-02-11 20:30:00",4625,1161,5786
"2020-02-10 10:11:36","2020-02-11 21:00:00","2020-02-11 21:30:00",4419,1081,5500
"2020-02-10 10:11:36","2020-02-11 22:00:00","2020-02-11 22:30:00",3976,962,4938
"2020-02-11 10:11:26","2020-02-11 23:00:00","2020-02-11 23:30:00",3627,760,4387
"2020-02-11 10:11:26","2020-02-12 00:00:00","2020-02-12 00:30:00",3366,614,3980
"2020-02-11 10:11:26","2020-02-12 01:00:00","2020-02-12 01:30:00",3153,559,3712
"2020-02-11 10:11:26","2020-02-12 02:00:00","2020-02-12 02:30:00",3020,577,3597
"2020-02-11 10:11:26","2020-02-12 03:00:00","2020-02-12 03:30:00",2943,541,3484
"2020-02-11 10:11:26","2020-02-12 04:00:00","2020-02-12 04:30:00",2914,542,3456
"2020-02-11 10:11:26","2020-02-12 05:00:00","2020-02-12 05:30:00",2919,558,3477
"2020-02-11 10:11:26","2020-02-12 06:00:00","2020-02-12 06:30:00",3128,650,3778
"2020-02-11 10:11:26","2020-02-12 07:00:00","2020-02-12 07:30:00",3717,883,4600
"2020-02-11 10:11:26","2020-02-12 08:00:00","2020-02-12 08:30:00",4221,1112,5333
"2020-02-11 10:11:26","2020-02-12 09:00:00","2020-02-12 09:30:00",4279,1167,5446
"2020-02-11 10:11:26","2020-02-12 10:00:00","2020-02-12 10:30:00",4350,1196,5546
"2020-02-11 10:11:26","2020-02-12 11:00:00","2020-02-12 11:30:00",4305,1197,5502
"2020-02-11 10:11:26","2020-02-12 12:00:00","2020-02-12 12:30:00",4306,1194,5500
"2020-02-11 10:11:26","2020-02-12 13:00:00","2020-02-12 13:30:00",4298,1183,5481
"2020-02-11 10:11:26","2020-02-12 14:00:00","2020-02-12 14:30:00",4133,1172,5305
"2020-02-11 10:11:26","2020-02-12 15:00:00","2020-02-12 15:30:00",4197,1191,5388
"2020-02-11 10:11:26","2020-02-12 16:00:00","2020-02-12 16:30:00",4258,1264,5522
"2020-02-11 10:11:26","2020-02-12 17:00:00","2020-02-12 17:30:00",4486,1432,5918
"2020-02-11 10:11:26","2020-02-12 18:00:00","2020-02-12 18:30:00",4950,1464,6414
"2020-02-11 10:11:26","2020-02-12 19:00:00","2020-02-12 19:30:00",4854,1356,6210
"2020-02-11 10:11:26","2020-02-12 20:00:00","2020-02-12 20:30:00",4625,1262,5887
"2020-02-11 10:11:26","2020-02-12 21:00:00","2020-02-12 21:30:00",4419,1174,5593
"2020-02-11 10:11:26","2020-02-12 22:00:00","2020-02-12 22:30:00",3976,1021,4997
"2020-02-12 10:11:26","2020-02-12 23:00:00","2020-02-12 23:30:00",3589,924,4513
"2020-02-12 10:11:26","2020-02-13 00:00:00","2020-02-13 00:30:00",3462,690,4152
"2020-02-12 10:11:26","2020-02-13 01:00:00","2020-02-13 01:30:00",3240,645,3885
"2020-02-12 10:11:26","2020-02-13 02:00:00","2020-02-13 02:30:00",3122,640,3762
"2020-02-12 10:11:26","2020-02-13 03:00:00","2020-02-13 03:30:00",3011,630,3641
"2020-02-12 10:11:26","2020-02-13 04:00:00","2020-02-13 04:30:00",2979,630,3609
"2020-02-12 10:11:26","2020-02-13 05:00:00","2020-02-13 05:30:00",2967,645,3612
"2020-02-12 10:11:26","2020-02-13 06:00:00","2020-02-13 06:30:00",3169,740,3909
"2020-02-12 10:11:26","2020-02-13 07:00:00","2020-02-13 07:30:00",3742,970,4712
"2020-02-12 10:11:26","2020-02-13 08:00:00","2020-02-13 08:30:00",4272,1170,5442
"2020-02-12 10:11:26","2020-02-13 09:00:00","2020-02-13 09:30:00",4263,1240,5503
"2020-02-12 10:11:26","2020-02-13 10:00:00","2020-02-13 10:30:00",4361,1270,5631
"2020-02-12 10:11:26","2020-02-13 11:00:00","2020-02-13 11:30:00",4387,1266,5653
"2020-02-12 10:11:26","2020-02-13 12:00:00","2020-02-13 12:30:00",4336,1270,5606
"2020-02-12 10:11:26","2020-02-13 13:00:00","2020-02-13 13:30:00",4296,1240,5536
"2020-02-12 10:11:26","2020-02-13 14:00:00","2020-02-13 14:30:00",4211,1200,5411
"2020-02-12 10:11:26","2020-02-13 15:00:00","2020-02-13 15:30:00",4220,1210,5430
"2020-02-12 10:11:26","2020-02-13 16:00:00","2020-02-13 16:30:00",4291,1300,5591
"2020-02-12 10:11:26","2020-02-13 17:00:00","2020-02-13 17:30:00",4516,1420,5936
"2020-02-12 10:11:26","2020-02-13 18:00:00","2020-02-13 18:30:00",4924,1460,6384
"2020-02-12 10:11:26","2020-02-13 19:00:00","2020-02-13 19:30:00",4920,1340,6260
"2020-02-12 10:11:26","2020-02-13 20:00:00","2020-02-13 20:30:00",4691,1250,5941
"2020-02-12 10:11:26","2020-02-13 21:00:00","2020-02-13 21:30:00",4439,1133,5572
"2020-02-12 10:11:26","2020-02-13 22:00:00","2020-02-13 22:30:00",4065,980,5045
"2020-02-13 10:11:11","2020-02-13 23:00:00","2020-02-13 23:30:00",3777,813,4590
"2020-02-13 10:11:11","2020-02-14 00:00:00","2020-02-14 00:30:00",3319,663,3982
"2020-02-13 10:11:11","2020-02-14 01:00:00","2020-02-14 01:30:00",3139,620,3759
"2020-02-13 10:11:11","2020-02-14 02:00:00","2020-02-14 02:30:00",3009,616,3625
"2020-02-13 10:11:11","2020-02-14 03:00:00","2020-02-14 03:30:00",2942,590,3532
"2020-02-13 10:11:11","2020-02-14 04:00:00","2020-02-14 04:30:00",2963,610,3573
"2020-02-13 10:11:11","2020-02-14 05:00:00","2020-02-14 05:30:00",2989,660,3649
"2020-02-13 10:11:11","2020-02-14 06:00:00","2020-02-14 06:30:00",3206,775,3981
"2020-02-13 10:11:11","2020-02-14 07:00:00","2020-02-14 07:30:00",3722,990,4712
"2020-02-13 10:11:11","2020-02-14 08:00:00","2020-02-14 08:30:00",4301,1210,5511
"2020-02-13 10:11:11","2020-02-14 09:00:00","2020-02-14 09:30:00",4304,1225,5529
"2020-02-13 10:11:11","2020-02-14 10:00:00","2020-02-14 10:30:00",4342,1205,5547
"2020-02-13 10:11:11","2020-02-14 11:00:00","2020-02-14 11:30:00",4282,1201,5483
"2020-02-13 10:11:11","2020-02-14 12:00:00","2020-02-14 12:30:00",4308,1195,5503
"2020-02-13 10:11:11","2020-02-14 13:00:00","2020-02-14 13:30:00",4310,1165,5475
"2020-02-13 10:11:11","2020-02-14 14:00:00","2020-02-14 14:30:00",4261,1135,5396
"2020-02-13 10:11:11","2020-02-14 15:00:00","2020-02-14 15:30:00",4204,1140,5344
"2020-02-13 10:11:11","2020-02-14 16:00:00","2020-02-14 16:30:00",4292,1205,5497
"2020-02-13 10:11:11","2020-02-14 17:00:00","2020-02-14 17:30:00",4519,1320,5839
"2020-02-13 10:11:11","2020-02-14 18:00:00","2020-02-14 18:30:00",4802,1360,6162
"2020-02-13 10:11:11","2020-02-14 19:00:00","2020-02-14 19:30:00",4648,1270,5918
"2020-02-13 10:11:11","2020-02-14 20:00:00","2020-02-14 20:30:00",4429,1150,5579
"2020-02-13 10:11:11","2020-02-14 21:00:00","2020-02-14 21:30:00",4116,1005,5121
"2020-02-13 10:11:11","2020-02-14 22:00:00","2020-02-14 22:30:00",3767,854,4621
"2020-02-14 10:11:11","2020-02-14 23:00:00","2020-02-14 23:30:00",3520,750,4270
"2020-02-14 10:11:11","2020-02-15 00:00:00","2020-02-15 00:30:00",3410,651,4061
"2020-02-14 10:11:11","2020-02-15 01:00:00","2020-02-15 01:30:00",3120,574,3694
"2020-02-14 10:11:11","2020-02-15 02:00:00","2020-02-15 02:30:00",2949,542,3491
"2020-02-14 10:11:11","2020-02-15 03:00:00","2020-02-15 03:30:00",2824,515,3339
"2020-02-14 10:11:11","2020-02-15 04:00:00","2020-02-15 04:30:00",2836,499,3335
"2020-02-14 10:11:11","2020-02-15 05:00:00","2020-02-15 05:30:00",2800,504,3304
"2020-02-14 10:11:11","2020-02-15 06:00:00","2020-02-15 06:30:00",2880,533,3413
"2020-02-14 10:11:11","2020-02-15 07:00:00","2020-02-15 07:30:00",3122,622,3744
"2020-02-14 10:11:11","2020-02-15 08:00:00","2020-02-15 08:30:00",3368,749,4117
"2020-02-14 10:11:11","2020-02-15 09:00:00","2020-02-15 09:30:00",3703,868,4571
"2020-02-14 10:11:11","2020-02-15 10:00:00","2020-02-15 10:30:00",3899,970,4869
"2020-02-14 10:11:11","2020-02-15 11:00:00","2020-02-15 11:30:00",3982,960,4942
"2020-02-14 10:11:11","2020-02-15 12:00:00","2020-02-15 12:30:00",4000,971,4971
"2020-02-14 10:11:11","2020-02-15 13:00:00","2020-02-15 13:30:00",4005,954,4959
"2020-02-14 10:11:11","2020-02-15 14:00:00","2020-02-15 14:30:00",3971,919,4890
"2020-02-14 10:11:11","2020-02-15 15:00:00","2020-02-15 15:30:00",3931,894,4825
"2020-02-14 10:11:11","2020-02-15 16:00:00","2020-02-15 16:30:00",3939,933,4872
"2020-02-14 10:11:11","2020-02-15 17:00:00","2020-02-15 17:30:00",4168,1040,5208
"2020-02-14 10:11:11","2020-02-15 18:00:00","2020-02-15 18:30:00",4450,1160,5610
"2020-02-14 10:11:11","2020-02-15 19:00:00","2020-02-15 19:30:00",4300,1077,5377
"2020-02-14 10:11:11","2020-02-15 20:00:00","2020-02-15 20:30:00",4047,976,5023
"2020-02-14 10:11:11","2020-02-15 21:00:00","2020-02-15 21:30:00",3892,920,4812
"2020-02-14 10:11:11","2020-02-15 22:00:00","2020-02-15 22:30:00",3646,849,4495
"2020-02-15 10:11:31","2020-02-15 23:00:00","2020-02-15 23:30:00",3458,718,4176
"2020-02-15 10:11:31","2020-02-16 00:00:00","2020-02-16 00:30:00",3263,659,3922
"2020-02-15 10:11:31","2020-02-16 01:00:00","2020-02-16 01:30:00",3032,594,3626
"2020-02-15 10:11:31","2020-02-16 02:00:00","2020-02-16 02:30:00",2878,585,3463
"2020-02-15 10:11:31","2020-02-16 03:00:00","2020-02-16 03:30:00",2751,567,3318
"2020-02-15 10:11:31","2020-02-16 04:00:00","2020-02-16 04:30:00",2702,567,3269
"2020-02-15 10:11:31","2020-02-16 05:00:00","2020-02-16 05:30:00",2701,583,3284
"2020-02-15 10:11:31","2020-02-16 06:00:00","2020-02-16 06:30:00",2744,609,3353
"2020-02-15 10:11:31","2020-02-16 07:00:00","2020-02-16 07:30:00",2860,658,3518
"2020-02-15 10:11:31","2020-02-16 08:00:00","2020-02-16 08:30:00",3029,744,3773
"2020-02-15 10:11:31","2020-02-16 09:00:00","2020-02-16 09:30:00",3165,865,4030
"2020-02-15 10:11:31","2020-02-16 10:00:00","2020-02-16 10:30:00",3440,931,4371
"2020-02-15 10:11:31","2020-02-16 11:00:00","2020-02-16 11:30:00",3694,984,4678
"2020-02-15 10:11:31","2020-02-16 12:00:00","2020-02-16 12:30:00",3782,1027,4809
"2020-02-15 10:11:31","2020-02-16 13:00:00","2020-02-16 13:30:00",3882,1083,4965
"2020-02-15 10:11:31","2020-02-16 14:00:00","2020-02-16 14:30:00",3856,1039,4895
"2020-02-15 10:11:31","2020-02-16 15:00:00","2020-02-16 15:30:00",3777,968,4745
"2020-02-15 10:11:31","2020-02-16 16:00:00","2020-02-16 16:30:00",3786,987,4773
"2020-02-15 10:11:31","2020-02-16 17:00:00","2020-02-16 17:30:00",3946,1074,5020
"2020-02-15 10:11:31","2020-02-16 18:00:00","2020-02-16 18:30:00",4300,1197,5497
"2020-02-15 10:11:31","2020-02-16 19:00:00","2020-02-16 19:30:00",4263,1160,5423
"2020-02-15 10:11:31","2020-02-16 20:00:00","2020-02-16 20:30:00",4031,1068,5099
"2020-02-15 10:11:31","2020-02-16 21:00:00","2020-02-16 21:30:00",3793,947,4740
"2020-02-15 10:11:31","2020-02-16 22:00:00","2020-02-16 22:30:00",3498,849,4347
"2020-02-16 10:11:21","2020-02-16 23:00:00","2020-02-16 23:30:00",3280,735,4015
"2020-02-16 10:11:21","2020-02-17 00:00:00","2020-02-17 00:30:00",3191,609,3800
"2020-02-16 10:11:21","2020-02-17 01:00:00","2020-02-17 01:30:00",2977,567,3544
"2020-02-16 10:11:21","2020-02-17 02:00:00","2020-02-17 02:30:00",2916,562,3478
"2020-02-16 10:11:21","2020-02-17 03:00:00","2020-02-17 03:30:00",2816,549,3365
"2020-02-16 10:11:21","2020-02-17 04:00:00","2020-02-17 04:30:00",2769,547,3316
"2020-02-16 10:11:21","2020-02-17 05:00:00","2020-02-17 05:30:00",2766,564,3330
"2020-02-16 10:11:21","2020-02-17 06:00:00","2020-02-17 06:30:00",3029,661,3690
"2020-02-16 10:11:21","2020-02-17 07:00:00","2020-02-17 07:30:00",3560,898,4458
"2020-02-16 10:11:21","2020-02-17 08:00:00","2020-02-17 08:30:00",3969,1112,5081
"2020-02-16 10:11:21","2020-02-17 09:00:00","2020-02-17 09:30:00",4234,1157,5391
"2020-02-16 10:11:21","2020-02-17 10:00:00","2020-02-17 10:30:00",4258,1235,5493
"2020-02-16 10:11:21","2020-02-17 11:00:00","2020-02-17 11:30:00",4242,1203,5445
"2020-02-16 10:11:21","2020-02-17 12:00:00","2020-02-17 12:30:00",4284,1208,5492
"2020-02-16 10:11:21","2020-02-17 13:00:00","2020-02-17 13:30:00",4319,1185,5504
"2020-02-16 10:11:21","2020-02-17 14:00:00","2020-02-17 14:30:00",4241,1200,5441
"2020-02-16 10:11:21","2020-02-17 15:00:00","2020-02-17 15:30:00",4183,1198,5381
"2020-02-16 10:11:21","2020-02-17 16:00:00","2020-02-17 16:30:00",4242,1197,5439
"2020-02-16 10:11:21","2020-02-17 17:00:00","2020-02-17 17:30:00",4393,1314,5707
"2020-02-16 10:11:21","2020-02-17 18:00:00","2020-02-17 18:30:00",4751,1400,6151
"2020-02-16 10:11:21","2020-02-17 19:00:00","2020-02-17 19:30:00",4820,1299,6119
"2020-02-16 10:11:21","2020-02-17 20:00:00","2020-02-17 20:30:00",4446,1219,5665
"2020-02-16 10:11:21","2020-02-17 21:00:00","2020-02-17 21:30:00",4198,1125,5323
"2020-02-16 10:11:21","2020-02-17 22:00:00","2020-02-17 22:30:00",3845,978,4823
"2020-02-17 10:11:11","2020-02-17 23:00:00","2020-02-17 23:30:00",3506,872,4378
"2020-02-17 10:11:11","2020-02-18 00:00:00","2020-02-18 00:30:00",3269,689,3958
"2020-02-17 10:11:11","2020-02-18 01:00:00","2020-02-18 01:30:00",3051,639,3690
"2020-02-17 10:11:11","2020-02-18 02:00:00","2020-02-18 02:30:00",2921,623,3544
"2020-02-17 10:11:11","2020-02-18 03:00:00","2020-02-18 03:30:00",2855,609,3464
"2020-02-17 10:11:11","2020-02-18 04:00:00","2020-02-18 04:30:00",2851,612,3463
"2020-02-17 10:11:11","2020-02-18 05:00:00","2020-02-18 05:30:00",2880,640,3520
"2020-02-17 10:11:11","2020-02-18 06:00:00","2020-02-18 06:30:00",3053,729,3782
"2020-02-17 10:11:11","2020-02-18 07:00:00","2020-02-18 07:30:00",3514,934,4448
"2020-02-17 10:11:11","2020-02-18 08:00:00","2020-02-18 08:30:00",3925,1141,5066
"2020-02-17 10:11:11","2020-02-18 09:00:00","2020-02-18 09:30:00",4135,1175,5310
"2020-02-17 10:11:11","2020-02-18 10:00:00","2020-02-18 10:30:00",4226,1193,5419
"2020-02-17 10:11:11","2020-02-18 11:00:00","2020-02-18 11:30:00",4271,1183,5454
"2020-02-17 10:11:11","2020-02-18 12:00:00","2020-02-18 12:30:00",4338,1186,5524
"2020-02-17 10:11:11","2020-02-18 13:00:00","2020-02-18 13:30:00",4390,1178,5568
"2020-02-17 10:11:11","2020-02-18 14:00:00","2020-02-18 14:30:00",4341,1145,5486
"2020-02-17 10:11:11","2020-02-18 15:00:00","2020-02-18 15:30:00",4356,1165,5521
"2020-02-17 10:11:11","2020-02-18 16:00:00","2020-02-18 16:30:00",4454,1184,5638
"2020-02-17 10:11:11","2020-02-18 17:00:00","2020-02-18 17:30:00",4607,1323,5930
"2020-02-17 10:11:11","2020-02-18 18:00:00","2020-02-18 18:30:00",4900,1406,6306
"2020-02-17 10:11:11","2020-02-18 19:00:00","2020-02-18 19:30:00",4785,1302,6087
"2020-02-17 10:11:11","2020-02-18 20:00:00","2020-02-18 20:30:00",4529,1235,5764
"2020-02-17 10:11:11","2020-02-18 21:00:00","2020-02-18 21:30:00",4276,1161,5437
"2020-02-17 10:11:11","2020-02-18 22:00:00","2020-02-18 22:30:00",3959,1016,4975
"2020-02-18 10:11:35","2020-02-18 23:00:00","2020-02-18 23:30:00",3637,820,4457
"2020-02-18 10:11:35","2020-02-19 00:00:00","2020-02-19 00:30:00",3452,687,4139
"2020-02-18 10:11:35","2020-02-19 01:00:00","2020-02-19 01:30:00",3217,632,3849
"2020-02-18 10:11:35","2020-02-19 02:00:00","2020-02-19 02:30:00",3011,623,3634
"2020-02-18 10:11:35","2020-02-19 03:00:00","2020-02-19 03:30:00",2911,609,3520
"2020-02-18 10:11:35","2020-02-19 04:00:00","2020-02-19 04:30:00",2874,600,3474
"2020-02-18 10:11:35","2020-02-19 05:00:00","2020-02-19 05:30:00",2888,621,3509
"2020-02-18 10:11:35","2020-02-19 06:00:00","2020-02-19 06:30:00",3103,700,3803
"2020-02-18 10:11:35","2020-02-19 07:00:00","2020-02-19 07:30:00",3665,879,4544
"2020-02-18 10:11:35","2020-02-19 08:00:00","2020-02-19 08:30:00",4120,1038,5158
"2020-02-18 10:11:35","2020-02-19 09:00:00","2020-02-19 09:30:00",4339,1150,5489
"2020-02-18 10:11:35","2020-02-19 10:00:00","2020-02-19 10:30:00",4434,1173,5607
"2020-02-18 10:11:35","2020-02-19 11:00:00","2020-02-19 11:30:00",4417,1174,5591
"2020-02-18 10:11:35","2020-02-19 12:00:00","2020-02-19 12:30:00",4343,1186,5529
"2020-02-18 10:11:35","2020-02-19 13:00:00","2020-02-19 13:30:00",4344,1183,5527
"2020-02-18 10:11:35","2020-02-19 14:00:00","2020-02-19 14:30:00",4243,1168,5411
"2020-02-18 10:11:35","2020-02-19 15:00:00","2020-02-19 15:30:00",4249,1178,5427
"2020-02-18 10:11:35","2020-02-19 16:00:00","2020-02-19 16:30:00",4302,1198,5500
"2020-02-18 10:11:35","2020-02-19 17:00:00","2020-02-19 17:30:00",4465,1313,5778
"2020-02-18 10:11:35","2020-02-19 18:00:00","2020-02-19 18:30:00",4840,1380,6220
"2020-02-18 10:11:35","2020-02-19 19:00:00","2020-02-19 19:30:00",4825,1299,6124
"2020-02-18 10:11:35","2020-02-19 20:00:00","2020-02-19 20:30:00",4586,1205,5791
"2020-02-18 10:11:35","2020-02-19 21:00:00","2020-02-19 21:30:00",4339,1115,5454
"2020-02-18 10:11:35","2020-02-19 22:00:00","2020-02-19 22:30:00",4035,978,5013
"2020-02-19 10:11:26","2020-02-19 23:00:00","2020-02-19 23:30:00",3681,811,4492
"2020-02-19 10:11:26","2020-02-20 00:00:00","2020-02-20 00:30:00",3461,664,4125
"2020-02-19 10:11:26","2020-02-20 01:00:00","2020-02-20 01:30:00",3184,630,3814
"2020-02-19 10:11:26","2020-02-20 02:00:00","2020-02-20 02:30:00",3015,624,3639
"2020-02-19 10:11:26","2020-02-20 03:00:00","2020-02-20 03:30:00",2891,607,3498
"2020-02-19 10:11:26","2020-02-20 04:00:00","2020-02-20 04:30:00",2850,619,3469
"2020-02-19 10:11:26","2020-02-20 05:00:00","2020-02-20 05:30:00",2862,642,3504
"2020-02-19 10:11:26","2020-02-20 06:00:00","2020-02-20 06:30:00",3045,719,3764
"2020-02-19 10:11:26","2020-02-20 07:00:00","2020-02-20 07:30:00",3547,923,4470
"2020-02-19 10:11:26","2020-02-20 08:00:00","2020-02-20 08:30:00",4005,1096,5101
"2020-02-19 10:11:26","2020-02-20 09:00:00","2020-02-20 09:30:00",4233,1182,5415
"2020-02-19 10:11:26","2020-02-20 10:00:00","2020-02-20 10:30:00",4344,1231,5575
"2020-02-19 10:11:26","2020-02-20 11:00:00","2020-02-20 11:30:00",4309,1206,5515
"2020-02-19 10:11:26","2020-02-20 12:00:00","2020-02-20 12:30:00",4317,1204,5521
"2020-02-19 10:11:26","2020-02-20 13:00:00","2020-02-20 13:30:00",4292,1185,5477
"2020-02-19 10:11:26","2020-02-20 14:00:00","2020-02-20 14:30:00",4213,1161,5374
"2020-02-19 10:11:26","2020-02-20 15:00:00","2020-02-20 15:30:00",4204,1174,5378
"2020-02-19 10:11:26","2020-02-20 16:00:00","2020-02-20 16:30:00",4268,1191,5459
"2020-02-19 10:11:26","2020-02-20 17:00:00","2020-02-20 17:30:00",4449,1313,5762
"2020-02-19 10:11:26","2020-02-20 18:00:00","2020-02-20 18:30:00",4809,1389,6198
"2020-02-19 10:11:26","2020-02-20 19:00:00","2020-02-20 19:30:00",4800,1276,6076
"2020-02-19 10:11:26","2020-02-20 20:00:00","2020-02-20 20:30:00",4557,1196,5753
"2020-02-19 10:11:26","2020-02-20 21:00:00","2020-02-20 21:30:00",4345,1116,5461
"2020-02-19 10:11:26","2020-02-20 22:00:00","2020-02-20 22:30:00",3926,978,4904
"2020-02-20 10:11:20","2020-02-20 23:00:00","2020-02-20 23:30:00",3666,883,4549
"2020-02-20 10:11:20","2020-02-21 00:00:00","2020-02-21 00:30:00",3451,692,4143
"2020-02-20 10:11:20","2020-02-21 01:00:00","2020-02-21 01:30:00",3203,636,3839
"2020-02-20 10:11:20","2020-02-21 02:00:00","2020-02-21 02:30:00",3018,612,3630
"2020-02-20 10:11:20","2020-02-21 03:00:00","2020-02-21 03:30:00",2928,594,3522
"2020-02-20 10:11:20","2020-02-21 04:00:00","2020-02-21 04:30:00",2872,581,3453
"2020-02-20 10:11:20","2020-02-21 05:00:00","2020-02-21 05:30:00",2907,584,3491
"2020-02-20 10:11:20","2020-02-21 06:00:00","2020-02-21 06:30:00",3071,657,3728
"2020-02-20 10:11:20","2020-02-21 07:00:00","2020-02-21 07:30:00",3532,884,4416
"2020-02-20 10:11:20","2020-02-21 08:00:00","2020-02-21 08:30:00",3904,1073,4977
"2020-02-20 10:11:20","2020-02-21 09:00:00","2020-02-21 09:30:00",4147,1168,5315
"2020-02-20 10:11:20","2020-02-21 10:00:00","2020-02-21 10:30:00",4319,1225,5544
"2020-02-20 10:11:20","2020-02-21 11:00:00","2020-02-21 11:30:00",4334,1228,5562
"2020-02-20 10:11:20","2020-02-21 12:00:00","2020-02-21 12:30:00",4393,1203,5596
"2020-02-20 10:11:20","2020-02-21 13:00:00","2020-02-21 13:30:00",4332,1143,5475
"2020-02-20 10:11:20","2020-02-21 14:00:00","2020-02-21 14:30:00",4231,1061,5292
"2020-02-20 10:11:20","2020-02-21 15:00:00","2020-02-21 15:30:00",4206,1046,5252
"2020-02-20 10:11:20","2020-02-21 16:00:00","2020-02-21 16:30:00",4198,1055,5253
"2020-02-20 10:11:20","2020-02-21 17:00:00","2020-02-21 17:30:00",4273,1178,5451
"2020-02-20 10:11:20","2020-02-21 18:00:00","2020-02-21 18:30:00",4624,1321,5945
"2020-02-20 10:11:20","2020-02-21 19:00:00","2020-02-21 19:30:00",4674,1227,5901
"2020-02-20 10:11:20","2020-02-21 20:00:00","2020-02-21 20:30:00",4437,1120,5557
"2020-02-20 10:11:20","2020-02-21 21:00:00","2020-02-21 21:30:00",4221,1013,5234
"2020-02-20 10:11:20","2020-02-21 22:00:00","2020-02-21 22:30:00",3864,889,4753
"2020-02-21 10:11:16","2020-02-21 23:00:00","2020-02-21 23:30:00",3600,733,4333
"2020-02-21 10:11:16","2020-02-22 00:00:00","2020-02-22 00:30:00",3483,683,4166
"2020-02-21 10:11:16","2020-02-22 01:00:00","2020-02-22 01:30:00",3236,627,3863
"2020-02-21 10:11:16","2020-02-22 02:00:00","2020-02-22 02:30:00",3001,590,3591
"2020-02-21 10:11:16","2020-02-22 03:00:00","2020-02-22 03:30:00",2848,553,3401
"2020-02-21 10:11:16","2020-02-22 04:00:00","2020-02-22 04:30:00",2804,534,3338
"2020-02-21 10:11:16","2020-02-22 05:00:00","2020-02-22 05:30:00",2754,534,3288
"2020-02-21 10:11:16","2020-02-22 06:00:00","2020-02-22 06:30:00",2829,567,3396
"2020-02-21 10:11:16","2020-02-22 07:00:00","2020-02-22 07:30:00",3057,658,3715
"2020-02-21 10:11:16","2020-02-22 08:00:00","2020-02-22 08:30:00",3338,786,4124
"2020-02-21 10:11:16","2020-02-22 09:00:00","2020-02-22 09:30:00",3616,922,4538
"2020-02-21 10:11:16","2020-02-22 10:00:00","2020-02-22 10:30:00",3824,1037,4861
"2020-02-21 10:11:16","2020-02-22 11:00:00","2020-02-22 11:30:00",3926,1079,5005
"2020-02-21 10:11:16","2020-02-22 12:00:00","2020-02-22 12:30:00",3979,1086,5065
"2020-02-21 10:11:16","2020-02-22 13:00:00","2020-02-22 13:30:00",3993,1101,5094
"2020-02-21 10:11:16","2020-02-22 14:00:00","2020-02-22 14:30:00",3988,1068,5056
"2020-02-21 10:11:16","2020-02-22 15:00:00","2020-02-22 15:30:00",4038,1053,5091
"2020-02-21 10:11:16","2020-02-22 16:00:00","2020-02-22 16:30:00",4015,1045,5060
"2020-02-21 10:11:16","2020-02-22 17:00:00","2020-02-22 17:30:00",4124,1079,5203
"2020-02-21 10:11:16","2020-02-22 18:00:00","2020-02-22 18:30:00",4365,1223,5588
"2020-02-21 10:11:16","2020-02-22 19:00:00","2020-02-22 19:30:00",4283,1168,5451
"2020-02-21 10:11:16","2020-02-22 20:00:00","2020-02-22 20:30:00",4071,1052,5123
"2020-02-21 10:11:16","2020-02-22 21:00:00","2020-02-22 21:30:00",3766,985,4751
"2020-02-21 10:11:16","2020-02-22 22:00:00","2020-02-22 22:30:00",3484,918,4402
"2020-02-22 10:11:10","2020-02-22 23:00:00","2020-02-22 23:30:00",3300,762,4062
"2020-02-22 10:11:10","2020-02-23 00:00:00","2020-02-23 00:30:00",3297,644,3941
"2020-02-22 10:11:10","2020-02-23 01:00:00","2020-02-23 01:30:00",3058,586,3644
"2020-02-22 10:11:10","2020-02-23 02:00:00","2020-02-23 02:30:00",2944,577,3521
"2020-02-22 10:11:10","2020-02-23 03:00:00","2020-02-23 03:30:00",2759,543,3302
"2020-02-22 10:11:10","2020-02-23 04:00:00","2020-02-23 04:30:00",2701,521,3222
"2020-02-22 10:11:10","2020-02-23 05:00:00","2020-02-23 05:30:00",2700,532,3232
"2020-02-22 10:11:10","2020-02-23 06:00:00","2020-02-23 06:30:00",2751,548,3299
"2020-02-22 10:11:10","2020-02-23 07:00:00","2020-02-23 07:30:00",2875,609,3484
"2020-02-22 10:11:10","2020-02-23 08:00:00","2020-02-23 08:30:00",3005,670,3675
"2020-02-22 10:11:10","2020-02-23 09:00:00","2020-02-23 09:30:00",3294,771,4065
"2020-02-22 10:11:10","2020-02-23 10:00:00","2020-02-23 10:30:00",3619,868,4487
"2020-02-22 10:11:10","2020-02-23 11:00:00","2020-02-23 11:30:00",3721,921,4642
"2020-02-22 10:11:10","2020-02-23 12:00:00","2020-02-23 12:30:00",3807,964,4771
"2020-02-22 10:11:10","2020-02-23 13:00:00","2020-02-23 13:30:00",3870,1032,4902
"2020-02-22 10:11:10","2020-02-23 14:00:00","2020-02-23 14:30:00",3805,992,4797
"2020-02-22 10:11:10","2020-02-23 15:00:00","2020-02-23 15:30:00",3709,954,4663
"2020-02-22 10:11:10","2020-02-23 16:00:00","2020-02-23 16:30:00",3670,1030,4700
"2020-02-22 10:11:10","2020-02-23 17:00:00","2020-02-23 17:30:00",3869,1140,5009
"2020-02-22 10:11:10","2020-02-23 18:00:00","2020-02-23 18:30:00",4194,1250,5444
"2020-02-22 10:11:10","2020-02-23 19:00:00","2020-02-23 19:30:00",4266,1157,5423
"2020-02-22 10:11:10","2020-02-23 20:00:00","2020-02-23 20:30:00",4075,1050,5125
"2020-02-22 10:11:10","2020-02-23 21:00:00","2020-02-23 21:30:00",3866,951,4817
"2020-02-22 10:11:10","2020-02-23 22:00:00","2020-02-23 22:30:00",3554,877,4431
"2020-02-23 10:11:36","2020-02-23 23:00:00","2020-02-23 23:30:00",3258,750,4008
"2020-02-23 10:11:36","2020-02-24 00:00:00","2020-02-24 00:30:00",3216,670,3886
"2020-02-23 10:11:36","2020-02-24 01:00:00","2020-02-24 01:30:00",3022,615,3637
"2020-02-23 10:11:36","2020-02-24 02:00:00","2020-02-24 02:30:00",2851,653,3504
"2020-02-23 10:11:36","2020-02-24 03:00:00","2020-02-24 03:30:00",2802,621,3423
"2020-02-23 10:11:36","2020-02-24 04:00:00","2020-02-24 04:30:00",2802,616,3418
"2020-02-23 10:11:36","2020-02-24 05:00:00","2020-02-24 05:30:00",2812,621,3433
"2020-02-23 10:11:36","2020-02-24 06:00:00","2020-02-24 06:30:00",3053,704,3757
"2020-02-23 10:11:36","2020-02-24 07:00:00","2020-02-24 07:30:00",3624,901,4525
"2020-02-23 10:11:36","2020-02-24 08:00:00","2020-02-24 08:30:00",4145,1067,5212
"2020-02-23 10:11:36","2020-02-24 09:00:00","2020-02-24 09:30:00",4242,1170,5412
"2020-02-23 10:11:36","2020-02-24 10:00:00","2020-02-24 10:30:00",4260,1238,5498
"2020-02-23 10:11:36","2020-02-24 11:00:00","2020-02-24 11:30:00",4247,1228,5475
"2020-02-23 10:11:36","2020-02-24 12:00:00","2020-02-24 12:30:00",4198,1192,5390
"2020-02-23 10:11:36","2020-02-24 13:00:00","2020-02-24 13:30:00",4199,1172,5371
"2020-02-23 10:11:36","2020-02-24 14:00:00","2020-02-24 14:30:00",4111,1141,5252
"2020-02-23 10:11:36","2020-02-24 15:00:00","2020-02-24 15:30:00",4122,1105,5227
"2020-02-23 10:11:36","2020-02-24 16:00:00","2020-02-24 16:30:00",4160,1126,5286
"2020-02-23 10:11:36","2020-02-24 17:00:00","2020-02-24 17:30:00",4325,1248,5573
"2020-02-23 10:11:36","2020-02-24 18:00:00","2020-02-24 18:30:00",4541,1354,5895
"2020-02-23 10:11:36","2020-02-24 19:00:00","2020-02-24 19:30:00",4768,1251,6019
"2020-02-23 10:11:36","2020-02-24 20:00:00","2020-02-24 20:30:00",4525,1150,5675
"2020-02-23 10:11:36","2020-02-24 21:00:00","2020-02-24 21:30:00",4277,1068,5345
"2020-02-23 10:11:36","2020-02-24 22:00:00","2020-02-24 22:30:00",3875,964,4839
"2020-02-24 10:11:26","2020-02-24 23:00:00","2020-02-24 23:30:00",3550,820,4370
"2020-02-24 10:11:26","2020-02-25 00:00:00","2020-02-25 00:30:00",3354,702,4056
"2020-02-24 10:11:26","2020-02-25 01:00:00","2020-02-25 01:30:00",3108,654,3762
"2020-02-24 10:11:26","2020-02-25 02:00:00","2020-02-25 02:30:00",2964,656,3620
"2020-02-24 10:11:26","2020-02-25 03:00:00","2020-02-25 03:30:00",2907,652,3559
"2020-02-24 10:11:26","2020-02-25 04:00:00","2020-02-25 04:30:00",2906,672,3578
"2020-02-24 10:11:26","2020-02-25 05:00:00","2020-02-25 05:30:00",2908,660,3568
"2020-02-24 10:11:26","2020-02-25 06:00:00","2020-02-25 06:30:00",3113,740,3853
"2020-02-24 10:11:26","2020-02-25 07:00:00","2020-02-25 07:30:00",3724,912,4636
"2020-02-24 10:11:26","2020-02-25 08:00:00","2020-02-25 08:30:00",4227,1073,5300
"2020-02-24 10:11:26","2020-02-25 09:00:00","2020-02-25 09:30:00",4305,1177,5482
"2020-02-24 10:11:26","2020-02-25 10:00:00","2020-02-25 10:30:00",4372,1224,5596
"2020-02-24 10:11:26","2020-02-25 11:00:00","2020-02-25 11:30:00",4321,1198,5519
"2020-02-24 10:11:26","2020-02-25 12:00:00","2020-02-25 12:30:00",4259,1182,5441
"2020-02-24 10:11:26","2020-02-25 13:00:00","2020-02-25 13:30:00",4248,1189,5437
"2020-02-24 10:11:26","2020-02-25 14:00:00","2020-02-25 14:30:00",4137,1158,5295
"2020-02-24 10:11:26","2020-02-25 15:00:00","2020-02-25 15:30:00",4123,1170,5293
"2020-02-24 10:11:26","2020-02-25 16:00:00","2020-02-25 16:30:00",4170,1171,5341
"2020-02-24 10:11:26","2020-02-25 17:00:00","2020-02-25 17:30:00",4359,1302,5661
"2020-02-24 10:11:26","2020-02-25 18:00:00","2020-02-25 18:30:00",4632,1387,6019
"2020-02-24 10:11:26","2020-02-25 19:00:00","2020-02-25 19:30:00",4880,1326,6206
"2020-02-24 10:11:26","2020-02-25 20:00:00","2020-02-25 20:30:00",4640,1259,5899
"2020-02-24 10:11:26","2020-02-25 21:00:00","2020-02-25 21:30:00",4376,1169,5545
"2020-02-24 10:11:26","2020-02-25 22:00:00","2020-02-25 22:30:00",4008,1013,5021
"2020-02-25 10:11:21","2020-02-25 23:00:00","2020-02-25 23:30:00",3713,771,4484
"2020-02-25 10:11:21","2020-02-26 00:00:00","2020-02-26 00:30:00",3410,738,4148
"2020-02-25 10:11:21","2020-02-26 01:00:00","2020-02-26 01:30:00",3174,685,3859
"2020-02-25 10:11:21","2020-02-26 02:00:00","2020-02-26 02:30:00",3023,678,3701
"2020-02-25 10:11:21","2020-02-26 03:00:00","2020-02-26 03:30:00",2919,662,3581
"2020-02-25 10:11:21","2020-02-26 04:00:00","2020-02-26 04:30:00",2891,685,3576
"2020-02-25 10:11:21","2020-02-26 05:00:00","2020-02-26 05:30:00",2882,663,3545
"2020-02-25 10:11:21","2020-02-26 06:00:00","2020-02-26 06:30:00",3070,742,3812
"2020-02-25 10:11:21","2020-02-26 07:00:00","2020-02-26 07:30:00",3656,916,4572
"2020-02-25 10:11:21","2020-02-26 08:00:00","2020-02-26 08:30:00",4128,1090,5218
"2020-02-25 10:11:21","2020-02-26 09:00:00","2020-02-26 09:30:00",4240,1201,5441
"2020-02-25 10:11:21","2020-02-26 10:00:00","2020-02-26 10:30:00",4333,1234,5567
"2020-02-25 10:11:21","2020-02-26 11:00:00","2020-02-26 11:30:00",4302,1222,5524
"2020-02-25 10:11:21","2020-02-26 12:00:00","2020-02-26 12:30:00",4312,1207,5519
"2020-02-25 10:11:21","2020-02-26 13:00:00","2020-02-26 13:30:00",4301,1214,5515
"2020-02-25 10:11:21","2020-02-26 14:00:00","2020-02-26 14:30:00",4202,1170,5372
"2020-02-25 10:11:21","2020-02-26 15:00:00","2020-02-26 15:30:00",4193,1184,5377
"2020-02-25 10:11:21","2020-02-26 16:00:00","2020-02-26 16:30:00",4291,1195,5486
"2020-02-25 10:11:21","2020-02-26 17:00:00","2020-02-26 17:30:00",4455,1334,5789
"2020-02-25 10:11:21","2020-02-26 18:00:00","2020-02-26 18:30:00",4647,1425,6072
"2020-02-25 10:11:21","2020-02-26 19:00:00","2020-02-26 19:30:00",4847,1354,6201
"2020-02-25 10:11:21","2020-02-26 20:00:00","2020-02-26 20:30:00",4663,1270,5933
"2020-02-25 10:11:21","2020-02-26 21:00:00","2020-02-26 21:30:00",4397,1196,5593
"2020-02-25 10:11:21","2020-02-26 22:00:00","2020-02-26 22:30:00",4024,1042,5066
"2020-02-26 10:11:16","2020-02-26 23:00:00","2020-02-26 23:30:00",3713,888,4601
"2020-02-26 10:11:16","2020-02-27 00:00:00","2020-02-27 00:30:00",3410,748,4158
"2020-02-26 10:11:16","2020-02-27 01:00:00","2020-02-27 01:30:00",3174,695,3869
"2020-02-26 10:11:16","2020-02-27 02:00:00","2020-02-27 02:30:00",3023,688,3711
"2020-02-26 10:11:16","2020-02-27 03:00:00","2020-02-27 03:30:00",2919,671,3590
"2020-02-26 10:11:16","2020-02-27 04:00:00","2020-02-27 04:30:00",2891,677,3568
"2020-02-26 10:11:16","2020-02-27 05:00:00","2020-02-27 05:30:00",2882,677,3559
"2020-02-26 10:11:16","2020-02-27 06:00:00","2020-02-27 06:30:00",3070,758,3828
"2020-02-26 10:11:16","2020-02-27 07:00:00","2020-02-27 07:30:00",3656,954,4610
"2020-02-26 10:11:16","2020-02-27 08:00:00","2020-02-27 08:30:00",4128,1102,5230
"2020-02-26 10:11:16","2020-02-27 09:00:00","2020-02-27 09:30:00",4240,1188,5428
"2020-02-26 10:11:16","2020-02-27 10:00:00","2020-02-27 10:30:00",4333,1213,5546
"2020-02-26 10:11:16","2020-02-27 11:00:00","2020-02-27 11:30:00",4302,1191,5493
"2020-02-26 10:11:16","2020-02-27 12:00:00","2020-02-27 12:30:00",4312,1163,5475
"2020-02-26 10:11:16","2020-02-27 13:00:00","2020-02-27 13:30:00",4301,1170,5471
"2020-02-26 10:11:16","2020-02-27 14:00:00","2020-02-27 14:30:00",4202,1130,5332
"2020-02-26 10:11:16","2020-02-27 15:00:00","2020-02-27 15:30:00",4193,1116,5309
"2020-02-26 10:11:16","2020-02-27 16:00:00","2020-02-27 16:30:00",4291,1159,5450
"2020-02-26 10:11:16","2020-02-27 17:00:00","2020-02-27 17:30:00",4455,1285,5740
"2020-02-26 10:11:16","2020-02-27 18:00:00","2020-02-27 18:30:00",4647,1376,6023
"2020-02-26 10:11:16","2020-02-27 19:00:00","2020-02-27 19:30:00",4847,1332,6179
"2020-02-26 10:11:16","2020-02-27 20:00:00","2020-02-27 20:30:00",4663,1236,5899
"2020-02-26 10:11:16","2020-02-27 21:00:00","2020-02-27 21:30:00",4397,1173,5570
"2020-02-26 10:11:16","2020-02-27 22:00:00","2020-02-27 22:30:00",4024,1034,5058
"2020-02-27 10:11:11","2020-02-27 23:00:00","2020-02-27 23:30:00",3713,913,4626
"2020-02-27 10:11:11","2020-02-28 00:00:00","2020-02-28 00:30:00",3389,745,4134
"2020-02-27 10:11:11","2020-02-28 01:00:00","2020-02-28 01:30:00",3130,674,3804
"2020-02-27 10:11:11","2020-02-28 02:00:00","2020-02-28 02:30:00",2972,668,3640
"2020-02-27 10:11:11","2020-02-28 03:00:00","2020-02-28 03:30:00",2870,633,3503
"2020-02-27 10:11:11","2020-02-28 04:00:00","2020-02-28 04:30:00",2830,620,3450
"2020-02-27 10:11:11","2020-02-28 05:00:00","2020-02-28 05:30:00",2873,622,3495
"2020-02-27 10:11:11","2020-02-28 06:00:00","2020-02-28 06:30:00",3131,699,3830
"2020-02-27 10:11:11","2020-02-28 07:00:00","2020-02-28 07:30:00",3672,921,4593
"2020-02-27 10:11:11","2020-02-28 08:00:00","2020-02-28 08:30:00",4143,1152,5295
"2020-02-27 10:11:11","2020-02-28 09:00:00","2020-02-28 09:30:00",4197,1214,5411
"2020-02-27 10:11:11","2020-02-28 10:00:00","2020-02-28 10:30:00",4254,1250,5504
"2020-02-27 10:11:11","2020-02-28 11:00:00","2020-02-28 11:30:00",4223,1257,5480
"2020-02-27 10:11:11","2020-02-28 12:00:00","2020-02-28 12:30:00",4232,1240,5472
"2020-02-27 10:11:11","2020-02-28 13:00:00","2020-02-28 13:30:00",4232,1230,5462
"2020-02-27 10:11:11","2020-02-28 14:00:00","2020-02-28 14:30:00",4173,1167,5340
"2020-02-27 10:11:11","2020-02-28 15:00:00","2020-02-28 15:30:00",4240,1159,5399
"2020-02-27 10:11:11","2020-02-28 16:00:00","2020-02-28 16:30:00",4345,1184,5529
"2020-02-27 10:11:11","2020-02-28 17:00:00","2020-02-28 17:30:00",4479,1295,5774
"2020-02-27 10:11:11","2020-02-28 18:00:00","2020-02-28 18:30:00",4680,1360,6040
"2020-02-27 10:11:11","2020-02-28 19:00:00","2020-02-28 19:30:00",4728,1336,6064
"2020-02-27 10:11:11","2020-02-28 20:00:00","2020-02-28 20:30:00",4462,1229,5691
"2020-02-27 10:11:11","2020-02-28 21:00:00","2020-02-28 21:30:00",4210,1141,5351
"2020-02-27 10:11:11","2020-02-28 22:00:00","2020-02-28 22:30:00",3872,995,4867
"2020-02-28 10:11:26","2020-02-28 23:00:00","2020-02-28 23:30:00",3633,840,4473
"2020-02-28 10:11:26","2020-02-29 00:00:00","2020-02-29 00:30:00",3463,678,4141
"2020-02-28 10:11:26","2020-02-29 01:00:00","2020-02-29 01:30:00",3199,615,3814
"2020-02-28 10:11:26","2020-02-29 02:00:00","2020-02-29 02:30:00",2980,584,3564
"2020-02-28 10:11:26","2020-02-29 03:00:00","2020-02-29 03:30:00",2846,552,3398
"2020-02-28 10:11:26","2020-02-29 04:00:00","2020-02-29 04:30:00",2770,554,3324
"2020-02-28 10:11:26","2020-02-29 05:00:00","2020-02-29 05:30:00",2750,529,3279
"2020-02-28 10:11:26","2020-02-29 06:00:00","2020-02-29 06:30:00",2838,570,3408
"2020-02-28 10:11:26","2020-02-29 07:00:00","2020-02-29 07:30:00",3020,663,3683
"2020-02-28 10:11:26","2020-02-29 08:00:00","2020-02-29 08:30:00",3192,756,3948
"2020-02-28 10:11:26","2020-02-29 09:00:00","2020-02-29 09:30:00",3515,898,4413
"2020-02-28 10:11:26","2020-02-29 10:00:00","2020-02-29 10:30:00",3777,978,4755
"2020-02-28 10:11:26","2020-02-29 11:00:00","2020-02-29 11:30:00",3859,1029,4888
"2020-02-28 10:11:26","2020-02-29 12:00:00","2020-02-29 12:30:00",3914,1024,4938
"2020-02-28 10:11:26","2020-02-29 13:00:00","2020-02-29 13:30:00",3969,1020,4989
"2020-02-28 10:11:26","2020-02-29 14:00:00","2020-02-29 14:30:00",3846,999,4845
"2020-02-28 10:11:26","2020-02-29 15:00:00","2020-02-29 15:30:00",3845,984,4829
"2020-02-28 10:11:26","2020-02-29 16:00:00","2020-02-29 16:30:00",3890,996,4886
"2020-02-28 10:11:26","2020-02-29 17:00:00","2020-02-29 17:30:00",4039,1076,5115
"2020-02-28 10:11:26","2020-02-29 18:00:00","2020-02-29 18:30:00",4309,1179,5488
"2020-02-28 10:11:26","2020-02-29 19:00:00","2020-02-29 19:30:00",4333,1118,5451
"2020-02-28 10:11:26","2020-02-29 20:00:00","2020-02-29 20:30:00",3998,1019,5017
"2020-02-28 10:11:26","2020-02-29 21:00:00","2020-02-29 21:30:00",3742,997,4739
"2020-02-28 10:11:26","2020-02-29 22:00:00","2020-02-29 22:30:00",3492,897,4389
"2020-02-29 10:11:21","2020-02-29 23:00:00","2020-02-29 23:30:00",3339,791,4130
"2020-02-29 10:11:21","2020-03-01 00:00:00","2020-03-01 00:30:00",3301,708,4009
"2020-02-29 10:11:21","2020-03-01 01:00:00","2020-03-01 01:30:00",3120,660,3780
"2020-02-29 10:11:21","2020-03-01 02:00:00","2020-03-01 02:30:00",2958,653,3611
"2020-02-29 10:11:21","2020-03-01 03:00:00","2020-03-01 03:30:00",2852,613,3465
"2020-02-29 10:11:21","2020-03-01 04:00:00","2020-03-01 04:30:00",2784,589,3373
"2020-02-29 10:11:21","2020-03-01 05:00:00","2020-03-01 05:30:00",2735,602,3337
"2020-02-29 10:11:21","2020-03-01 06:00:00","2020-03-01 06:30:00",2774,606,3380
"2020-02-29 10:11:21","2020-03-01 07:00:00","2020-03-01 07:30:00",2846,649,3495
"2020-02-29 10:11:21","2020-03-01 08:00:00","2020-03-01 08:30:00",2918,740,3658
"2020-02-29 10:11:21","2020-03-01 09:00:00","2020-03-01 09:30:00",3257,812,4069
"2020-02-29 10:11:21","2020-03-01 10:00:00","2020-03-01 10:30:00",3488,891,4379
"2020-02-29 10:11:21","2020-03-01 11:00:00","2020-03-01 11:30:00",3614,925,4539
"2020-02-29 10:11:21","2020-03-01 12:00:00","2020-03-01 12:30:00",3757,929,4686
"2020-02-29 10:11:21","2020-03-01 13:00:00","2020-03-01 13:30:00",3852,1003,4855
"2020-02-29 10:11:21","2020-03-01 14:00:00","2020-03-01 14:30:00",3872,926,4798
"2020-02-29 10:11:21","2020-03-01 15:00:00","2020-03-01 15:30:00",3823,904,4727
"2020-02-29 10:11:21","2020-03-01 16:00:00","2020-03-01 16:30:00",3848,970,4818
"2020-02-29 10:11:21","2020-03-01 17:00:00","2020-03-01 17:30:00",3877,1091,4968
"2020-02-29 10:11:21","2020-03-01 18:00:00","2020-03-01 18:30:00",4215,1220,5435
"2020-02-29 10:11:21","2020-03-01 19:00:00","2020-03-01 19:30:00",4249,1204,5453
"2020-02-29 10:11:21","2020-03-01 20:00:00","2020-03-01 20:30:00",4045,1137,5182
"2020-02-29 10:11:21","2020-03-01 21:00:00","2020-03-01 21:30:00",3797,1021,4818
"2020-02-29 10:11:21","2020-03-01 22:00:00","2020-03-01 22:30:00",3482,929,4411
"2020-03-01 10:11:10","2020-03-01 23:00:00","2020-03-01 23:30:00",3370,771,4141
"2020-03-01 10:11:10","2020-03-02 00:00:00","2020-03-02 00:30:00",3223,684,3907
"2020-03-01 10:11:10","2020-03-02 01:00:00","2020-03-02 01:30:00",3033,666,3699
"2020-03-01 10:11:10","2020-03-02 02:00:00","2020-03-02 02:30:00",2880,653,3533
"2020-03-01 10:11:10","2020-03-02 03:00:00","2020-03-02 03:30:00",2813,586,3399
"2020-03-01 10:11:10","2020-03-02 04:00:00","2020-03-02 04:30:00",2765,591,3356
"2020-03-01 10:11:10","2020-03-02 05:00:00","2020-03-02 05:30:00",2769,610,3379
"2020-03-01 10:11:10","2020-03-02 06:00:00","2020-03-02 06:30:00",2935,710,3645
"2020-03-01 10:11:10","2020-03-02 07:00:00","2020-03-02 07:30:00",3413,933,4346
"2020-03-01 10:11:10","2020-03-02 08:00:00","2020-03-02 08:30:00",3876,1150,5026
"2020-03-01 10:11:10","2020-03-02 09:00:00","2020-03-02 09:30:00",4068,1187,5255
"2020-03-01 10:11:10","2020-03-02 10:00:00","2020-03-02 10:30:00",4235,1185,5420
"2020-03-01 10:11:10","2020-03-02 11:00:00","2020-03-02 11:30:00",4269,1218,5487
"2020-03-01 10:11:10","2020-03-02 12:00:00","2020-03-02 12:30:00",4256,1172,5428
"2020-03-01 10:11:10","2020-03-02 13:00:00","2020-03-02 13:30:00",4290,1214,5504
"2020-03-01 10:11:10","2020-03-02 14:00:00","2020-03-02 14:30:00",4195,1143,5338
"2020-03-01 10:11:10","2020-03-02 15:00:00","2020-03-02 15:30:00",4224,1128,5352
"2020-03-01 10:11:10","2020-03-02 16:00:00","2020-03-02 16:30:00",4280,1170,5450
"2020-03-01 10:11:10","2020-03-02 17:00:00","2020-03-02 17:30:00",4423,1297,5720
"2020-03-01 10:11:10","2020-03-02 18:00:00","2020-03-02 18:30:00",4585,1328,5913
"2020-03-01 10:11:10","2020-03-02 19:00:00","2020-03-02 19:30:00",4721,1292,6013
"2020-03-01 10:11:10","2020-03-02 20:00:00","2020-03-02 20:30:00",4501,1211,5712
"2020-03-01 10:11:10","2020-03-02 21:00:00","2020-03-02 21:30:00",4250,1121,5371
"2020-03-01 10:11:10","2020-03-02 22:00:00","2020-03-02 22:30:00",3865,959,4824
"2020-03-02 10:11:31","2020-03-02 23:00:00","2020-03-02 23:30:00",3536,874,4410
"2020-03-02 10:11:31","2020-03-03 00:00:00","2020-03-03 00:30:00",3392,705,4097
"2020-03-02 10:11:31","2020-03-03 01:00:00","2020-03-03 01:30:00",3146,655,3801
"2020-03-02 10:11:31","2020-03-03 02:00:00","2020-03-03 02:30:00",2991,640,3631
"2020-03-02 10:11:31","2020-03-03 03:00:00","2020-03-03 03:30:00",2911,628,3539
"2020-03-02 10:11:31","2020-03-03 04:00:00","2020-03-03 04:30:00",2876,620,3496
"2020-03-02 10:11:31","2020-03-03 05:00:00","2020-03-03 05:30:00",2869,628,3497
"2020-03-02 10:11:31","2020-03-03 06:00:00","2020-03-03 06:30:00",3043,735,3778
"2020-03-02 10:11:31","2020-03-03 07:00:00","2020-03-03 07:30:00",3584,952,4536
"2020-03-02 10:11:31","2020-03-03 08:00:00","2020-03-03 08:30:00",4077,1130,5207
"2020-03-02 10:11:31","2020-03-03 09:00:00","2020-03-03 09:30:00",4198,1200,5398
"2020-03-02 10:11:31","2020-03-03 10:00:00","2020-03-03 10:30:00",4298,1225,5523
"2020-03-02 10:11:31","2020-03-03 11:00:00","2020-03-03 11:30:00",4272,1190,5462
"2020-03-02 10:11:31","2020-03-03 12:00:00","2020-03-03 12:30:00",4241,1170,5411
"2020-03-02 10:11:31","2020-03-03 13:00:00","2020-03-03 13:30:00",4227,1166,5393
"2020-03-02 10:11:31","2020-03-03 14:00:00","2020-03-03 14:30:00",4143,1134,5277
"2020-03-02 10:11:31","2020-03-03 15:00:00","2020-03-03 15:30:00",4138,1131,5269
"2020-03-02 10:11:31","2020-03-03 16:00:00","2020-03-03 16:30:00",4201,1165,5366
"2020-03-02 10:11:31","2020-03-03 17:00:00","2020-03-03 17:30:00",4358,1279,5637
"2020-03-02 10:11:31","2020-03-03 18:00:00","2020-03-03 18:30:00",4507,1352,5859
"2020-03-02 10:11:31","2020-03-03 19:00:00","2020-03-03 19:30:00",4750,1299,6049
"2020-03-02 10:11:31","2020-03-03 20:00:00","2020-03-03 20:30:00",4574,1204,5778
"2020-03-02 10:11:31","2020-03-03 21:00:00","2020-03-03 21:30:00",4295,1136,5431
"2020-03-02 10:11:31","2020-03-03 22:00:00","2020-03-03 22:30:00",3921,999,4920
"2020-03-03 10:11:21","2020-03-03 23:00:00","2020-03-03 23:30:00",3496,845,4341
"2020-03-03 10:11:21","2020-03-04 00:00:00","2020-03-04 00:30:00",3398,711,4109
"2020-03-03 10:11:21","2020-03-04 01:00:00","2020-03-04 01:30:00",3155,660,3815
"2020-03-03 10:11:21","2020-03-04 02:00:00","2020-03-04 02:30:00",2996,645,3641
"2020-03-03 10:11:21","2020-03-04 03:00:00","2020-03-04 03:30:00",2903,633,3536
"2020-03-03 10:11:21","2020-03-04 04:00:00","2020-03-04 04:30:00",2880,625,3505
"2020-03-03 10:11:21","2020-03-04 05:00:00","2020-03-04 05:30:00",2914,633,3547
"2020-03-03 10:11:21","2020-03-04 06:00:00","2020-03-04 06:30:00",3120,730,3850
"2020-03-03 10:11:21","2020-03-04 07:00:00","2020-03-04 07:30:00",3720,940,4660
"2020-03-03 10:11:21","2020-03-04 08:00:00","2020-03-04 08:30:00",4150,1120,5270
"2020-03-03 10:11:21","2020-03-04 09:00:00","2020-03-04 09:30:00",4190,1180,5370
"2020-03-03 10:11:21","2020-03-04 10:00:00","2020-03-04 10:30:00",4230,1200,5430
"2020-03-03 10:11:21","2020-03-04 11:00:00","2020-03-04 11:30:00",4220,1182,5402
"2020-03-03 10:11:21","2020-03-04 12:00:00","2020-03-04 12:30:00",4215,1171,5386
"2020-03-03 10:11:21","2020-03-04 13:00:00","2020-03-04 13:30:00",4230,1170,5400
"2020-03-03 10:11:21","2020-03-04 14:00:00","2020-03-04 14:30:00",4170,1137,5307
"2020-03-03 10:11:21","2020-03-04 15:00:00","2020-03-04 15:30:00",4170,1134,5304
"2020-03-03 10:11:21","2020-03-04 16:00:00","2020-03-04 16:30:00",4233,1168,5401
"2020-03-03 10:11:21","2020-03-04 17:00:00","2020-03-04 17:30:00",4464,1282,5746
"2020-03-03 10:11:21","2020-03-04 18:00:00","2020-03-04 18:30:00",4679,1355,6034
"2020-03-03 10:11:21","2020-03-04 19:00:00","2020-03-04 19:30:00",4756,1302,6058
"2020-03-03 10:11:21","2020-03-04 20:00:00","2020-03-04 20:30:00",4566,1207,5773
"2020-03-03 10:11:21","2020-03-04 21:00:00","2020-03-04 21:30:00",4341,1138,5479
"2020-03-03 10:11:21","2020-03-04 22:00:00","2020-03-04 22:30:00",3916,1001,4917
"2020-03-04 10:11:11","2020-03-04 23:00:00","2020-03-04 23:30:00",3496,876,4372
"2020-03-04 10:11:11","2020-03-05 00:00:00","2020-03-05 00:30:00",3456,711,4167
"2020-03-04 10:11:11","2020-03-05 01:00:00","2020-03-05 01:30:00",3186,660,3846
"2020-03-04 10:11:11","2020-03-05 02:00:00","2020-03-05 02:30:00",2971,645,3616
"2020-03-04 10:11:11","2020-03-05 03:00:00","2020-03-05 03:30:00",2842,633,3475
"2020-03-04 10:11:11","2020-03-05 04:00:00","2020-03-05 04:30:00",2802,625,3427
"2020-03-04 10:11:11","2020-03-05 05:00:00","2020-03-05 05:30:00",2800,633,3433
"2020-03-04 10:11:11","2020-03-05 06:00:00","2020-03-05 06:30:00",2986,724,3710
"2020-03-04 10:11:11","2020-03-05 07:00:00","2020-03-05 07:30:00",3576,909,4485
"2020-03-04 10:11:11","2020-03-05 08:00:00","2020-03-05 08:30:00",4116,1057,5173
"2020-03-04 10:11:11","2020-03-05 09:00:00","2020-03-05 09:30:00",4182,1144,5326
"2020-03-04 10:11:11","2020-03-05 10:00:00","2020-03-05 10:30:00",4281,1183,5464
"2020-03-04 10:11:11","2020-03-05 11:00:00","2020-03-05 11:30:00",4267,1179,5446
"2020-03-04 10:11:11","2020-03-05 12:00:00","2020-03-05 12:30:00",4259,1171,5430
"2020-03-04 10:11:11","2020-03-05 13:00:00","2020-03-05 13:30:00",4224,1170,5394
"2020-03-04 10:11:11","2020-03-05 14:00:00","2020-03-05 14:30:00",4106,1137,5243
"2020-03-04 10:11:11","2020-03-05 15:00:00","2020-03-05 15:30:00",4118,1134,5252
"2020-03-04 10:11:11","2020-03-05 16:00:00","2020-03-05 16:30:00",4117,1168,5285
"2020-03-04 10:11:11","2020-03-05 17:00:00","2020-03-05 17:30:00",4259,1282,5541
"2020-03-04 10:11:11","2020-03-05 18:00:00","2020-03-05 18:30:00",4365,1355,5720
"2020-03-04 10:11:11","2020-03-05 19:00:00","2020-03-05 19:30:00",4750,1302,6052
"2020-03-04 10:11:11","2020-03-05 20:00:00","2020-03-05 20:30:00",4641,1207,5848
"2020-03-04 10:11:11","2020-03-05 21:00:00","2020-03-05 21:30:00",4411,1138,5549
"2020-03-04 10:11:11","2020-03-05 22:00:00","2020-03-05 22:30:00",3961,1001,4962
"2020-03-05 10:11:35","2020-03-05 23:00:00","2020-03-05 23:30:00",3559,839,4398
"2020-03-05 10:11:35","2020-03-06 00:00:00","2020-03-06 00:30:00",3290,732,4022
"2020-03-05 10:11:35","2020-03-06 01:00:00","2020-03-06 01:30:00",3118,654,3772
"2020-03-05 10:11:35","2020-03-06 02:00:00","2020-03-06 02:30:00",3015,633,3648
"2020-03-05 10:11:35","2020-03-06 03:00:00","2020-03-06 03:30:00",2904,603,3507
"2020-03-05 10:11:35","2020-03-06 04:00:00","2020-03-06 04:30:00",2880,589,3469
"2020-03-05 10:11:35","2020-03-06 05:00:00","2020-03-06 05:30:00",2899,596,3495
"2020-03-05 10:11:35","2020-03-06 06:00:00","2020-03-06 06:30:00",3099,666,3765
"2020-03-05 10:11:35","2020-03-06 07:00:00","2020-03-06 07:30:00",3648,881,4529
"2020-03-05 10:11:35","2020-03-06 08:00:00","2020-03-06 08:30:00",4102,1045,5147
"2020-03-05 10:11:35","2020-03-06 09:00:00","2020-03-06 09:30:00",4253,1170,5423
"2020-03-05 10:11:35","2020-03-06 10:00:00","2020-03-06 10:30:00",4314,1210,5524
"2020-03-05 10:11:35","2020-03-06 11:00:00","2020-03-06 11:30:00",4303,1219,5522
"2020-03-05 10:11:35","2020-03-06 12:00:00","2020-03-06 12:30:00",4244,1211,5455
"2020-03-05 10:11:35","2020-03-06 13:00:00","2020-03-06 13:30:00",4260,1178,5438
"2020-03-05 10:11:35","2020-03-06 14:00:00","2020-03-06 14:30:00",4133,1125,5258
"2020-03-05 10:11:35","2020-03-06 15:00:00","2020-03-06 15:30:00",4077,1086,5163
"2020-03-05 10:11:35","2020-03-06 16:00:00","2020-03-06 16:30:00",4071,1102,5173
"2020-03-05 10:11:35","2020-03-06 17:00:00","2020-03-06 17:30:00",4210,1204,5414
"2020-03-05 10:11:35","2020-03-06 18:00:00","2020-03-06 18:30:00",4393,1331,5724
"2020-03-05 10:11:35","2020-03-06 19:00:00","2020-03-06 19:30:00",4550,1274,5824
"2020-03-05 10:11:35","2020-03-06 20:00:00","2020-03-06 20:30:00",4298,1168,5466
"2020-03-05 10:11:35","2020-03-06 21:00:00","2020-03-06 21:30:00",4074,1075,5149
"2020-03-05 10:11:35","2020-03-06 22:00:00","2020-03-06 22:30:00",3706,945,4651
"2020-03-06 10:11:31","2020-03-06 23:00:00","2020-03-06 23:30:00",3486,872,4358
"2020-03-06 10:11:31","2020-03-07 00:00:00","2020-03-07 00:30:00",3355,696,4051
"2020-03-06 10:11:31","2020-03-07 01:00:00","2020-03-07 01:30:00",3107,635,3742
"2020-03-06 10:11:31","2020-03-07 02:00:00","2020-03-07 02:30:00",2921,607,3528
"2020-03-06 10:11:31","2020-03-07 03:00:00","2020-03-07 03:30:00",2809,570,3379
"2020-03-06 10:11:31","2020-03-07 04:00:00","2020-03-07 04:30:00",2780,570,3350
"2020-03-06 10:11:31","2020-03-07 05:00:00","2020-03-07 05:30:00",2816,549,3365
"2020-03-06 10:11:31","2020-03-07 06:00:00","2020-03-07 06:30:00",2864,585,3449
"2020-03-06 10:11:31","2020-03-07 07:00:00","2020-03-07 07:30:00",3053,680,3733
"2020-03-06 10:11:31","2020-03-07 08:00:00","2020-03-07 08:30:00",3284,775,4059
"2020-03-06 10:11:31","2020-03-07 09:00:00","2020-03-07 09:30:00",3610,916,4526
"2020-03-06 10:11:31","2020-03-07 10:00:00","2020-03-07 10:30:00",3843,990,4833
"2020-03-06 10:11:31","2020-03-07 11:00:00","2020-03-07 11:30:00",3934,1037,4971
"2020-03-06 10:11:31","2020-03-07 12:00:00","2020-03-07 12:30:00",4004,1026,5030
"2020-03-06 10:11:31","2020-03-07 13:00:00","2020-03-07 13:30:00",3980,1019,4999
"2020-03-06 10:11:31","2020-03-07 14:00:00","2020-03-07 14:30:00",3958,1001,4959
"2020-03-06 10:11:31","2020-03-07 15:00:00","2020-03-07 15:30:00",3979,984,4963
"2020-03-06 10:11:31","2020-03-07 16:00:00","2020-03-07 16:30:00",4015,999,5014
"2020-03-06 10:11:31","2020-03-07 17:00:00","2020-03-07 17:30:00",4187,1078,5265
"2020-03-06 10:11:31","2020-03-07 18:00:00","2020-03-07 18:30:00",4278,1191,5469
"2020-03-06 10:11:31","2020-03-07 19:00:00","2020-03-07 19:30:00",4287,1130,5417
"2020-03-06 10:11:31","2020-03-07 20:00:00","2020-03-07 20:30:00",4126,1032,5158
"2020-03-06 10:11:31","2020-03-07 21:00:00","2020-03-07 21:30:00",3830,1006,4836
"2020-03-06 10:11:31","2020-03-07 22:00:00","2020-03-07 22:30:00",3617,904,4521
"2020-03-07 10:11:50","2020-03-07 23:00:00","2020-03-07 23:30:00",3438,816,4254
"2020-03-07 10:11:50","2020-03-08 00:00:00","2020-03-08 00:30:00",3314,714,4028
"2020-03-07 10:11:50","2020-03-08 01:00:00","2020-03-08 01:30:00",3074,662,3736
"2020-03-07 10:11:50","2020-03-08 02:00:00","2020-03-08 02:30:00",2974,659,3633
"2020-03-07 10:11:50","2020-03-08 03:00:00","2020-03-08 03:30:00",2829,619,3448
"2020-03-07 10:11:50","2020-03-08 04:00:00","2020-03-08 04:30:00",2806,596,3402
"2020-03-07 10:11:50","2020-03-08 05:00:00","2020-03-08 05:30:00",2766,609,3375
"2020-03-07 10:11:50","2020-03-08 06:00:00","2020-03-08 06:30:00",2783,613,3396
"2020-03-07 10:11:50","2020-03-08 07:00:00","2020-03-08 07:30:00",2867,656,3523
"2020-03-07 10:11:50","2020-03-08 08:00:00","2020-03-08 08:30:00",3022,745,3767
"2020-03-07 10:11:50","2020-03-08 09:00:00","2020-03-08 09:30:00",3258,821,4079
"2020-03-07 10:11:50","2020-03-08 10:00:00","2020-03-08 10:30:00",3559,897,4456
"2020-03-07 10:11:50","2020-03-08 11:00:00","2020-03-08 11:30:00",3703,926,4629
"2020-03-07 10:11:50","2020-03-08 12:00:00","2020-03-08 12:30:00",3806,928,4734
"2020-03-07 10:11:50","2020-03-08 13:00:00","2020-03-08 13:30:00",3897,1002,4899
"2020-03-07 10:11:50","2020-03-08 14:00:00","2020-03-08 14:30:00",3767,928,4695
"2020-03-07 10:11:50","2020-03-08 15:00:00","2020-03-08 15:30:00",3661,903,4564
"2020-03-07 10:11:50","2020-03-08 16:00:00","2020-03-08 16:30:00",3649,960,4609
"2020-03-07 10:11:50","2020-03-08 17:00:00","2020-03-08 17:30:00",3731,1088,4819
"2020-03-07 10:11:50","2020-03-08 18:00:00","2020-03-08 18:30:00",3967,1206,5173
"2020-03-07 10:11:50","2020-03-08 19:00:00","2020-03-08 19:30:00",4260,1190,5450
"2020-03-07 10:11:50","2020-03-08 20:00:00","2020-03-08 20:30:00",4076,1123,5199
"2020-03-07 10:11:50","2020-03-08 21:00:00","2020-03-08 21:30:00",3888,1003,4891
"2020-03-07 10:11:50","2020-03-08 22:00:00","2020-03-08 22:30:00",3553,908,4461
"2020-03-08 10:11:10","2020-03-08 23:00:00","2020-03-08 23:30:00",3282,783,4065
"2020-03-08 10:11:10","2020-03-09 00:00:00","2020-03-09 00:30:00",3151,666,3817
"2020-03-08 10:11:10","2020-03-09 01:00:00","2020-03-09 01:30:00",2995,651,3646
"2020-03-08 10:11:10","2020-03-09 02:00:00","2020-03-09 02:30:00",2873,636,3509
"2020-03-08 10:11:10","2020-03-09 03:00:00","2020-03-09 03:30:00",2782,569,3351
"2020-03-08 10:11:10","2020-03-09 04:00:00","2020-03-09 04:30:00",2766,577,3343
"2020-03-08 10:11:10","2020-03-09 05:00:00","2020-03-09 05:30:00",2795,595,3390
"2020-03-08 10:11:10","2020-03-09 06:00:00","2020-03-09 06:30:00",3024,695,3719
"2020-03-08 10:11:10","2020-03-09 07:00:00","2020-03-09 07:30:00",3605,917,4522
"2020-03-08 10:11:10","2020-03-09 08:00:00","2020-03-09 08:30:00",4041,1135,5176
"2020-03-08 10:11:10","2020-03-09 09:00:00","2020-03-09 09:30:00",4163,1169,5332
"2020-03-08 10:11:10","2020-03-09 10:00:00","2020-03-09 10:30:00",4245,1167,5412
"2020-03-08 10:11:10","2020-03-09 11:00:00","2020-03-09 11:30:00",4191,1205,5396
"2020-03-08 10:11:10","2020-03-09 12:00:00","2020-03-09 12:30:00",4205,1162,5367
"2020-03-08 10:11:10","2020-03-09 13:00:00","2020-03-09 13:30:00",4265,1205,5470
"2020-03-08 10:11:10","2020-03-09 14:00:00","2020-03-09 14:30:00",4231,1135,5366
"2020-03-08 10:11:10","2020-03-09 15:00:00","2020-03-09 15:30:00",4206,1121,5327
"2020-03-08 10:11:10","2020-03-09 16:00:00","2020-03-09 16:30:00",4168,1168,5336
"2020-03-08 10:11:10","2020-03-09 17:00:00","2020-03-09 17:30:00",4391,1292,5683
"2020-03-08 10:11:10","2020-03-09 18:00:00","2020-03-09 18:30:00",4536,1327,5863
"2020-03-08 10:11:10","2020-03-09 19:00:00","2020-03-09 19:30:00",4750,1292,6042
"2020-03-08 10:11:10","2020-03-09 20:00:00","2020-03-09 20:30:00",4561,1212,5773
"2020-03-08 10:11:10","2020-03-09 21:00:00","2020-03-09 21:30:00",4274,1125,5399
"2020-03-08 10:11:10","2020-03-09 22:00:00","2020-03-09 22:30:00",3919,964,4883
"2020-03-09 10:11:36","2020-03-09 23:00:00","2020-03-09 23:30:00",3442,815,4257
"2020-03-09 10:11:36","2020-03-10 00:00:00","2020-03-10 00:30:00",3223,711,3934
"2020-03-09 10:11:36","2020-03-10 01:00:00","2020-03-10 01:30:00",2991,660,3651
"2020-03-09 10:11:36","2020-03-10 02:00:00","2020-03-10 02:30:00",2856,645,3501
"2020-03-09 10:11:36","2020-03-10 03:00:00","2020-03-10 03:30:00",2809,633,3442
"2020-03-09 10:11:36","2020-03-10 04:00:00","2020-03-10 04:30:00",2780,625,3405
"2020-03-09 10:11:36","2020-03-10 05:00:00","2020-03-10 05:30:00",2792,633,3425
"2020-03-09 10:11:36","2020-03-10 06:00:00","2020-03-10 06:30:00",3028,724,3752
"2020-03-09 10:11:36","2020-03-10 07:00:00","2020-03-10 07:30:00",3655,909,4564
"2020-03-09 10:11:36","2020-03-10 08:00:00","2020-03-10 08:30:00",4103,1057,5160
"2020-03-09 10:11:36","2020-03-10 09:00:00","2020-03-10 09:30:00",4133,1144,5277
"2020-03-09 10:11:36","2020-03-10 10:00:00","2020-03-10 10:30:00",4122,1183,5305
"2020-03-09 10:11:36","2020-03-10 11:00:00","2020-03-10 11:30:00",4105,1179,5284
"2020-03-09 10:11:36","2020-03-10 12:00:00","2020-03-10 12:30:00",4103,1171,5274
"2020-03-09 10:11:36","2020-03-10 13:00:00","2020-03-10 13:30:00",4085,1170,5255
"2020-03-09 10:11:36","2020-03-10 14:00:00","2020-03-10 14:30:00",4007,1137,5144
"2020-03-09 10:11:36","2020-03-10 15:00:00","2020-03-10 15:30:00",4015,1134,5149
"2020-03-09 10:11:36","2020-03-10 16:00:00","2020-03-10 16:30:00",4090,1168,5258
"2020-03-09 10:11:36","2020-03-10 17:00:00","2020-03-10 17:30:00",4285,1282,5567
"2020-03-09 10:11:36","2020-03-10 18:00:00","2020-03-10 18:30:00",4475,1355,5830
"2020-03-09 10:11:36","2020-03-10 19:00:00","2020-03-10 19:30:00",4700,1302,6002
"2020-03-09 10:11:36","2020-03-10 20:00:00","2020-03-10 20:30:00",4512,1207,5719
"2020-03-09 10:11:36","2020-03-10 21:00:00","2020-03-10 21:30:00",4270,1138,5408
"2020-03-09 10:11:36","2020-03-10 22:00:00","2020-03-10 22:30:00",3861,1001,4862
"2020-03-10 10:11:26","2020-03-10 23:00:00","2020-03-10 23:30:00",3557,844,4401
"2020-03-10 10:11:26","2020-03-11 00:00:00","2020-03-11 00:30:00",3317,711,4028
"2020-03-10 10:11:26","2020-03-11 01:00:00","2020-03-11 01:30:00",3062,660,3722
"2020-03-10 10:11:26","2020-03-11 02:00:00","2020-03-11 02:30:00",2936,645,3581
"2020-03-10 10:11:26","2020-03-11 03:00:00","2020-03-11 03:30:00",2845,633,3478
"2020-03-10 10:11:26","2020-03-11 04:00:00","2020-03-11 04:30:00",2800,625,3425
"2020-03-10 10:11:26","2020-03-11 05:00:00","2020-03-11 05:30:00",2826,633,3459
"2020-03-10 10:11:26","2020-03-11 06:00:00","2020-03-11 06:30:00",3036,724,3760
"2020-03-10 10:11:26","2020-03-11 07:00:00","2020-03-11 07:30:00",3548,909,4457
"2020-03-10 10:11:26","2020-03-11 08:00:00","2020-03-11 08:30:00",4107,1057,5164
"2020-03-10 10:11:26","2020-03-11 09:00:00","2020-03-11 09:30:00",4168,1144,5312
"2020-03-10 10:11:26","2020-03-11 10:00:00","2020-03-11 10:30:00",4262,1183,5445
"2020-03-10 10:11:26","2020-03-11 11:00:00","2020-03-11 11:30:00",4246,1179,5425
"2020-03-10 10:11:26","2020-03-11 12:00:00","2020-03-11 12:30:00",4200,1171,5371
"2020-03-10 10:11:26","2020-03-11 13:00:00","2020-03-11 13:30:00",4192,1170,5362
"2020-03-10 10:11:26","2020-03-11 14:00:00","2020-03-11 14:30:00",4075,1137,5212
"2020-03-10 10:11:26","2020-03-11 15:00:00","2020-03-11 15:30:00",4120,1134,5254
"2020-03-10 10:11:26","2020-03-11 16:00:00","2020-03-11 16:30:00",4206,1168,5374
"2020-03-10 10:11:26","2020-03-11 17:00:00","2020-03-11 17:30:00",4435,1282,5717
"2020-03-10 10:11:26","2020-03-11 18:00:00","2020-03-11 18:30:00",4599,1355,5954
"2020-03-10 10:11:26","2020-03-11 19:00:00","2020-03-11 19:30:00",4750,1302,6052
"2020-03-10 10:11:26","2020-03-11 20:00:00","2020-03-11 20:30:00",4564,1207,5771
"2020-03-10 10:11:26","2020-03-11 21:00:00","2020-03-11 21:30:00",4307,1138,5445
"2020-03-10 10:11:26","2020-03-11 22:00:00","2020-03-11 22:30:00",3879,1001,4880
"2020-03-11 10:10:51","2020-03-11 23:00:00","2020-03-11 23:30:00",3510,781,4291
"2020-03-11 10:10:51","2020-03-12 00:00:00","2020-03-12 00:30:00",3313,711,4024
"2020-03-11 10:10:51","2020-03-12 01:00:00","2020-03-12 01:30:00",3073,660,3733
"2020-03-11 10:10:51","2020-03-12 02:00:00","2020-03-12 02:30:00",2911,645,3556
"2020-03-11 10:10:51","2020-03-12 03:00:00","2020-03-12 03:30:00",2806,633,3439
"2020-03-11 10:10:51","2020-03-12 04:00:00","2020-03-12 04:30:00",2787,625,3412
"2020-03-11 10:10:51","2020-03-12 05:00:00","2020-03-12 05:30:00",2836,633,3469
"2020-03-11 10:10:51","2020-03-12 06:00:00","2020-03-12 06:30:00",3061,724,3785
"2020-03-11 10:10:51","2020-03-12 07:00:00","2020-03-12 07:30:00",3615,909,4524
"2020-03-11 10:10:51","2020-03-12 08:00:00","2020-03-12 08:30:00",4181,1057,5238
"2020-03-11 10:10:51","2020-03-12 09:00:00","2020-03-12 09:30:00",4260,1144,5404
"2020-03-11 10:10:51","2020-03-12 10:00:00","2020-03-12 10:30:00",4311,1183,5494
"2020-03-11 10:10:51","2020-03-12 11:00:00","2020-03-12 11:30:00",4278,1179,5457
"2020-03-11 10:10:51","2020-03-12 12:00:00","2020-03-12 12:30:00",4265,1171,5436
"2020-03-11 10:10:51","2020-03-12 13:00:00","2020-03-12 13:30:00",4276,1170,5446
"2020-03-11 10:10:51","2020-03-12 14:00:00","2020-03-12 14:30:00",4139,1137,5276
"2020-03-11 10:10:51","2020-03-12 15:00:00","2020-03-12 15:30:00",4158,1134,5292
"2020-03-11 10:10:51","2020-03-12 16:00:00","2020-03-12 16:30:00",4169,1168,5337
"2020-03-11 10:10:51","2020-03-12 17:00:00","2020-03-12 17:30:00",4351,1282,5633
"2020-03-11 10:10:51","2020-03-12 18:00:00","2020-03-12 18:30:00",4534,1355,5889
"2020-03-11 10:10:51","2020-03-12 19:00:00","2020-03-12 19:30:00",4750,1302,6052
"2020-03-11 10:10:51","2020-03-12 20:00:00","2020-03-12 20:30:00",4588,1207,5795
"2020-03-11 10:10:51","2020-03-12 21:00:00","2020-03-12 21:30:00",4282,1138,5420
"2020-03-11 10:10:51","2020-03-12 22:00:00","2020-03-12 22:30:00",3855,1001,4856
"2020-03-12 10:11:06","2020-03-12 23:00:00","2020-03-12 23:30:00",3447,844,4291
"2020-03-12 10:11:06","2020-03-13 00:00:00","2020-03-13 00:30:00",3314,732,4046
"2020-03-12 10:11:06","2020-03-13 01:00:00","2020-03-13 01:30:00",3102,654,3756
"2020-03-12 10:11:06","2020-03-13 02:00:00","2020-03-13 02:30:00",2913,633,3546
"2020-03-12 10:11:06","2020-03-13 03:00:00","2020-03-13 03:30:00",2811,603,3414
"2020-03-12 10:11:06","2020-03-13 04:00:00","2020-03-13 04:30:00",2780,589,3369
"2020-03-12 10:11:06","2020-03-13 05:00:00","2020-03-13 05:30:00",2793,596,3389
"2020-03-12 10:11:06","2020-03-13 06:00:00","2020-03-13 06:30:00",3047,666,3713
"2020-03-12 10:11:06","2020-03-13 07:00:00","2020-03-13 07:30:00",3525,881,4406
"2020-03-12 10:11:06","2020-03-13 08:00:00","2020-03-13 08:30:00",4076,1045,5121
"2020-03-12 10:11:06","2020-03-13 09:00:00","2020-03-13 09:30:00",4242,1170,5412
"2020-03-12 10:11:06","2020-03-13 10:00:00","2020-03-13 10:30:00",4273,1210,5483
"2020-03-12 10:11:06","2020-03-13 11:00:00","2020-03-13 11:30:00",4231,1219,5450
"2020-03-12 10:11:06","2020-03-13 12:00:00","2020-03-13 12:30:00",4235,1211,5446
"2020-03-12 10:11:06","2020-03-13 13:00:00","2020-03-13 13:30:00",4170,1178,5348
"2020-03-12 10:11:06","2020-03-13 14:00:00","2020-03-13 14:30:00",4077,1125,5202
"2020-03-12 10:11:06","2020-03-13 15:00:00","2020-03-13 15:30:00",4018,1086,5104
"2020-03-12 10:11:06","2020-03-13 16:00:00","2020-03-13 16:30:00",4105,1102,5207
"2020-03-12 10:11:06","2020-03-13 17:00:00","2020-03-13 17:30:00",4189,1204,5393
"2020-03-12 10:11:06","2020-03-13 18:00:00","2020-03-13 18:30:00",4379,1331,5710
"2020-03-12 10:11:06","2020-03-13 19:00:00","2020-03-13 19:30:00",4620,1274,5894
"2020-03-12 10:11:06","2020-03-13 20:00:00","2020-03-13 20:30:00",4451,1168,5619
"2020-03-12 10:11:06","2020-03-13 21:00:00","2020-03-13 21:30:00",4177,1075,5252
"2020-03-12 10:11:06","2020-03-13 22:00:00","2020-03-13 22:30:00",3769,945,4714
"2020-03-13 10:11:31","2020-03-13 23:00:00","2020-03-13 23:30:00",3485,836,4321
"2020-03-13 10:11:31","2020-03-14 00:00:00","2020-03-14 00:30:00",3363,696,4059
"2020-03-13 10:11:31","2020-03-14 01:00:00","2020-03-14 01:30:00",3105,635,3740
"2020-03-13 10:11:31","2020-03-14 02:00:00","2020-03-14 02:30:00",2894,607,3501
"2020-03-13 10:11:31","2020-03-14 03:00:00","2020-03-14 03:30:00",2806,570,3376
"2020-03-13 10:11:31","2020-03-14 04:00:00","2020-03-14 04:30:00",2758,570,3328
"2020-03-13 10:11:31","2020-03-14 05:00:00","2020-03-14 05:30:00",2760,549,3309
"2020-03-13 10:11:31","2020-03-14 06:00:00","2020-03-14 06:30:00",2857,585,3442
"2020-03-13 10:11:31","2020-03-14 07:00:00","2020-03-14 07:30:00",3048,680,3728
"2020-03-13 10:11:31","2020-03-14 08:00:00","2020-03-14 08:30:00",3321,775,4096
"2020-03-13 10:11:31","2020-03-14 09:00:00","2020-03-14 09:30:00",3669,916,4585
"2020-03-13 10:11:31","2020-03-14 10:00:00","2020-03-14 10:30:00",3869,990,4859
"2020-03-13 10:11:31","2020-03-14 11:00:00","2020-03-14 11:30:00",3929,1037,4966
"2020-03-13 10:11:31","2020-03-14 12:00:00","2020-03-14 12:30:00",3962,1026,4988
"2020-03-13 10:11:31","2020-03-14 13:00:00","2020-03-14 13:30:00",3984,1019,5003
"2020-03-13 10:11:31","2020-03-14 14:00:00","2020-03-14 14:30:00",3906,1001,4907
"2020-03-13 10:11:31","2020-03-14 15:00:00","2020-03-14 15:30:00",3857,984,4841
"2020-03-13 10:11:31","2020-03-14 16:00:00","2020-03-14 16:30:00",3892,999,4891
"2020-03-13 10:11:31","2020-03-14 17:00:00","2020-03-14 17:30:00",4044,1078,5122
"2020-03-13 10:11:31","2020-03-14 18:00:00","2020-03-14 18:30:00",4218,1191,5409
"2020-03-13 10:11:31","2020-03-14 19:00:00","2020-03-14 19:30:00",4300,1130,5430
"2020-03-13 10:11:31","2020-03-14 20:00:00","2020-03-14 20:30:00",4049,1032,5081
"2020-03-13 10:11:31","2020-03-14 21:00:00","2020-03-14 21:30:00",3757,1006,4763
"2020-03-13 10:11:31","2020-03-14 22:00:00","2020-03-14 22:30:00",3495,904,4399
"2020-03-14 10:11:35","2020-03-14 23:00:00","2020-03-14 23:30:00",3324,806,4130
"2020-03-14 10:11:35","2020-03-15 00:00:00","2020-03-15 00:30:00",3175,714,3889
"2020-03-14 10:11:35","2020-03-15 01:00:00","2020-03-15 01:30:00",2989,662,3651
"2020-03-14 10:11:35","2020-03-15 02:00:00","2020-03-15 02:30:00",2819,659,3478
"2020-03-14 10:11:35","2020-03-15 03:00:00","2020-03-15 03:30:00",2703,619,3322
"2020-03-14 10:11:35","2020-03-15 04:00:00","2020-03-15 04:30:00",2656,596,3252
"2020-03-14 10:11:35","2020-03-15 05:00:00","2020-03-15 05:30:00",2640,609,3249
"2020-03-14 10:11:35","2020-03-15 06:00:00","2020-03-15 06:30:00",2656,613,3269
"2020-03-14 10:11:35","2020-03-15 07:00:00","2020-03-15 07:30:00",2726,656,3382
"2020-03-14 10:11:35","2020-03-15 08:00:00","2020-03-15 08:30:00",2917,745,3662
"2020-03-14 10:11:35","2020-03-15 09:00:00","2020-03-15 09:30:00",3187,821,4008
"2020-03-14 10:11:35","2020-03-15 10:00:00","2020-03-15 10:30:00",3459,897,4356
"2020-03-14 10:11:35","2020-03-15 11:00:00","2020-03-15 11:30:00",3616,926,4542
"2020-03-14 10:11:35","2020-03-15 12:00:00","2020-03-15 12:30:00",3696,928,4624
"2020-03-14 10:11:35","2020-03-15 13:00:00","2020-03-15 13:30:00",3797,1002,4799
"2020-03-14 10:11:35","2020-03-15 14:00:00","2020-03-15 14:30:00",3752,928,4680
"2020-03-14 10:11:35","2020-03-15 15:00:00","2020-03-15 15:30:00",3628,903,4531
"2020-03-14 10:11:35","2020-03-15 16:00:00","2020-03-15 16:30:00",3604,960,4564
"2020-03-14 10:11:35","2020-03-15 17:00:00","2020-03-15 17:30:00",3734,1088,4822
"2020-03-14 10:11:35","2020-03-15 18:00:00","2020-03-15 18:30:00",3956,1206,5162
"2020-03-14 10:11:35","2020-03-15 19:00:00","2020-03-15 19:30:00",4150,1190,5340
"2020-03-14 10:11:35","2020-03-15 20:00:00","2020-03-15 20:30:00",4025,1123,5148
"2020-03-14 10:11:35","2020-03-15 21:00:00","2020-03-15 21:30:00",3825,1003,4828
"2020-03-14 10:11:35","2020-03-15 22:00:00","2020-03-15 22:30:00",3489,908,4397
"2020-03-15 10:11:30","2020-03-15 23:00:00","2020-03-15 23:30:00",3198,781,3979
"2020-03-15 10:11:30","2020-03-16 00:00:00","2020-03-16 00:30:00",3008,666,3674
"2020-03-15 10:11:30","2020-03-16 01:00:00","2020-03-16 01:30:00",2864,651,3515
"2020-03-15 10:11:30","2020-03-16 02:00:00","2020-03-16 02:30:00",2702,636,3338
"2020-03-15 10:11:30","2020-03-16 03:00:00","2020-03-16 03:30:00",2650,569,3219
"2020-03-15 10:11:30","2020-03-16 04:00:00","2020-03-16 04:30:00",2673,577,3250
"2020-03-15 10:11:30","2020-03-16 05:00:00","2020-03-16 05:30:00",2670,595,3265
"2020-03-15 10:11:30","2020-03-16 06:00:00","2020-03-16 06:30:00",2901,695,3596
"2020-03-15 10:11:30","2020-03-16 07:00:00","2020-03-16 07:30:00",3389,917,4306
"2020-03-15 10:11:30","2020-03-16 08:00:00","2020-03-16 08:30:00",3877,1135,5012
"2020-03-15 10:11:30","2020-03-16 09:00:00","2020-03-16 09:30:00",4017,1169,5186
"2020-03-15 10:11:30","2020-03-16 10:00:00","2020-03-16 10:30:00",4136,1167,5303
"2020-03-15 10:11:30","2020-03-16 11:00:00","2020-03-16 11:30:00",4246,1205,5451
"2020-03-15 10:11:30","2020-03-16 12:00:00","2020-03-16 12:30:00",4300,1162,5462
"2020-03-15 10:11:30","2020-03-16 13:00:00","2020-03-16 13:30:00",4370,1205,5575
"2020-03-15 10:11:30","2020-03-16 14:00:00","2020-03-16 14:30:00",4308,1135,5443
"2020-03-15 10:11:30","2020-03-16 15:00:00","2020-03-16 15:30:00",4276,1121,5397
"2020-03-15 10:11:30","2020-03-16 16:00:00","2020-03-16 16:30:00",4332,1168,5500
"2020-03-15 10:11:30","2020-03-16 17:00:00","2020-03-16 17:30:00",4471,1292,5763
"2020-03-15 10:11:30","2020-03-16 18:00:00","2020-03-16 18:30:00",4623,1327,5950
"2020-03-15 10:11:30","2020-03-16 19:00:00","2020-03-16 19:30:00",4654,1292,5946
"2020-03-15 10:11:30","2020-03-16 20:00:00","2020-03-16 20:30:00",4414,1212,5626
"2020-03-15 10:11:30","2020-03-16 21:00:00","2020-03-16 21:30:00",4125,1125,5250
"2020-03-15 10:11:30","2020-03-16 22:00:00","2020-03-16 22:30:00",3721,964,4685
"2020-03-16 10:11:10","2020-03-16 23:00:00","2020-03-16 23:30:00",3326,885,4211
"2020-03-16 10:11:10","2020-03-17 00:00:00","2020-03-17 00:30:00",3530,725,4255
"2020-03-16 10:11:10","2020-03-17 01:00:00","2020-03-17 01:30:00",3253,713,3966
"2020-03-16 10:11:10","2020-03-17 02:00:00","2020-03-17 02:30:00",3031,671,3702
"2020-03-16 10:11:10","2020-03-17 03:00:00","2020-03-17 03:30:00",2893,641,3534
"2020-03-16 10:11:10","2020-03-17 04:00:00","2020-03-17 04:30:00",2788,636,3424
"2020-03-16 10:11:10","2020-03-17 05:00:00","2020-03-17 05:30:00",2700,647,3347
"2020-03-16 10:11:10","2020-03-17 06:00:00","2020-03-17 06:30:00",2742,710,3452
"2020-03-16 10:11:10","2020-03-17 07:00:00","2020-03-17 07:30:00",2876,824,3700
"2020-03-16 10:11:10","2020-03-17 08:00:00","2020-03-17 08:30:00",3251,961,4212
"2020-03-16 10:11:10","2020-03-17 09:00:00","2020-03-17 09:30:00",3629,1065,4694
"2020-03-16 10:11:10","2020-03-17 10:00:00","2020-03-17 10:30:00",3970,1105,5075
"2020-03-16 10:11:10","2020-03-17 11:00:00","2020-03-17 11:30:00",4105,1105,5210
"2020-03-16 10:11:10","2020-03-17 12:00:00","2020-03-17 12:30:00",4164,1112,5276
"2020-03-16 10:11:10","2020-03-17 13:00:00","2020-03-17 13:30:00",4195,1054,5249
"2020-03-16 10:11:10","2020-03-17 14:00:00","2020-03-17 14:30:00",4039,1012,5051
"2020-03-16 10:11:10","2020-03-17 15:00:00","2020-03-17 15:30:00",3877,1018,4895
"2020-03-16 10:11:10","2020-03-17 16:00:00","2020-03-17 16:30:00",3802,1056,4858
"2020-03-16 10:11:10","2020-03-17 17:00:00","2020-03-17 17:30:00",3845,1151,4996
"2020-03-16 10:11:10","2020-03-17 18:00:00","2020-03-17 18:30:00",4054,1160,5214
"2020-03-16 10:11:10","2020-03-17 19:00:00","2020-03-17 19:30:00",4300,1270,5570
"2020-03-16 10:11:10","2020-03-17 20:00:00","2020-03-17 20:30:00",4210,1186,5396
"2020-03-16 10:11:10","2020-03-17 21:00:00","2020-03-17 21:30:00",4018,1091,5109
"2020-03-16 10:11:10","2020-03-17 22:00:00","2020-03-17 22:30:00",3732,955,4687
"2020-03-17 10:11:36","2020-03-17 23:00:00","2020-03-17 23:30:00",3352,864,4216
"2020-03-17 10:11:36","2020-03-18 00:00:00","2020-03-18 00:30:00",2969,718,3687
"2020-03-17 10:11:36","2020-03-18 01:00:00","2020-03-18 01:30:00",2841,664,3505
"2020-03-17 10:11:36","2020-03-18 02:00:00","2020-03-18 02:30:00",2696,653,3349
"2020-03-17 10:11:36","2020-03-18 03:00:00","2020-03-18 03:30:00",2650,638,3288
"2020-03-17 10:11:36","2020-03-18 04:00:00","2020-03-18 04:30:00",2670,638,3308
"2020-03-17 10:11:36","2020-03-18 05:00:00","2020-03-18 05:30:00",2668,639,3307
"2020-03-17 10:11:36","2020-03-18 06:00:00","2020-03-18 06:30:00",2874,721,3595
"2020-03-17 10:11:36","2020-03-18 07:00:00","2020-03-18 07:30:00",3309,889,4198
"2020-03-17 10:11:36","2020-03-18 08:00:00","2020-03-18 08:30:00",3744,1090,4834
"2020-03-17 10:11:36","2020-03-18 09:00:00","2020-03-18 09:30:00",3868,1170,5038
"2020-03-17 10:11:36","2020-03-18 10:00:00","2020-03-18 10:30:00",3975,1193,5168
"2020-03-17 10:11:36","2020-03-18 11:00:00","2020-03-18 11:30:00",4073,1183,5256
"2020-03-17 10:11:36","2020-03-18 12:00:00","2020-03-18 12:30:00",4122,1175,5297
"2020-03-17 10:11:36","2020-03-18 13:00:00","2020-03-18 13:30:00",4183,1172,5355
"2020-03-17 10:11:36","2020-03-18 14:00:00","2020-03-18 14:30:00",4129,1133,5262
"2020-03-17 10:11:36","2020-03-18 15:00:00","2020-03-18 15:30:00",4100,1107,5207
"2020-03-17 10:11:36","2020-03-18 16:00:00","2020-03-18 16:30:00",4150,1141,5291
"2020-03-17 10:11:36","2020-03-18 17:00:00","2020-03-18 17:30:00",4273,1245,5518
"2020-03-17 10:11:36","2020-03-18 18:00:00","2020-03-18 18:30:00",4409,1275,5684
"2020-03-17 10:11:36","2020-03-18 19:00:00","2020-03-18 19:30:00",4437,1310,5747
"2020-03-17 10:11:36","2020-03-18 20:00:00","2020-03-18 20:30:00",4222,1257,5479
"2020-03-17 10:11:36","2020-03-18 21:00:00","2020-03-18 21:30:00",3965,1180,5145
"2020-03-17 10:11:36","2020-03-18 22:00:00","2020-03-18 22:30:00",3605,1030,4635
"2020-03-18 10:11:36","2020-03-18 23:00:00","2020-03-18 23:30:00",3348,877,4225
"2020-03-18 10:11:36","2020-03-19 00:00:00","2020-03-19 00:30:00",3361,711,4072
"2020-03-18 10:11:36","2020-03-19 01:00:00","2020-03-19 01:30:00",3193,660,3853
"2020-03-18 10:11:36","2020-03-19 02:00:00","2020-03-19 02:30:00",3035,645,3680
"2020-03-18 10:11:36","2020-03-19 03:00:00","2020-03-19 03:30:00",2946,633,3579
"2020-03-18 10:11:36","2020-03-19 04:00:00","2020-03-19 04:30:00",2902,625,3527
"2020-03-18 10:11:36","2020-03-19 05:00:00","2020-03-19 05:30:00",2926,633,3559
"2020-03-18 10:11:36","2020-03-19 06:00:00","2020-03-19 06:30:00",3095,724,3819
"2020-03-18 10:11:36","2020-03-19 07:00:00","2020-03-19 07:30:00",3686,909,4595
"2020-03-18 10:11:36","2020-03-19 08:00:00","2020-03-19 08:30:00",3963,1057,5020
"2020-03-18 10:11:36","2020-03-19 09:00:00","2020-03-19 09:30:00",4192,1144,5336
"2020-03-18 10:11:36","2020-03-19 10:00:00","2020-03-19 10:30:00",4172,1183,5355
"2020-03-18 10:11:36","2020-03-19 11:00:00","2020-03-19 11:30:00",4174,1179,5353
"2020-03-18 10:11:36","2020-03-19 12:00:00","2020-03-19 12:30:00",4169,1171,5340
"2020-03-18 10:11:36","2020-03-19 13:00:00","2020-03-19 13:30:00",4230,1170,5400
"2020-03-18 10:11:36","2020-03-19 14:00:00","2020-03-19 14:30:00",4095,1137,5232
"2020-03-18 10:11:36","2020-03-19 15:00:00","2020-03-19 15:30:00",4130,1134,5264
"2020-03-18 10:11:36","2020-03-19 16:00:00","2020-03-19 16:30:00",4250,1168,5418
"2020-03-18 10:11:36","2020-03-19 17:00:00","2020-03-19 17:30:00",4428,1282,5710
"2020-03-18 10:11:36","2020-03-19 18:00:00","2020-03-19 18:30:00",4667,1355,6022
"2020-03-18 10:11:36","2020-03-19 19:00:00","2020-03-19 19:30:00",4751,1302,6053
"2020-03-18 10:11:36","2020-03-19 20:00:00","2020-03-19 20:30:00",4569,1207,5776
"2020-03-18 10:11:36","2020-03-19 21:00:00","2020-03-19 21:30:00",4329,1138,5467
"2020-03-18 10:11:36","2020-03-19 22:00:00","2020-03-19 22:30:00",3960,1001,4961
"2020-03-19 10:11:31","2020-03-19 23:00:00","2020-03-19 23:30:00",3437,904,4341
"2020-03-19 10:11:31","2020-03-20 00:00:00","2020-03-20 00:30:00",3194,732,3926
"2020-03-19 10:11:31","2020-03-20 01:00:00","2020-03-20 01:30:00",3040,654,3694
"2020-03-19 10:11:31","2020-03-20 02:00:00","2020-03-20 02:30:00",2884,633,3517
"2020-03-19 10:11:31","2020-03-20 03:00:00","2020-03-20 03:30:00",2823,603,3426
"2020-03-19 10:11:31","2020-03-20 04:00:00","2020-03-20 04:30:00",2810,589,3399
"2020-03-19 10:11:31","2020-03-20 05:00:00","2020-03-20 05:30:00",2825,596,3421
"2020-03-19 10:11:31","2020-03-20 06:00:00","2020-03-20 06:30:00",2978,666,3644
"2020-03-19 10:11:31","2020-03-20 07:00:00","2020-03-20 07:30:00",3230,881,4111
"2020-03-19 10:11:31","2020-03-20 08:00:00","2020-03-20 08:30:00",3588,1045,4633
"2020-03-19 10:11:31","2020-03-20 09:00:00","2020-03-20 09:30:00",3867,1170,5037
"2020-03-19 10:11:31","2020-03-20 10:00:00","2020-03-20 10:30:00",4006,1210,5216
"2020-03-19 10:11:31","2020-03-20 11:00:00","2020-03-20 11:30:00",4080,1219,5299
"2020-03-19 10:11:31","2020-03-20 12:00:00","2020-03-20 12:30:00",4120,1211,5331
"2020-03-19 10:11:31","2020-03-20 13:00:00","2020-03-20 13:30:00",4221,1178,5399
"2020-03-19 10:11:31","2020-03-20 14:00:00","2020-03-20 14:30:00",4147,1125,5272
"2020-03-19 10:11:31","2020-03-20 15:00:00","2020-03-20 15:30:00",4101,1086,5187
"2020-03-19 10:11:31","2020-03-20 16:00:00","2020-03-20 16:30:00",4114,1102,5216
"2020-03-19 10:11:31","2020-03-20 17:00:00","2020-03-20 17:30:00",4244,1204,5448
"2020-03-19 10:11:31","2020-03-20 18:00:00","2020-03-20 18:30:00",4384,1331,5715
"2020-03-19 10:11:31","2020-03-20 19:00:00","2020-03-20 19:30:00",4450,1274,5724
"2020-03-19 10:11:31","2020-03-20 20:00:00","2020-03-20 20:30:00",4284,1168,5452
"2020-03-19 10:11:31","2020-03-20 21:00:00","2020-03-20 21:30:00",4010,1075,5085
"2020-03-19 10:11:31","2020-03-20 22:00:00","2020-03-20 22:30:00",3726,945,4671
"2020-03-20 10:11:56","2020-03-20 23:00:00","2020-03-20 23:30:00",3510,819,4329
"2020-03-20 10:11:56","2020-03-21 00:00:00","2020-03-21 00:30:00",3329,696,4025
"2020-03-20 10:11:56","2020-03-21 01:00:00","2020-03-21 01:30:00",3070,635,3705
"2020-03-20 10:11:56","2020-03-21 02:00:00","2020-03-21 02:30:00",2881,607,3488
"2020-03-20 10:11:56","2020-03-21 03:00:00","2020-03-21 03:30:00",2772,570,3342
"2020-03-20 10:11:56","2020-03-21 04:00:00","2020-03-21 04:30:00",2706,570,3276
"2020-03-20 10:11:56","2020-03-21 05:00:00","2020-03-21 05:30:00",2691,549,3240
"2020-03-20 10:11:56","2020-03-21 06:00:00","2020-03-21 06:30:00",2788,585,3373
"2020-03-20 10:11:56","2020-03-21 07:00:00","2020-03-21 07:30:00",2907,680,3587
"2020-03-20 10:11:56","2020-03-21 08:00:00","2020-03-21 08:30:00",3144,775,3919
"2020-03-20 10:11:56","2020-03-21 09:00:00","2020-03-21 09:30:00",3417,916,4333
"2020-03-20 10:11:56","2020-03-21 10:00:00","2020-03-21 10:30:00",3660,990,4650
"2020-03-20 10:11:56","2020-03-21 11:00:00","2020-03-21 11:30:00",3837,1037,4874
"2020-03-20 10:11:56","2020-03-21 12:00:00","2020-03-21 12:30:00",3930,1026,4956
"2020-03-20 10:11:56","2020-03-21 13:00:00","2020-03-21 13:30:00",4044,1019,5063
"2020-03-20 10:11:56","2020-03-21 14:00:00","2020-03-21 14:30:00",3932,1001,4933
"2020-03-20 10:11:56","2020-03-21 15:00:00","2020-03-21 15:30:00",3872,984,4856
"2020-03-20 10:11:56","2020-03-21 16:00:00","2020-03-21 16:30:00",3866,999,4865
"2020-03-20 10:11:56","2020-03-21 17:00:00","2020-03-21 17:30:00",3959,1078,5037
"2020-03-20 10:11:56","2020-03-21 18:00:00","2020-03-21 18:30:00",4137,1191,5328
"2020-03-20 10:11:56","2020-03-21 19:00:00","2020-03-21 19:30:00",4280,1130,5410
"2020-03-20 10:11:56","2020-03-21 20:00:00","2020-03-21 20:30:00",3994,1032,5026
"2020-03-20 10:11:56","2020-03-21 21:00:00","2020-03-21 21:30:00",3731,1006,4737
"2020-03-20 10:11:56","2020-03-21 22:00:00","2020-03-21 22:30:00",3452,904,4356
"2020-03-21 10:11:16","2020-03-21 23:00:00","2020-03-21 23:30:00",3281,794,4075
"2020-03-21 10:11:16","2020-03-22 00:00:00","2020-03-22 00:30:00",3109,714,3823
"2020-03-21 10:11:16","2020-03-22 01:00:00","2020-03-22 01:30:00",2912,662,3574
"2020-03-21 10:11:16","2020-03-22 02:00:00","2020-03-22 02:30:00",2729,659,3388
"2020-03-21 10:11:16","2020-03-22 03:00:00","2020-03-22 03:30:00",2594,619,3213
"2020-03-21 10:11:16","2020-03-22 04:00:00","2020-03-22 04:30:00",2573,596,3169
"2020-03-21 10:11:16","2020-03-22 05:00:00","2020-03-22 05:30:00",2604,609,3213
"2020-03-21 10:11:16","2020-03-22 06:00:00","2020-03-22 06:30:00",2654,613,3267
"2020-03-21 10:11:16","2020-03-22 07:00:00","2020-03-22 07:30:00",2711,656,3367
"2020-03-21 10:11:16","2020-03-22 08:00:00","2020-03-22 08:30:00",2885,745,3630
"2020-03-21 10:11:16","2020-03-22 09:00:00","2020-03-22 09:30:00",3070,821,3891
"2020-03-21 10:11:16","2020-03-22 10:00:00","2020-03-22 10:30:00",3380,897,4277
"2020-03-21 10:11:16","2020-03-22 11:00:00","2020-03-22 11:30:00",3591,926,4517
"2020-03-21 10:11:16","2020-03-22 12:00:00","2020-03-22 12:30:00",3659,928,4587
"2020-03-21 10:11:16","2020-03-22 13:00:00","2020-03-22 13:30:00",3753,1002,4755
"2020-03-21 10:11:16","2020-03-22 14:00:00","2020-03-22 14:30:00",3604,928,4532
"2020-03-21 10:11:16","2020-03-22 15:00:00","2020-03-22 15:30:00",3549,903,4452
"2020-03-21 10:11:16","2020-03-22 16:00:00","2020-03-22 16:30:00",3505,960,4465
"2020-03-21 10:11:16","2020-03-22 17:00:00","2020-03-22 17:30:00",3632,1088,4720
"2020-03-21 10:11:16","2020-03-22 18:00:00","2020-03-22 18:30:00",3798,1206,5004
"2020-03-21 10:11:16","2020-03-22 19:00:00","2020-03-22 19:30:00",4024,1190,5214
"2020-03-21 10:11:16","2020-03-22 20:00:00","2020-03-22 20:30:00",3872,1123,4995
"2020-03-21 10:11:16","2020-03-22 21:00:00","2020-03-22 21:30:00",3684,1003,4687
"2020-03-21 10:11:16","2020-03-22 22:00:00","2020-03-22 22:30:00",3423,908,4331
"2020-03-22 10:11:15","2020-03-22 23:00:00","2020-03-22 23:30:00",3241,809,4050
"2020-03-22 10:11:15","2020-03-23 00:00:00","2020-03-23 00:30:00",3046,666,3712
"2020-03-22 10:11:15","2020-03-23 01:00:00","2020-03-23 01:30:00",2874,651,3525
"2020-03-22 10:11:15","2020-03-23 02:00:00","2020-03-23 02:30:00",2700,636,3336
"2020-03-22 10:11:15","2020-03-23 03:00:00","2020-03-23 03:30:00",2632,569,3201
"2020-03-22 10:11:15","2020-03-23 04:00:00","2020-03-23 04:30:00",2619,577,3196
"2020-03-22 10:11:15","2020-03-23 05:00:00","2020-03-23 05:30:00",2635,595,3230
"2020-03-22 10:11:15","2020-03-23 06:00:00","2020-03-23 06:30:00",2805,695,3500
"2020-03-22 10:11:15","2020-03-23 07:00:00","2020-03-23 07:30:00",3086,917,4003
"2020-03-22 10:11:15","2020-03-23 08:00:00","2020-03-23 08:30:00",3485,1135,4620
"2020-03-22 10:11:15","2020-03-23 09:00:00","2020-03-23 09:30:00",3795,1169,4964
"2020-03-22 10:11:15","2020-03-23 10:00:00","2020-03-23 10:30:00",3950,1167,5117
"2020-03-22 10:11:15","2020-03-23 11:00:00","2020-03-23 11:30:00",4032,1205,5237
"2020-03-22 10:11:15","2020-03-23 12:00:00","2020-03-23 12:30:00",4077,1162,5239
"2020-03-22 10:11:15","2020-03-23 13:00:00","2020-03-23 13:30:00",4189,1205,5394
"2020-03-22 10:11:15","2020-03-23 14:00:00","2020-03-23 14:30:00",4108,1135,5243
"2020-03-22 10:11:15","2020-03-23 15:00:00","2020-03-23 15:30:00",4057,1121,5178
"2020-03-22 10:11:15","2020-03-23 16:00:00","2020-03-23 16:30:00",4071,1168,5239
"2020-03-22 10:11:15","2020-03-23 17:00:00","2020-03-23 17:30:00",4215,1292,5507
"2020-03-22 10:11:15","2020-03-23 18:00:00","2020-03-23 18:30:00",4371,1327,5698
"2020-03-22 10:11:15","2020-03-23 19:00:00","2020-03-23 19:30:00",4445,1292,5737
"2020-03-22 10:11:15","2020-03-23 20:00:00","2020-03-23 20:30:00",4259,1212,5471
"2020-03-22 10:11:15","2020-03-23 21:00:00","2020-03-23 21:30:00",3955,1125,5080
"2020-03-22 10:11:15","2020-03-23 22:00:00","2020-03-23 22:30:00",3638,964,4602
"2020-03-23 10:11:10","2020-03-23 23:00:00","2020-03-23 23:30:00",3398,833,4231
"2020-03-23 10:11:10","2020-03-24 00:00:00","2020-03-24 00:30:00",3164,711,3875
"2020-03-23 10:11:10","2020-03-24 01:00:00","2020-03-24 01:30:00",3006,660,3666
"2020-03-23 10:11:10","2020-03-24 02:00:00","2020-03-24 02:30:00",2846,645,3491
"2020-03-23 10:11:10","2020-03-24 03:00:00","2020-03-24 03:30:00",2783,633,3416
"2020-03-23 10:11:10","2020-03-24 04:00:00","2020-03-24 04:30:00",2771,625,3396
"2020-03-23 10:11:10","2020-03-24 05:00:00","2020-03-24 05:30:00",2785,633,3418
"2020-03-23 10:11:10","2020-03-24 06:00:00","2020-03-24 06:30:00",2942,724,3666
"2020-03-23 10:11:10","2020-03-24 07:00:00","2020-03-24 07:30:00",3200,909,4109
"2020-03-23 10:11:10","2020-03-24 08:00:00","2020-03-24 08:30:00",3567,1057,4624
"2020-03-23 10:11:10","2020-03-24 09:00:00","2020-03-24 09:30:00",3853,1144,4997
"2020-03-23 10:11:10","2020-03-24 10:00:00","2020-03-24 10:30:00",3995,1183,5178
"2020-03-23 10:11:10","2020-03-24 11:00:00","2020-03-24 11:30:00",4071,1179,5250
"2020-03-23 10:11:10","2020-03-24 12:00:00","2020-03-24 12:30:00",4112,1171,5283
"2020-03-23 10:11:10","2020-03-24 13:00:00","2020-03-24 13:30:00",4215,1170,5385
"2020-03-23 10:11:10","2020-03-24 14:00:00","2020-03-24 14:30:00",4140,1137,5277
"2020-03-23 10:11:10","2020-03-24 15:00:00","2020-03-24 15:30:00",4093,1134,5227
"2020-03-23 10:11:10","2020-03-24 16:00:00","2020-03-24 16:30:00",4106,1168,5274
"2020-03-23 10:11:10","2020-03-24 17:00:00","2020-03-24 17:30:00",4239,1282,5521
"2020-03-23 10:11:10","2020-03-24 18:00:00","2020-03-24 18:30:00",4382,1355,5737
"2020-03-23 10:11:10","2020-03-24 19:00:00","2020-03-24 19:30:00",4450,1302,5752
"2020-03-23 10:11:10","2020-03-24 20:00:00","2020-03-24 20:30:00",4280,1207,5487
"2020-03-23 10:11:10","2020-03-24 21:00:00","2020-03-24 21:30:00",3999,1138,5137
"2020-03-23 10:11:10","2020-03-24 22:00:00","2020-03-24 22:30:00",3708,1001,4709
"2020-03-24 10:11:10","2020-03-24 23:00:00","2020-03-24 23:30:00",3488,810,4298
"2020-03-24 10:11:10","2020-03-25 00:00:00","2020-03-25 00:30:00",3164,660,3824
"2020-03-24 10:11:10","2020-03-25 01:00:00","2020-03-25 01:30:00",3006,632,3638
"2020-03-24 10:11:10","2020-03-25 02:00:00","2020-03-25 02:30:00",2846,620,3466
"2020-03-24 10:11:10","2020-03-25 03:00:00","2020-03-25 03:30:00",2783,595,3378
"2020-03-24 10:11:10","2020-03-25 04:00:00","2020-03-25 04:30:00",2771,586,3357
"2020-03-24 10:11:10","2020-03-25 05:00:00","2020-03-25 05:30:00",2785,608,3393
"2020-03-24 10:11:10","2020-03-25 06:00:00","2020-03-25 06:30:00",2942,663,3605
"2020-03-24 10:11:10","2020-03-25 07:00:00","2020-03-25 07:30:00",3200,782,3982
"2020-03-24 10:11:10","2020-03-25 08:00:00","2020-03-25 08:30:00",3567,933,4500
"2020-03-24 10:11:10","2020-03-25 09:00:00","2020-03-25 09:30:00",3853,1016,4869
"2020-03-24 10:11:10","2020-03-25 10:00:00","2020-03-25 10:30:00",3995,1036,5031
"2020-03-24 10:11:10","2020-03-25 11:00:00","2020-03-25 11:30:00",4071,1050,5121
"2020-03-24 10:11:10","2020-03-25 12:00:00","2020-03-25 12:30:00",4112,1074,5186
"2020-03-24 10:11:10","2020-03-25 13:00:00","2020-03-25 13:30:00",4215,1109,5324
"2020-03-24 10:11:10","2020-03-25 14:00:00","2020-03-25 14:30:00",4140,1076,5216
"2020-03-24 10:11:10","2020-03-25 15:00:00","2020-03-25 15:30:00",4093,1088,5181
"2020-03-24 10:11:10","2020-03-25 16:00:00","2020-03-25 16:30:00",4106,1120,5226
"2020-03-24 10:11:10","2020-03-25 17:00:00","2020-03-25 17:30:00",4239,1220,5459
"2020-03-24 10:11:10","2020-03-25 18:00:00","2020-03-25 18:30:00",4382,1248,5630
"2020-03-24 10:11:10","2020-03-25 19:00:00","2020-03-25 19:30:00",4450,1209,5659
"2020-03-24 10:11:10","2020-03-25 20:00:00","2020-03-25 20:30:00",4280,1145,5425
"2020-03-24 10:11:10","2020-03-25 21:00:00","2020-03-25 21:30:00",3999,1019,5018
"2020-03-24 10:11:10","2020-03-25 22:00:00","2020-03-25 22:30:00",3708,931,4639
"2020-03-25 10:11:40","2020-03-25 23:00:00","2020-03-25 23:30:00",3479,780,4259
"2020-03-25 10:11:40","2020-03-26 00:00:00","2020-03-26 00:30:00",3164,711,3875
"2020-03-25 10:11:40","2020-03-26 01:00:00","2020-03-26 01:30:00",3006,660,3666
"2020-03-25 10:11:40","2020-03-26 02:00:00","2020-03-26 02:30:00",2846,645,3491
"2020-03-25 10:11:40","2020-03-26 03:00:00","2020-03-26 03:30:00",2783,633,3416
"2020-03-25 10:11:40","2020-03-26 04:00:00","2020-03-26 04:30:00",2771,600,3371
"2020-03-25 10:11:40","2020-03-26 05:00:00","2020-03-26 05:30:00",2785,608,3393
"2020-03-25 10:11:40","2020-03-26 06:00:00","2020-03-26 06:30:00",2942,660,3602
"2020-03-25 10:11:40","2020-03-26 07:00:00","2020-03-26 07:30:00",3200,750,3950
"2020-03-25 10:11:40","2020-03-26 08:00:00","2020-03-26 08:30:00",3567,880,4447
"2020-03-25 10:11:40","2020-03-26 09:00:00","2020-03-26 09:30:00",3853,980,4833
"2020-03-25 10:11:40","2020-03-26 10:00:00","2020-03-26 10:30:00",3995,1010,5005
"2020-03-25 10:11:40","2020-03-26 11:00:00","2020-03-26 11:30:00",4071,1018,5089
"2020-03-25 10:11:40","2020-03-26 12:00:00","2020-03-26 12:30:00",4112,1008,5120
"2020-03-25 10:11:40","2020-03-26 13:00:00","2020-03-26 13:30:00",4215,1025,5240
"2020-03-25 10:11:40","2020-03-26 14:00:00","2020-03-26 14:30:00",4140,1038,5178
"2020-03-25 10:11:40","2020-03-26 15:00:00","2020-03-26 15:30:00",4093,1025,5118
"2020-03-25 10:11:40","2020-03-26 16:00:00","2020-03-26 16:30:00",4106,1050,5156
"2020-03-25 10:11:40","2020-03-26 17:00:00","2020-03-26 17:30:00",4239,1180,5419
"2020-03-25 10:11:40","2020-03-26 18:00:00","2020-03-26 18:30:00",4382,1220,5602
"2020-03-25 10:11:40","2020-03-26 19:00:00","2020-03-26 19:30:00",4450,1180,5630
"2020-03-25 10:11:40","2020-03-26 20:00:00","2020-03-26 20:30:00",4280,1115,5395
"2020-03-25 10:11:40","2020-03-26 21:00:00","2020-03-26 21:30:00",3999,990,4989
"2020-03-25 10:11:40","2020-03-26 22:00:00","2020-03-26 22:30:00",3708,902,4610
"2020-03-26 10:11:35","2020-03-26 23:00:00","2020-03-26 23:30:00",3226,810,4036
"2020-03-26 10:11:35","2020-03-27 00:00:00","2020-03-27 00:30:00",3030,708,3738
"2020-03-26 10:11:35","2020-03-27 01:00:00","2020-03-27 01:30:00",2826,637,3463
"2020-03-26 10:11:35","2020-03-27 02:00:00","2020-03-27 02:30:00",2696,611,3307
"2020-03-26 10:11:35","2020-03-27 03:00:00","2020-03-27 03:30:00",2626,587,3213
"2020-03-26 10:11:35","2020-03-27 04:00:00","2020-03-27 04:30:00",2620,590,3210
"2020-03-26 10:11:35","2020-03-27 05:00:00","2020-03-27 05:30:00",2619,618,3237
"2020-03-26 10:11:35","2020-03-27 06:00:00","2020-03-27 06:30:00",2777,655,3432
"2020-03-26 10:11:35","2020-03-27 07:00:00","2020-03-27 07:30:00",3040,750,3790
"2020-03-26 10:11:35","2020-03-27 08:00:00","2020-03-27 08:30:00",3398,870,4268
"2020-03-26 10:11:35","2020-03-27 09:00:00","2020-03-27 09:30:00",3679,950,4629
"2020-03-26 10:11:35","2020-03-27 10:00:00","2020-03-27 10:30:00",3742,1000,4742
"2020-03-26 10:11:35","2020-03-27 11:00:00","2020-03-27 11:30:00",3777,1030,4807
"2020-03-26 10:11:35","2020-03-27 12:00:00","2020-03-27 12:30:00",3823,1055,4878
"2020-03-26 10:11:35","2020-03-27 13:00:00","2020-03-27 13:30:00",3935,1090,5025
"2020-03-26 10:11:35","2020-03-27 14:00:00","2020-03-27 14:30:00",3790,1055,4845
"2020-03-26 10:11:35","2020-03-27 15:00:00","2020-03-27 15:30:00",3732,1030,4762
"2020-03-26 10:11:35","2020-03-27 16:00:00","2020-03-27 16:30:00",3780,1050,4830
"2020-03-26 10:11:35","2020-03-27 17:00:00","2020-03-27 17:30:00",3947,1150,5097
"2020-03-26 10:11:35","2020-03-27 18:00:00","2020-03-27 18:30:00",4196,1180,5376
"2020-03-26 10:11:35","2020-03-27 19:00:00","2020-03-27 19:30:00",4227,1160,5387
"2020-03-26 10:11:35","2020-03-27 20:00:00","2020-03-27 20:30:00",4107,1100,5207
"2020-03-26 10:11:35","2020-03-27 21:00:00","2020-03-27 21:30:00",3835,1000,4835
"2020-03-26 10:11:35","2020-03-27 22:00:00","2020-03-27 22:30:00",3510,900,4410
"2020-03-27 10:11:35","2020-03-27 23:00:00","2020-03-27 23:30:00",3226,791,4017
"2020-03-27 10:11:35","2020-03-28 00:00:00","2020-03-28 00:30:00",3416,630,4046
"2020-03-27 10:11:35","2020-03-28 01:00:00","2020-03-28 01:30:00",3151,588,3739
"2020-03-27 10:11:35","2020-03-28 02:00:00","2020-03-28 02:30:00",2949,560,3509
"2020-03-27 10:11:35","2020-03-28 03:00:00","2020-03-28 03:30:00",2797,532,3329
"2020-03-27 10:11:35","2020-03-28 04:00:00","2020-03-28 04:30:00",2681,532,3213
"2020-03-27 10:11:35","2020-03-28 05:00:00","2020-03-28 05:30:00",2661,570,3231
"2020-03-27 10:11:35","2020-03-28 06:00:00","2020-03-28 06:30:00",2729,600,3329
"2020-03-27 10:11:35","2020-03-28 07:00:00","2020-03-28 07:30:00",2907,660,3567
"2020-03-27 10:11:35","2020-03-28 08:00:00","2020-03-28 08:30:00",3055,750,3805
"2020-03-27 10:11:35","2020-03-28 09:00:00","2020-03-28 09:30:00",3349,845,4194
"2020-03-27 10:11:35","2020-03-28 10:00:00","2020-03-28 10:30:00",3570,920,4490
"2020-03-27 10:11:35","2020-03-28 11:00:00","2020-03-28 11:30:00",3621,945,4566
"2020-03-27 10:11:35","2020-03-28 12:00:00","2020-03-28 12:30:00",3455,975,4430
"2020-03-27 10:11:35","2020-03-28 13:00:00","2020-03-28 13:30:00",3617,980,4597
"2020-03-27 10:11:35","2020-03-28 14:00:00","2020-03-28 14:30:00",3483,930,4413
"2020-03-27 10:11:35","2020-03-28 15:00:00","2020-03-28 15:30:00",3501,922,4423
"2020-03-27 10:11:35","2020-03-28 16:00:00","2020-03-28 16:30:00",3470,940,4410
"2020-03-27 10:11:35","2020-03-28 17:00:00","2020-03-28 17:30:00",3651,1050,4701
"2020-03-27 10:11:35","2020-03-28 18:00:00","2020-03-28 18:30:00",3951,1140,5091
"2020-03-27 10:11:35","2020-03-28 19:00:00","2020-03-28 19:30:00",4036,1152,5188
"2020-03-27 10:11:35","2020-03-28 20:00:00","2020-03-28 20:30:00",3757,1060,4817
"2020-03-27 10:11:35","2020-03-28 21:00:00","2020-03-28 21:30:00",3534,970,4504
"2020-03-27 10:11:35","2020-03-28 22:00:00","2020-03-28 22:30:00",3304,870,4174
"2020-03-28 10:11:30","2020-03-28 23:00:00","2020-03-28 23:30:00",3060,762,3822
"2020-03-28 10:11:30","2020-03-29 00:00:00","2020-03-29 00:30:00",3083,662,3745
"2020-03-28 10:11:30","2020-03-29 01:00:00","2020-03-29 01:30:00",2767,604,3371
"2020-03-28 10:11:30","2020-03-29 02:00:00","2020-03-29 02:30:00",2672,579,3251
"2020-03-28 10:11:30","2020-03-29 03:00:00","2020-03-29 03:30:00",2617,552,3169
"2020-03-28 10:11:30","2020-03-29 04:00:00","2020-03-29 04:30:00",2576,553,3129
"2020-03-28 10:11:30","2020-03-29 05:00:00","2020-03-29 05:30:00",2595,572,3167
"2020-03-28 10:11:30","2020-03-29 06:00:00","2020-03-29 06:30:00",2670,586,3256
"2020-03-28 10:11:30","2020-03-29 07:00:00","2020-03-29 07:30:00",2747,652,3399
"2020-03-28 10:11:30","2020-03-29 08:00:00","2020-03-29 08:30:00",3074,732,3806
"2020-03-28 10:11:30","2020-03-29 09:00:00","2020-03-29 09:30:00",3291,824,4115
"2020-03-28 10:11:30","2020-03-29 10:00:00","2020-03-29 10:30:00",3400,872,4272
"2020-03-28 10:11:30","2020-03-29 11:00:00","2020-03-29 11:30:00",3489,907,4396
"2020-03-28 10:11:30","2020-03-29 12:00:00","2020-03-29 12:30:00",3516,924,4440
"2020-03-28 10:11:30","2020-03-29 13:00:00","2020-03-29 13:30:00",3510,885,4395
"2020-03-28 10:11:30","2020-03-29 14:00:00","2020-03-29 14:30:00",3443,874,4317
"2020-03-28 10:11:30","2020-03-29 15:00:00","2020-03-29 15:30:00",3443,873,4316
"2020-03-28 10:11:30","2020-03-29 16:00:00","2020-03-29 16:30:00",3469,924,4393
"2020-03-28 10:11:30","2020-03-29 17:00:00","2020-03-29 17:30:00",3788,955,4743
"2020-03-28 10:11:30","2020-03-29 18:00:00","2020-03-29 18:30:00",3850,953,4803
"2020-03-28 10:11:30","2020-03-29 19:00:00","2020-03-29 19:30:00",3732,997,4729
"2020-03-28 10:11:30","2020-03-29 20:00:00","2020-03-29 20:30:00",3508,1054,4562
"2020-03-28 10:11:30","2020-03-29 21:00:00","2020-03-29 21:30:00",3239,943,4182
"2020-03-28 10:11:30","2020-03-29 22:00:00","2020-03-29 22:30:00",3014,819,3833
"2020-03-29 10:11:31","2020-03-29 23:00:00","2020-03-29 23:30:00",2657,654,3311
"2020-03-29 10:11:31","2020-03-30 00:00:00","2020-03-30 00:30:00",2588,604,3192
"2020-03-29 10:11:31","2020-03-30 01:00:00","2020-03-30 01:30:00",2482,588,3070
"2020-03-29 10:11:31","2020-03-30 02:00:00","2020-03-30 02:30:00",2407,570,2977
"2020-03-29 10:11:31","2020-03-30 03:00:00","2020-03-30 03:30:00",2370,564,2934
"2020-03-29 10:11:31","2020-03-30 04:00:00","2020-03-30 04:30:00",2411,574,2985
"2020-03-29 10:11:31","2020-03-30 05:00:00","2020-03-30 05:30:00",2604,630,3234
"2020-03-29 10:11:31","2020-03-30 06:00:00","2020-03-30 06:30:00",3026,735,3761
"2020-03-29 10:11:31","2020-03-30 07:00:00","2020-03-30 07:30:00",3548,836,4384
"2020-03-29 10:11:31","2020-03-30 08:00:00","2020-03-30 08:30:00",3703,915,4618
"2020-03-29 10:11:31","2020-03-30 09:00:00","2020-03-30 09:30:00",3709,943,4652
"2020-03-29 10:11:31","2020-03-30 10:00:00","2020-03-30 10:30:00",3708,954,4662
"2020-03-29 10:11:31","2020-03-30 11:00:00","2020-03-30 11:30:00",3716,969,4685
"2020-03-29 10:11:31","2020-03-30 12:00:00","2020-03-30 12:30:00",3731,984,4715
"2020-03-29 10:11:31","2020-03-30 13:00:00","2020-03-30 13:30:00",3634,936,4570
"2020-03-29 10:11:31","2020-03-30 14:00:00","2020-03-30 14:30:00",3656,928,4584
"2020-03-29 10:11:31","2020-03-30 15:00:00","2020-03-30 15:30:00",3705,963,4668
"2020-03-29 10:11:31","2020-03-30 16:00:00","2020-03-30 16:30:00",3807,1100,4907
"2020-03-29 10:11:31","2020-03-30 17:00:00","2020-03-30 17:30:00",3897,1135,5032
"2020-03-29 10:11:31","2020-03-30 18:00:00","2020-03-30 18:30:00",3768,1062,4830
"2020-03-29 10:11:31","2020-03-30 19:00:00","2020-03-30 19:30:00",3807,1075,4882
"2020-03-29 10:11:31","2020-03-30 20:00:00","2020-03-30 20:30:00",3803,1040,4843
"2020-03-29 10:11:31","2020-03-30 21:00:00","2020-03-30 21:30:00",3425,900,4325
"2020-03-29 10:11:31","2020-03-30 22:00:00","2020-03-30 22:30:00",3043,791,3834
"2020-03-30 10:11:36","2020-03-30 23:00:00","2020-03-30 23:30:00",3043,719,3762
"2020-03-30 10:11:36","2020-03-31 00:00:00","2020-03-31 00:30:00",2764,650,3414
"2020-03-30 10:11:36","2020-03-31 01:00:00","2020-03-31 01:30:00",2694,605,3299
"2020-03-30 10:11:36","2020-03-31 02:00:00","2020-03-31 02:30:00",2612,591,3203
"2020-03-30 10:11:36","2020-03-31 03:00:00","2020-03-31 03:30:00",2530,578,3108
"2020-03-30 10:11:36","2020-03-31 04:00:00","2020-03-31 04:30:00",2470,572,3042
"2020-03-30 10:11:36","2020-03-31 05:00:00","2020-03-31 05:30:00",2489,593,3082
"2020-03-30 10:11:36","2020-03-31 06:00:00","2020-03-31 06:30:00",2712,631,3343
"2020-03-30 10:11:36","2020-03-31 07:00:00","2020-03-31 07:30:00",3123,722,3845
"2020-03-30 10:11:36","2020-03-31 08:00:00","2020-03-31 08:30:00",3599,820,4419
"2020-03-30 10:11:36","2020-03-31 09:00:00","2020-03-31 09:30:00",3710,884,4594
"2020-03-30 10:11:36","2020-03-31 10:00:00","2020-03-31 10:30:00",3679,919,4598
"2020-03-30 10:11:36","2020-03-31 11:00:00","2020-03-31 11:30:00",3704,941,4645
"2020-03-30 10:11:36","2020-03-31 12:00:00","2020-03-31 12:30:00",3734,950,4684
"2020-03-30 10:11:36","2020-03-31 13:00:00","2020-03-31 13:30:00",3723,987,4710
"2020-03-30 10:11:36","2020-03-31 14:00:00","2020-03-31 14:30:00",3638,949,4587
"2020-03-30 10:11:36","2020-03-31 15:00:00","2020-03-31 15:30:00",3667,939,4606
"2020-03-30 10:11:36","2020-03-31 16:00:00","2020-03-31 16:30:00",3678,946,4624
"2020-03-30 10:11:36","2020-03-31 17:00:00","2020-03-31 17:30:00",3850,1077,4927
"2020-03-30 10:11:36","2020-03-31 18:00:00","2020-03-31 18:30:00",3900,1121,5021
"2020-03-30 10:11:36","2020-03-31 19:00:00","2020-03-31 19:30:00",3799,1075,4874
"2020-03-30 10:11:36","2020-03-31 20:00:00","2020-03-31 20:30:00",3778,1051,4829
"2020-03-30 10:11:36","2020-03-31 21:00:00","2020-03-31 21:30:00",3832,989,4821
"2020-03-30 10:11:36","2020-03-31 22:00:00","2020-03-31 22:30:00",3578,869,4447
"2020-03-31 10:11:11","2020-03-31 23:00:00","2020-03-31 23:30:00",3121,746,3867
"2020-03-31 10:11:11","2020-04-01 00:00:00","2020-04-01 00:30:00",2851,658,3509
"2020-03-31 10:11:11","2020-04-01 01:00:00","2020-04-01 01:30:00",2827,602,3429
"2020-03-31 10:11:11","2020-04-01 02:00:00","2020-04-01 02:30:00",2736,589,3325
"2020-03-31 10:11:11","2020-04-01 03:00:00","2020-04-01 03:30:00",2602,573,3175
"2020-03-31 10:11:11","2020-04-01 04:00:00","2020-04-01 04:30:00",2561,563,3124
"2020-03-31 10:11:11","2020-04-01 05:00:00","2020-04-01 05:30:00",2572,573,3145
"2020-03-31 10:11:11","2020-04-01 06:00:00","2020-04-01 06:30:00",2683,614,3297
"2020-03-31 10:11:11","2020-04-01 07:00:00","2020-04-01 07:30:00",2897,691,3588
"2020-03-31 10:11:11","2020-04-01 08:00:00","2020-04-01 08:30:00",3214,789,4003
"2020-03-31 10:11:11","2020-04-01 09:00:00","2020-04-01 09:30:00",3444,863,4307
"2020-03-31 10:11:11","2020-04-01 10:00:00","2020-04-01 10:30:00",3527,900,4427
"2020-03-31 10:11:11","2020-04-01 11:00:00","2020-04-01 11:30:00",3638,912,4550
"2020-03-31 10:11:11","2020-04-01 12:00:00","2020-04-01 12:30:00",3765,923,4688
"2020-03-31 10:11:11","2020-04-01 13:00:00","2020-04-01 13:30:00",3918,958,4876
"2020-03-31 10:11:11","2020-04-01 14:00:00","2020-04-01 14:30:00",3779,914,4693
"2020-03-31 10:11:11","2020-04-01 15:00:00","2020-04-01 15:30:00",3737,892,4629
"2020-03-31 10:11:11","2020-04-01 16:00:00","2020-04-01 16:30:00",3702,904,4606
"2020-03-31 10:11:11","2020-04-01 17:00:00","2020-04-01 17:30:00",3872,1024,4896
"2020-03-31 10:11:11","2020-04-01 18:00:00","2020-04-01 18:30:00",4070,1062,5132
"2020-03-31 10:11:11","2020-04-01 19:00:00","2020-04-01 19:30:00",3909,1012,4921
"2020-03-31 10:11:11","2020-04-01 20:00:00","2020-04-01 20:30:00",3757,978,4735
"2020-03-31 10:11:11","2020-04-01 21:00:00","2020-04-01 21:30:00",3769,918,4687
"2020-03-31 10:11:11","2020-04-01 22:00:00","2020-04-01 22:30:00",3455,805,4260
"2020-04-01 10:11:10","2020-04-01 23:00:00","2020-04-01 23:30:00",3128,770,3898
"2020-04-01 10:11:10","2020-04-02 00:00:00","2020-04-02 00:30:00",2859,587,3446
"2020-04-01 10:11:10","2020-04-02 01:00:00","2020-04-02 01:30:00",2835,539,3374
"2020-04-01 10:11:10","2020-04-02 02:00:00","2020-04-02 02:30:00",2745,521,3266
"2020-04-01 10:11:10","2020-04-02 03:00:00","2020-04-02 03:30:00",2611,509,3120
"2020-04-01 10:11:10","2020-04-02 04:00:00","2020-04-02 04:30:00",2571,500,3071
"2020-04-01 10:11:10","2020-04-02 05:00:00","2020-04-02 05:30:00",2582,493,3075
"2020-04-01 10:11:10","2020-04-02 06:00:00","2020-04-02 06:30:00",2692,538,3230
"2020-04-01 10:11:10","2020-04-02 07:00:00","2020-04-02 07:30:00",2905,596,3501
"2020-04-01 10:11:10","2020-04-02 08:00:00","2020-04-02 08:30:00",3219,697,3916
"2020-04-01 10:11:10","2020-04-02 09:00:00","2020-04-02 09:30:00",3448,782,4230
"2020-04-01 10:11:10","2020-04-02 10:00:00","2020-04-02 10:30:00",3530,840,4370
"2020-04-01 10:11:10","2020-04-02 11:00:00","2020-04-02 11:30:00",3641,880,4521
"2020-04-01 10:11:10","2020-04-02 12:00:00","2020-04-02 12:30:00",3767,902,4669
"2020-04-01 10:11:10","2020-04-02 13:00:00","2020-04-02 13:30:00",3919,978,4897
"2020-04-01 10:11:10","2020-04-02 14:00:00","2020-04-02 14:30:00",3781,920,4701
"2020-04-01 10:11:10","2020-04-02 15:00:00","2020-04-02 15:30:00",3740,921,4661
"2020-04-01 10:11:10","2020-04-02 16:00:00","2020-04-02 16:30:00",3705,940,4645
"2020-04-01 10:11:10","2020-04-02 17:00:00","2020-04-02 17:30:00",3874,1073,4947
"2020-04-01 10:11:10","2020-04-02 18:00:00","2020-04-02 18:30:00",4070,1119,5189
"2020-04-01 10:11:10","2020-04-02 19:00:00","2020-04-02 19:30:00",3910,1065,4975
"2020-04-01 10:11:10","2020-04-02 20:00:00","2020-04-02 20:30:00",3759,1031,4790
"2020-04-01 10:11:10","2020-04-02 21:00:00","2020-04-02 21:30:00",3771,991,4762
"2020-04-01 10:11:10","2020-04-02 22:00:00","2020-04-02 22:30:00",3459,885,4344
"2020-04-02 10:11:31","2020-04-02 23:00:00","2020-04-02 23:30:00",3106,801,3907
"2020-04-02 10:11:31","2020-04-03 00:00:00","2020-04-03 00:30:00",2881,628,3509
"2020-04-02 10:11:31","2020-04-03 01:00:00","2020-04-03 01:30:00",2798,588,3386
"2020-04-02 10:11:31","2020-04-03 02:00:00","2020-04-03 02:30:00",2668,562,3230
"2020-04-02 10:11:31","2020-04-03 03:00:00","2020-04-03 03:30:00",2567,524,3091
"2020-04-02 10:11:31","2020-04-03 04:00:00","2020-04-03 04:30:00",2520,531,3051
"2020-04-02 10:11:31","2020-04-03 05:00:00","2020-04-03 05:30:00",2541,535,3076
"2020-04-02 10:11:31","2020-04-03 06:00:00","2020-04-03 06:30:00",2653,547,3200
"2020-04-02 10:11:31","2020-04-03 07:00:00","2020-04-03 07:30:00",2849,619,3468
"2020-04-02 10:11:31","2020-04-03 08:00:00","2020-04-03 08:30:00",3146,752,3898
"2020-04-02 10:11:31","2020-04-03 09:00:00","2020-04-03 09:30:00",3398,850,4248
"2020-04-02 10:11:31","2020-04-03 10:00:00","2020-04-03 10:30:00",3452,857,4309
"2020-04-02 10:11:31","2020-04-03 11:00:00","2020-04-03 11:30:00",3527,888,4415
"2020-04-02 10:11:31","2020-04-03 12:00:00","2020-04-03 12:30:00",3588,876,4464
"2020-04-02 10:11:31","2020-04-03 13:00:00","2020-04-03 13:30:00",3727,871,4598
"2020-04-02 10:11:31","2020-04-03 14:00:00","2020-04-03 14:30:00",3595,831,4426
"2020-04-02 10:11:31","2020-04-03 15:00:00","2020-04-03 15:30:00",3532,820,4352
"2020-04-02 10:11:31","2020-04-03 16:00:00","2020-04-03 16:30:00",3520,849,4369
"2020-04-02 10:11:31","2020-04-03 17:00:00","2020-04-03 17:30:00",3726,950,4676
"2020-04-02 10:11:31","2020-04-03 18:00:00","2020-04-03 18:30:00",3900,1033,4933
"2020-04-02 10:11:31","2020-04-03 19:00:00","2020-04-03 19:30:00",3759,1023,4782
"2020-04-02 10:11:31","2020-04-03 20:00:00","2020-04-03 20:30:00",3702,968,4670
"2020-04-02 10:11:31","2020-04-03 21:00:00","2020-04-03 21:30:00",3702,884,4586
"2020-04-02 10:11:31","2020-04-03 22:00:00","2020-04-03 22:30:00",3406,797,4203
"2020-04-03 10:11:26","2020-04-03 23:00:00","2020-04-03 23:30:00",3094,794,3888
"2020-04-03 10:11:26","2020-04-04 00:00:00","2020-04-04 00:30:00",3079,604,3683
"2020-04-03 10:11:26","2020-04-04 01:00:00","2020-04-04 01:30:00",2823,553,3376
"2020-04-03 10:11:26","2020-04-04 02:00:00","2020-04-04 02:30:00",2650,550,3200
"2020-04-03 10:11:26","2020-04-04 03:00:00","2020-04-04 03:30:00",2539,516,3055
"2020-04-03 10:11:26","2020-04-04 04:00:00","2020-04-04 04:30:00",2479,495,2974
"2020-04-03 10:11:26","2020-04-04 05:00:00","2020-04-04 05:30:00",2460,494,2954
"2020-04-03 10:11:26","2020-04-04 06:00:00","2020-04-04 06:30:00",2490,483,2973
"2020-04-03 10:11:26","2020-04-04 07:00:00","2020-04-04 07:30:00",2596,521,3117
"2020-04-03 10:11:26","2020-04-04 08:00:00","2020-04-04 08:30:00",2748,579,3327
"2020-04-03 10:11:26","2020-04-04 09:00:00","2020-04-04 09:30:00",2967,635,3602
"2020-04-03 10:11:26","2020-04-04 10:00:00","2020-04-04 10:30:00",3137,670,3807
"2020-04-03 10:11:26","2020-04-04 11:00:00","2020-04-04 11:30:00",3253,682,3935
"2020-04-03 10:11:26","2020-04-04 12:00:00","2020-04-04 12:30:00",3357,704,4061
"2020-04-03 10:11:26","2020-04-04 13:00:00","2020-04-04 13:30:00",3436,733,4169
"2020-04-03 10:11:26","2020-04-04 14:00:00","2020-04-04 14:30:00",3341,704,4045
"2020-04-03 10:11:26","2020-04-04 15:00:00","2020-04-04 15:30:00",3255,686,3941
"2020-04-03 10:11:26","2020-04-04 16:00:00","2020-04-04 16:30:00",3259,699,3958
"2020-04-03 10:11:26","2020-04-04 17:00:00","2020-04-04 17:30:00",3490,819,4309
"2020-04-03 10:11:26","2020-04-04 18:00:00","2020-04-04 18:30:00",3720,899,4619
"2020-04-03 10:11:26","2020-04-04 19:00:00","2020-04-04 19:30:00",3690,889,4579
"2020-04-03 10:11:26","2020-04-04 20:00:00","2020-04-04 20:30:00",3610,818,4428
"2020-04-03 10:11:26","2020-04-04 21:00:00","2020-04-04 21:30:00",3630,728,4358
"2020-04-03 10:11:26","2020-04-04 22:00:00","2020-04-04 22:30:00",3400,686,4086
"2020-04-04 10:11:16","2020-04-04 23:00:00","2020-04-04 23:30:00",3110,760,3870
"2020-04-04 10:11:16","2020-04-05 00:00:00","2020-04-05 00:30:00",2860,554,3414
"2020-04-04 10:11:16","2020-04-05 01:00:00","2020-04-05 01:30:00",2780,513,3293
"2020-04-04 10:11:16","2020-04-05 02:00:00","2020-04-05 02:30:00",2650,506,3156
"2020-04-04 10:11:16","2020-04-05 03:00:00","2020-04-05 03:30:00",2540,486,3026
"2020-04-04 10:11:16","2020-04-05 04:00:00","2020-04-05 04:30:00",2470,463,2933
"2020-04-04 10:11:16","2020-04-05 05:00:00","2020-04-05 05:30:00",2470,472,2942
"2020-04-04 10:11:16","2020-04-05 06:00:00","2020-04-05 06:30:00",2526,463,2989
"2020-04-04 10:11:16","2020-04-05 07:00:00","2020-04-05 07:30:00",2584,459,3043
"2020-04-04 10:11:16","2020-04-05 08:00:00","2020-04-05 08:30:00",2707,503,3210
"2020-04-04 10:11:16","2020-04-05 09:00:00","2020-04-05 09:30:00",2852,547,3399
"2020-04-04 10:11:16","2020-04-05 10:00:00","2020-04-05 10:30:00",3105,640,3745
"2020-04-04 10:11:16","2020-04-05 11:00:00","2020-04-05 11:30:00",3307,660,3967
"2020-04-04 10:11:16","2020-04-05 12:00:00","2020-04-05 12:30:00",3464,657,4121
"2020-04-04 10:11:16","2020-04-05 13:00:00","2020-04-05 13:30:00",3440,716,4156
"2020-04-04 10:11:16","2020-04-05 14:00:00","2020-04-05 14:30:00",3381,652,4033
"2020-04-04 10:11:16","2020-04-05 15:00:00","2020-04-05 15:30:00",3384,640,4024
"2020-04-04 10:11:16","2020-04-05 16:00:00","2020-04-05 16:30:00",3495,685,4180
"2020-04-04 10:11:16","2020-04-05 17:00:00","2020-04-05 17:30:00",3640,770,4410
"2020-04-04 10:11:16","2020-04-05 18:00:00","2020-04-05 18:30:00",3568,864,4432
"2020-04-04 10:11:16","2020-04-05 19:00:00","2020-04-05 19:30:00",3457,864,4321
"2020-04-04 10:11:16","2020-04-05 20:00:00","2020-04-05 20:30:00",3546,817,4363
"2020-04-04 10:11:16","2020-04-05 21:00:00","2020-04-05 21:30:00",3271,727,3998
"2020-04-04 10:11:16","2020-04-05 22:00:00","2020-04-05 22:30:00",3017,665,3682
"2020-04-05 10:11:06","2020-04-05 23:00:00","2020-04-05 23:30:00",3009,720,3729
"2020-04-05 10:11:06","2020-04-06 00:00:00","2020-04-06 00:30:00",2795,661,3456
"2020-04-05 10:11:06","2020-04-06 01:00:00","2020-04-06 01:30:00",2772,601,3373
"2020-04-05 10:11:06","2020-04-06 02:00:00","2020-04-06 02:30:00",2686,563,3249
"2020-04-05 10:11:06","2020-04-06 03:00:00","2020-04-06 03:30:00",2559,565,3124
"2020-04-05 10:11:06","2020-04-06 04:00:00","2020-04-06 04:30:00",2520,545,3065
"2020-04-05 10:11:06","2020-04-06 05:00:00","2020-04-06 05:30:00",2530,547,3077
"2020-04-05 10:11:06","2020-04-06 06:00:00","2020-04-06 06:30:00",2636,588,3224
"2020-04-05 10:11:06","2020-04-06 07:00:00","2020-04-06 07:30:00",2838,661,3499
"2020-04-05 10:11:06","2020-04-06 08:00:00","2020-04-06 08:30:00",3138,754,3892
"2020-04-05 10:11:06","2020-04-06 09:00:00","2020-04-06 09:30:00",3357,816,4173
"2020-04-05 10:11:06","2020-04-06 10:00:00","2020-04-06 10:30:00",3435,842,4277
"2020-04-05 10:11:06","2020-04-06 11:00:00","2020-04-06 11:30:00",3540,871,4411
"2020-04-05 10:11:06","2020-04-06 12:00:00","2020-04-06 12:30:00",3661,890,4551
"2020-04-05 10:11:06","2020-04-06 13:00:00","2020-04-06 13:30:00",3806,937,4743
"2020-04-05 10:11:06","2020-04-06 14:00:00","2020-04-06 14:30:00",3674,893,4567
"2020-04-05 10:11:06","2020-04-06 15:00:00","2020-04-06 15:30:00",3635,856,4491
"2020-04-05 10:11:06","2020-04-06 16:00:00","2020-04-06 16:30:00",3602,881,4483
"2020-04-05 10:11:06","2020-04-06 17:00:00","2020-04-06 17:30:00",3763,1030,4793
"2020-04-05 10:11:06","2020-04-06 18:00:00","2020-04-06 18:30:00",3950,1084,5034
"2020-04-05 10:11:06","2020-04-06 19:00:00","2020-04-06 19:30:00",3797,996,4793
"2020-04-05 10:11:06","2020-04-06 20:00:00","2020-04-06 20:30:00",3653,963,4616
"2020-04-05 10:11:06","2020-04-06 21:00:00","2020-04-06 21:30:00",3665,982,4647
"2020-04-05 10:11:06","2020-04-06 22:00:00","2020-04-06 22:30:00",3367,885,4252
"2020-04-05 10:11:06","2020-04-06 23:00:00","2020-04-06 23:30:00",3057,769,3826
"2020-04-05 10:11:06","2020-04-07 00:00:00","2020-04-07 00:30:00",2884,664,3548
"2020-04-05 10:11:06","2020-04-07 01:00:00","2020-04-07 01:30:00",2799,607,3406
"2020-04-05 10:11:06","2020-04-07 02:00:00","2020-04-07 02:30:00",2663,582,3245
"2020-04-05 10:11:06","2020-04-07 03:00:00","2020-04-07 03:30:00",2564,579,3143
"2020-04-05 10:11:06","2020-04-07 04:00:00","2020-04-07 04:30:00",2534,570,3104
"2020-04-05 10:11:06","2020-04-07 05:00:00","2020-04-07 05:30:00",2570,558,3128
"2020-04-05 10:11:06","2020-04-07 06:00:00","2020-04-07 06:30:00",2697,589,3286
"2020-04-05 10:11:06","2020-04-07 07:00:00","2020-04-07 07:30:00",2880,633,3513
"2020-04-05 10:11:06","2020-04-07 08:00:00","2020-04-07 08:30:00",3192,696,3888
"2020-04-05 10:11:06","2020-04-07 09:00:00","2020-04-07 09:30:00",3433,746,4179
"2020-04-05 10:11:06","2020-04-07 10:00:00","2020-04-07 10:30:00",3506,757,4263
"2020-04-05 10:11:06","2020-04-07 11:00:00","2020-04-07 11:30:00",3565,751,4316
"2020-04-05 10:11:06","2020-04-07 12:00:00","2020-04-07 12:30:00",3593,761,4354
"2020-04-05 10:11:06","2020-04-07 13:00:00","2020-04-07 13:30:00",3729,779,4508
"2020-04-05 10:11:06","2020-04-07 14:00:00","2020-04-07 14:30:00",3613,749,4362
"2020-04-05 10:11:06","2020-04-07 15:00:00","2020-04-07 15:30:00",3519,723,4242
"2020-04-05 10:11:06","2020-04-07 16:00:00","2020-04-07 16:30:00",3535,740,4275
"2020-04-05 10:11:06","2020-04-07 17:00:00","2020-04-07 17:30:00",3722,872,4594
"2020-04-05 10:11:06","2020-04-07 18:00:00","2020-04-07 18:30:00",3942,917,4859
"2020-04-05 10:11:06","2020-04-07 19:00:00","2020-04-07 19:30:00",3819,855,4674
"2020-04-05 10:11:06","2020-04-07 20:00:00","2020-04-07 20:30:00",3696,818,4514
"2020-04-05 10:11:06","2020-04-07 21:00:00","2020-04-07 21:30:00",3734,852,4586
"2020-04-05 10:11:06","2020-04-07 22:00:00","2020-04-07 22:30:00",3424,785,4209
"2020-04-07 10:11:21","2020-04-07 23:00:00","2020-04-07 23:30:00",3080,827,3907
"2020-04-07 10:11:21","2020-04-08 00:00:00","2020-04-08 00:30:00",2775,608,3383
"2020-04-07 10:11:21","2020-04-08 01:00:00","2020-04-08 01:30:00",2735,577,3312
"2020-04-07 10:11:21","2020-04-08 02:00:00","2020-04-08 02:30:00",2614,550,3164
"2020-04-07 10:11:21","2020-04-08 03:00:00","2020-04-08 03:30:00",2521,557,3078
"2020-04-07 10:11:21","2020-04-08 04:00:00","2020-04-08 04:30:00",2500,554,3054
"2020-04-07 10:11:21","2020-04-08 05:00:00","2020-04-08 05:30:00",2510,564,3074
"2020-04-07 10:11:21","2020-04-08 06:00:00","2020-04-08 06:30:00",2599,595,3194
"2020-04-07 10:11:21","2020-04-08 07:00:00","2020-04-08 07:30:00",2793,655,3448
"2020-04-07 10:11:21","2020-04-08 08:00:00","2020-04-08 08:30:00",3138,756,3894
"2020-04-07 10:11:21","2020-04-08 09:00:00","2020-04-08 09:30:00",3408,820,4228
"2020-04-07 10:11:21","2020-04-08 10:00:00","2020-04-08 10:30:00",3478,842,4320
"2020-04-07 10:11:21","2020-04-08 11:00:00","2020-04-08 11:30:00",3538,850,4388
"2020-04-07 10:11:21","2020-04-08 12:00:00","2020-04-08 12:30:00",3607,851,4458
"2020-04-07 10:11:21","2020-04-08 13:00:00","2020-04-08 13:30:00",3697,894,4591
"2020-04-07 10:11:21","2020-04-08 14:00:00","2020-04-08 14:30:00",3619,862,4481
"2020-04-07 10:11:21","2020-04-08 15:00:00","2020-04-08 15:30:00",3501,858,4359
"2020-04-07 10:11:21","2020-04-08 16:00:00","2020-04-08 16:30:00",3518,906,4424
"2020-04-07 10:11:21","2020-04-08 17:00:00","2020-04-08 17:30:00",3641,1026,4667
"2020-04-07 10:11:21","2020-04-08 18:00:00","2020-04-08 18:30:00",3790,1076,4866
"2020-04-07 10:11:21","2020-04-08 19:00:00","2020-04-08 19:30:00",3676,1001,4677
"2020-04-07 10:11:21","2020-04-08 20:00:00","2020-04-08 20:30:00",3540,972,4512
"2020-04-07 10:11:21","2020-04-08 21:00:00","2020-04-08 21:30:00",3676,1022,4698
"2020-04-07 10:11:21","2020-04-08 22:00:00","2020-04-08 22:30:00",3379,933,4312
"2020-04-08 10:11:06","2020-04-08 23:00:00","2020-04-08 23:30:00",3076,827,3903
"2020-04-08 10:11:06","2020-04-09 00:00:00","2020-04-09 00:30:00",2773,577,3350
"2020-04-08 10:11:06","2020-04-09 01:00:00","2020-04-09 01:30:00",2733,516,3249
"2020-04-08 10:11:06","2020-04-09 02:00:00","2020-04-09 02:30:00",2613,500,3113
"2020-04-08 10:11:06","2020-04-09 03:00:00","2020-04-09 03:30:00",2521,498,3019
"2020-04-08 10:11:06","2020-04-09 04:00:00","2020-04-09 04:30:00",2500,489,2989
"2020-04-08 10:11:06","2020-04-09 05:00:00","2020-04-09 05:30:00",2510,490,3000
"2020-04-08 10:11:06","2020-04-09 06:00:00","2020-04-09 06:30:00",2598,516,3114
"2020-04-08 10:11:06","2020-04-09 07:00:00","2020-04-09 07:30:00",2791,533,3324
"2020-04-08 10:11:06","2020-04-09 08:00:00","2020-04-09 08:30:00",3133,611,3744
"2020-04-08 10:11:06","2020-04-09 09:00:00","2020-04-09 09:30:00",3401,698,4099
"2020-04-08 10:11:06","2020-04-09 10:00:00","2020-04-09 10:30:00",3470,707,4177
"2020-04-08 10:11:06","2020-04-09 11:00:00","2020-04-09 11:30:00",3530,709,4239
"2020-04-08 10:11:06","2020-04-09 12:00:00","2020-04-09 12:30:00",3598,704,4302
"2020-04-08 10:11:06","2020-04-09 13:00:00","2020-04-09 13:30:00",3688,714,4402
"2020-04-08 10:11:06","2020-04-09 14:00:00","2020-04-09 14:30:00",3610,678,4288
"2020-04-08 10:11:06","2020-04-09 15:00:00","2020-04-09 15:30:00",3493,665,4158
"2020-04-08 10:11:06","2020-04-09 16:00:00","2020-04-09 16:30:00",3511,685,4196
"2020-04-08 10:11:06","2020-04-09 17:00:00","2020-04-09 17:30:00",3633,856,4489
"2020-04-08 10:11:06","2020-04-09 18:00:00","2020-04-09 18:30:00",3780,904,4684
"2020-04-08 10:11:06","2020-04-09 19:00:00","2020-04-09 19:30:00",3666,865,4531
"2020-04-08 10:11:06","2020-04-09 20:00:00","2020-04-09 20:30:00",3532,839,4371
"2020-04-08 10:11:06","2020-04-09 21:00:00","2020-04-09 21:30:00",3667,860,4527
"2020-04-08 10:11:06","2020-04-09 22:00:00","2020-04-09 22:30:00",3372,765,4137
"2020-04-09 10:11:55","2020-04-09 23:00:00","2020-04-09 23:30:00",3003,785,3788
"2020-04-09 10:11:55","2020-04-10 00:00:00","2020-04-10 00:30:00",2762,584,3346
"2020-04-09 10:11:55","2020-04-10 01:00:00","2020-04-10 01:30:00",2678,538,3216
"2020-04-09 10:11:55","2020-04-10 02:00:00","2020-04-10 02:30:00",2559,503,3062
"2020-04-09 10:11:55","2020-04-10 03:00:00","2020-04-10 03:30:00",2476,505,2981
"2020-04-09 10:11:55","2020-04-10 04:00:00","2020-04-10 04:30:00",2430,500,2930
"2020-04-09 10:11:55","2020-04-10 05:00:00","2020-04-10 05:30:00",2456,500,2956
"2020-04-09 10:11:55","2020-04-10 06:00:00","2020-04-10 06:30:00",2542,527,3069
"2020-04-09 10:11:55","2020-04-10 07:00:00","2020-04-10 07:30:00",2692,562,3254
"2020-04-09 10:11:55","2020-04-10 08:00:00","2020-04-10 08:30:00",2998,646,3644
"2020-04-09 10:11:55","2020-04-10 09:00:00","2020-04-10 09:30:00",3246,697,3943
"2020-04-09 10:11:55","2020-04-10 10:00:00","2020-04-10 10:30:00",3351,701,4052
"2020-04-09 10:11:55","2020-04-10 11:00:00","2020-04-10 11:30:00",3357,713,4070
"2020-04-09 10:11:55","2020-04-10 12:00:00","2020-04-10 12:30:00",3362,728,4090
"2020-04-09 10:11:55","2020-04-10 13:00:00","2020-04-10 13:30:00",3478,732,4210
"2020-04-09 10:11:55","2020-04-10 14:00:00","2020-04-10 14:30:00",3333,701,4034
"2020-04-09 10:11:55","2020-04-10 15:00:00","2020-04-10 15:30:00",3268,644,3912
"2020-04-09 10:11:55","2020-04-10 16:00:00","2020-04-10 16:30:00",3273,688,3961
"2020-04-09 10:11:55","2020-04-10 17:00:00","2020-04-10 17:30:00",3429,780,4209
"2020-04-09 10:11:55","2020-04-10 18:00:00","2020-04-10 18:30:00",3600,845,4445
"2020-04-09 10:11:55","2020-04-10 19:00:00","2020-04-10 19:30:00",3494,800,4294
"2020-04-09 10:11:55","2020-04-10 20:00:00","2020-04-10 20:30:00",3380,775,4155
"2020-04-09 10:11:55","2020-04-10 21:00:00","2020-04-10 21:30:00",3485,767,4252
"2020-04-09 10:11:55","2020-04-10 22:00:00","2020-04-10 22:30:00",3218,712,3930
"2020-04-10 10:11:20","2020-04-10 23:00:00","2020-04-10 23:30:00",2914,747,3661
"2020-04-10 10:11:20","2020-04-11 00:00:00","2020-04-11 00:30:00",2781,661,3442
"2020-04-10 10:11:20","2020-04-11 01:00:00","2020-04-11 01:30:00",2677,602,3279
"2020-04-10 10:11:20","2020-04-11 02:00:00","2020-04-11 02:30:00",2526,576,3102
"2020-04-10 10:11:20","2020-04-11 03:00:00","2020-04-11 03:30:00",2418,563,2981
"2020-04-10 10:11:20","2020-04-11 04:00:00","2020-04-11 04:30:00",2370,555,2925
"2020-04-10 10:11:20","2020-04-11 05:00:00","2020-04-11 05:30:00",2353,550,2903
"2020-04-10 10:11:20","2020-04-11 06:00:00","2020-04-11 06:30:00",2402,576,2978
"2020-04-10 10:11:20","2020-04-11 07:00:00","2020-04-11 07:30:00",2472,589,3061
"2020-04-10 10:11:20","2020-04-11 08:00:00","2020-04-11 08:30:00",2638,643,3281
"2020-04-10 10:11:20","2020-04-11 09:00:00","2020-04-11 09:30:00",2850,705,3555
"2020-04-10 10:11:20","2020-04-11 10:00:00","2020-04-11 10:30:00",3012,727,3739
"2020-04-10 10:11:20","2020-04-11 11:00:00","2020-04-11 11:30:00",3168,758,3926
"2020-04-10 10:11:20","2020-04-11 12:00:00","2020-04-11 12:30:00",3307,791,4098
"2020-04-10 10:11:20","2020-04-11 13:00:00","2020-04-11 13:30:00",3413,816,4229
"2020-04-10 10:11:20","2020-04-11 14:00:00","2020-04-11 14:30:00",3327,789,4116
"2020-04-10 10:11:20","2020-04-11 15:00:00","2020-04-11 15:30:00",3234,779,4013
"2020-04-10 10:11:20","2020-04-11 16:00:00","2020-04-11 16:30:00",3235,788,4023
"2020-04-10 10:11:20","2020-04-11 17:00:00","2020-04-11 17:30:00",3375,876,4251
"2020-04-10 10:11:20","2020-04-11 18:00:00","2020-04-11 18:30:00",3600,950,4550
"2020-04-10 10:11:20","2020-04-11 19:00:00","2020-04-11 19:30:00",3466,904,4370
"2020-04-10 10:11:20","2020-04-11 20:00:00","2020-04-11 20:30:00",3325,857,4182
"2020-04-10 10:11:20","2020-04-11 21:00:00","2020-04-11 21:30:00",3398,847,4245
"2020-04-10 10:11:20","2020-04-11 22:00:00","2020-04-11 22:30:00",3100,761,3861
"2020-04-11 10:11:40","2020-04-11 23:00:00","2020-04-11 23:30:00",2870,681,3551
"2020-04-11 10:11:40","2020-04-12 00:00:00","2020-04-12 00:30:00",2784,590,3374
"2020-04-11 10:11:40","2020-04-12 01:00:00","2020-04-12 01:30:00",2680,533,3213
"2020-04-11 10:11:40","2020-04-12 02:00:00","2020-04-12 02:30:00",2508,499,3007
"2020-04-11 10:11:40","2020-04-12 03:00:00","2020-04-12 03:30:00",2429,497,2926
"2020-04-11 10:11:40","2020-04-12 04:00:00","2020-04-12 04:30:00",2344,493,2837
"2020-04-11 10:11:40","2020-04-12 05:00:00","2020-04-12 05:30:00",2321,508,2829
"2020-04-11 10:11:40","2020-04-12 06:00:00","2020-04-12 06:30:00",2346,501,2847
"2020-04-11 10:11:40","2020-04-12 07:00:00","2020-04-12 07:30:00",2340,513,2853
"2020-04-11 10:11:40","2020-04-12 08:00:00","2020-04-12 08:30:00",2550,607,3157
"2020-04-11 10:11:40","2020-04-12 09:00:00","2020-04-12 09:30:00",2687,669,3356
"2020-04-11 10:11:40","2020-04-12 10:00:00","2020-04-12 10:30:00",2891,732,3623
"2020-04-11 10:11:40","2020-04-12 11:00:00","2020-04-12 11:30:00",3115,790,3905
"2020-04-11 10:11:40","2020-04-12 12:00:00","2020-04-12 12:30:00",3297,859,4156
"2020-04-11 10:11:40","2020-04-12 13:00:00","2020-04-12 13:30:00",3447,905,4352
"2020-04-11 10:11:40","2020-04-12 14:00:00","2020-04-12 14:30:00",3384,835,4219
"2020-04-11 10:11:40","2020-04-12 15:00:00","2020-04-12 15:30:00",3366,819,4185
"2020-04-11 10:11:40","2020-04-12 16:00:00","2020-04-12 16:30:00",3396,847,4243
"2020-04-11 10:11:40","2020-04-12 17:00:00","2020-04-12 17:30:00",3577,959,4536
"2020-04-11 10:11:40","2020-04-12 18:00:00","2020-04-12 18:30:00",3730,970,4700
"2020-04-11 10:11:40","2020-04-12 19:00:00","2020-04-12 19:30:00",3581,930,4511
"2020-04-11 10:11:40","2020-04-12 20:00:00","2020-04-12 20:30:00",3453,873,4326
"2020-04-11 10:11:40","2020-04-12 21:00:00","2020-04-12 21:30:00",3408,843,4251
"2020-04-11 10:11:40","2020-04-12 22:00:00","2020-04-12 22:30:00",3136,760,3896
"2020-04-12 10:11:36","2020-04-12 23:00:00","2020-04-12 23:30:00",2700,659,3359
"2020-04-12 10:11:36","2020-04-13 00:00:00","2020-04-13 00:30:00",2700,614,3314
"2020-04-12 10:11:36","2020-04-13 01:00:00","2020-04-13 01:30:00",2590,575,3165
"2020-04-12 10:11:36","2020-04-13 02:00:00","2020-04-13 02:30:00",2455,554,3009
"2020-04-12 10:11:36","2020-04-13 03:00:00","2020-04-13 03:30:00",2355,564,2919
"2020-04-12 10:11:36","2020-04-13 04:00:00","2020-04-13 04:30:00",2325,563,2888
"2020-04-12 10:11:36","2020-04-13 05:00:00","2020-04-13 05:30:00",2321,574,2895
"2020-04-12 10:11:36","2020-04-13 06:00:00","2020-04-13 06:30:00",2346,620,2966
"2020-04-12 10:11:36","2020-04-13 07:00:00","2020-04-13 07:30:00",2340,698,3038
"2020-04-12 10:11:36","2020-04-13 08:00:00","2020-04-13 08:30:00",2550,817,3367
"2020-04-12 10:11:36","2020-04-13 09:00:00","2020-04-13 09:30:00",2687,889,3576
"2020-04-12 10:11:36","2020-04-13 10:00:00","2020-04-13 10:30:00",2891,942,3833
"2020-04-12 10:11:36","2020-04-13 11:00:00","2020-04-13 11:30:00",3115,967,4082
"2020-04-12 10:11:36","2020-04-13 12:00:00","2020-04-13 12:30:00",3230,964,4194
"2020-04-12 10:11:36","2020-04-13 13:00:00","2020-04-13 13:30:00",3250,1000,4250
"2020-04-12 10:11:36","2020-04-13 14:00:00","2020-04-13 14:30:00",3120,939,4059
"2020-04-12 10:11:36","2020-04-13 15:00:00","2020-04-13 15:30:00",3010,955,3965
"2020-04-12 10:11:36","2020-04-13 16:00:00","2020-04-13 16:30:00",2950,928,3878
"2020-04-12 10:11:36","2020-04-13 17:00:00","2020-04-13 17:30:00",3100,1164,4264
"2020-04-12 10:11:36","2020-04-13 18:00:00","2020-04-13 18:30:00",3250,1205,4455
"2020-04-12 10:11:36","2020-04-13 19:00:00","2020-04-13 19:30:00",3100,1112,4212
"2020-04-12 10:11:36","2020-04-13 20:00:00","2020-04-13 20:30:00",2970,1052,4022
"2020-04-12 10:11:36","2020-04-13 21:00:00","2020-04-13 21:30:00",3030,1116,4146
"2020-04-12 10:11:36","2020-04-13 22:00:00","2020-04-13 22:30:00",2960,1026,3986
"2020-04-12 10:11:36","2020-04-13 23:00:00","2020-04-13 23:30:00",2750,882,3632
"2020-04-12 10:11:36","2020-04-14 00:00:00","2020-04-14 00:30:00",2672,872,3544
"2020-04-12 10:11:36","2020-04-14 01:00:00","2020-04-14 01:30:00",2633,939,3572
"2020-04-12 10:11:36","2020-04-14 02:00:00","2020-04-14 02:30:00",2512,963,3475
"2020-04-12 10:11:36","2020-04-14 03:00:00","2020-04-14 03:30:00",2419,974,3393
"2020-04-12 10:11:36","2020-04-14 04:00:00","2020-04-14 04:30:00",2400,980,3380
"2020-04-12 10:11:36","2020-04-14 05:00:00","2020-04-14 05:30:00",2406,961,3367
"2020-04-12 10:11:36","2020-04-14 06:00:00","2020-04-14 06:30:00",2495,948,3443
"2020-04-12 10:11:36","2020-04-14 07:00:00","2020-04-14 07:30:00",2689,914,3603
"2020-04-12 10:11:36","2020-04-14 08:00:00","2020-04-14 08:30:00",3038,864,3902
"2020-04-12 10:11:36","2020-04-14 09:00:00","2020-04-14 09:30:00",3309,803,4112
"2020-04-12 10:11:36","2020-04-14 10:00:00","2020-04-14 10:30:00",3375,717,4092
"2020-04-12 10:11:36","2020-04-14 11:00:00","2020-04-14 11:30:00",3431,626,4057
"2020-04-12 10:11:36","2020-04-14 12:00:00","2020-04-14 12:30:00",3496,531,4027
"2020-04-12 10:11:36","2020-04-14 13:00:00","2020-04-14 13:30:00",3583,572,4155
"2020-04-12 10:11:36","2020-04-14 14:00:00","2020-04-14 14:30:00",3498,629,4127
"2020-04-12 10:11:36","2020-04-14 15:00:00","2020-04-14 15:30:00",3373,630,4003
"2020-04-12 10:11:36","2020-04-14 16:00:00","2020-04-14 16:30:00",3387,549,3936
"2020-04-12 10:11:36","2020-04-14 17:00:00","2020-04-14 17:30:00",3506,499,4005
"2020-04-12 10:11:36","2020-04-14 18:00:00","2020-04-14 18:30:00",3650,533,4183
"2020-04-12 10:11:36","2020-04-14 19:00:00","2020-04-14 19:30:00",3545,521,4066
"2020-04-12 10:11:36","2020-04-14 20:00:00","2020-04-14 20:30:00",3419,507,3926
"2020-04-12 10:11:36","2020-04-14 21:00:00","2020-04-14 21:30:00",3567,617,4184
"2020-04-12 10:11:36","2020-04-14 22:00:00","2020-04-14 22:30:00",3275,728,4003
"2020-04-14 10:11:20","2020-04-14 23:00:00","2020-04-14 23:30:00",2878,745,3623
"2020-04-14 10:11:20","2020-04-15 00:00:00","2020-04-15 00:30:00",2745,626,3371
"2020-04-14 10:11:20","2020-04-15 01:00:00","2020-04-15 01:30:00",2668,570,3238
"2020-04-14 10:11:20","2020-04-15 02:00:00","2020-04-15 02:30:00",2531,540,3071
"2020-04-14 10:11:20","2020-04-15 03:00:00","2020-04-15 03:30:00",2463,538,3001
"2020-04-14 10:11:20","2020-04-15 04:00:00","2020-04-15 04:30:00",2417,528,2945
"2020-04-14 10:11:20","2020-04-15 05:00:00","2020-04-15 05:30:00",2441,522,2963
"2020-04-14 10:11:20","2020-04-15 06:00:00","2020-04-15 06:30:00",2544,560,3104
"2020-04-14 10:11:20","2020-04-15 07:00:00","2020-04-15 07:30:00",2727,565,3292
"2020-04-14 10:11:20","2020-04-15 08:00:00","2020-04-15 08:30:00",3059,640,3699
"2020-04-14 10:11:20","2020-04-15 09:00:00","2020-04-15 09:30:00",3302,720,4022
"2020-04-14 10:11:20","2020-04-15 10:00:00","2020-04-15 10:30:00",3392,760,4152
"2020-04-14 10:11:20","2020-04-15 11:00:00","2020-04-15 11:30:00",3420,800,4220
"2020-04-14 10:11:20","2020-04-15 12:00:00","2020-04-15 12:30:00",3441,830,4271
"2020-04-14 10:11:20","2020-04-15 13:00:00","2020-04-15 13:30:00",3537,833,4370
"2020-04-14 10:11:20","2020-04-15 14:00:00","2020-04-15 14:30:00",3419,780,4199
"2020-04-14 10:11:20","2020-04-15 15:00:00","2020-04-15 15:30:00",3327,761,4088
"2020-04-14 10:11:20","2020-04-15 16:00:00","2020-04-15 16:30:00",3319,780,4099
"2020-04-14 10:11:20","2020-04-15 17:00:00","2020-04-15 17:30:00",3503,950,4453
"2020-04-14 10:11:20","2020-04-15 18:00:00","2020-04-15 18:30:00",3721,995,4716
"2020-04-14 10:11:20","2020-04-15 19:00:00","2020-04-15 19:30:00",3623,933,4556
"2020-04-14 10:11:20","2020-04-15 20:00:00","2020-04-15 20:30:00",3505,897,4402
"2020-04-14 10:11:20","2020-04-15 21:00:00","2020-04-15 21:30:00",3609,956,4565
"2020-04-14 10:11:20","2020-04-15 22:00:00","2020-04-15 22:30:00",3319,891,4210
"2020-04-15 10:11:16","2020-04-15 23:00:00","2020-04-15 23:30:00",2994,745,3739
"2020-04-15 10:11:16","2020-04-16 00:00:00","2020-04-16 00:30:00",2663,649,3312
"2020-04-15 10:11:16","2020-04-16 01:00:00","2020-04-16 01:30:00",2607,598,3205
"2020-04-15 10:11:16","2020-04-16 02:00:00","2020-04-16 02:30:00",2493,571,3064
"2020-04-15 10:11:16","2020-04-16 03:00:00","2020-04-16 03:30:00",2440,570,3010
"2020-04-15 10:11:16","2020-04-16 04:00:00","2020-04-16 04:30:00",2415,555,2970
"2020-04-15 10:11:16","2020-04-16 05:00:00","2020-04-16 05:30:00",2437,557,2994
"2020-04-15 10:11:16","2020-04-16 06:00:00","2020-04-16 06:30:00",2563,602,3165
"2020-04-15 10:11:16","2020-04-16 07:00:00","2020-04-16 07:30:00",2733,634,3367
"2020-04-15 10:11:16","2020-04-16 08:00:00","2020-04-16 08:30:00",3071,720,3791
"2020-04-15 10:11:16","2020-04-16 09:00:00","2020-04-16 09:30:00",3314,791,4105
"2020-04-15 10:11:16","2020-04-16 10:00:00","2020-04-16 10:30:00",3405,839,4244
"2020-04-15 10:11:16","2020-04-16 11:00:00","2020-04-16 11:30:00",3471,853,4324
"2020-04-15 10:11:16","2020-04-16 12:00:00","2020-04-16 12:30:00",3475,863,4338
"2020-04-15 10:11:16","2020-04-16 13:00:00","2020-04-16 13:30:00",3567,868,4435
"2020-04-15 10:11:16","2020-04-16 14:00:00","2020-04-16 14:30:00",3437,836,4273
"2020-04-15 10:11:16","2020-04-16 15:00:00","2020-04-16 15:30:00",3344,818,4162
"2020-04-15 10:11:16","2020-04-16 16:00:00","2020-04-16 16:30:00",3318,824,4142
"2020-04-15 10:11:16","2020-04-16 17:00:00","2020-04-16 17:30:00",3488,969,4457
"2020-04-15 10:11:16","2020-04-16 18:00:00","2020-04-16 18:30:00",3680,1036,4716
"2020-04-15 10:11:16","2020-04-16 19:00:00","2020-04-16 19:30:00",3586,967,4553
"2020-04-15 10:11:16","2020-04-16 20:00:00","2020-04-16 20:30:00",3441,916,4357
"2020-04-15 10:11:16","2020-04-16 21:00:00","2020-04-16 21:30:00",3561,931,4492
"2020-04-15 10:11:16","2020-04-16 22:00:00","2020-04-16 22:30:00",3344,840,4184
"2020-04-16 10:11:31","2020-04-16 23:00:00","2020-04-16 23:30:00",3037,700,3737
"2020-04-16 10:11:31","2020-04-17 00:00:00","2020-04-17 00:30:00",2667,630,3297
"2020-04-16 10:11:31","2020-04-17 01:00:00","2020-04-17 01:30:00",2610,579,3189
"2020-04-16 10:11:31","2020-04-17 02:00:00","2020-04-17 02:30:00",2494,552,3046
"2020-04-16 10:11:31","2020-04-17 03:00:00","2020-04-17 03:30:00",2440,540,2980
"2020-04-16 10:11:31","2020-04-17 04:00:00","2020-04-17 04:30:00",2415,525,2940
"2020-04-16 10:11:31","2020-04-17 05:00:00","2020-04-17 05:30:00",2438,529,2967
"2020-04-16 10:11:31","2020-04-17 06:00:00","2020-04-17 06:30:00",2566,554,3120
"2020-04-16 10:11:31","2020-04-17 07:00:00","2020-04-17 07:30:00",2738,608,3346
"2020-04-16 10:11:31","2020-04-17 08:00:00","2020-04-17 08:30:00",3081,709,3790
"2020-04-16 10:11:31","2020-04-17 09:00:00","2020-04-17 09:30:00",3328,781,4109
"2020-04-16 10:11:31","2020-04-17 10:00:00","2020-04-17 10:30:00",3420,839,4259
"2020-04-16 10:11:31","2020-04-17 11:00:00","2020-04-17 11:30:00",3488,853,4341
"2020-04-16 10:11:31","2020-04-17 12:00:00","2020-04-17 12:30:00",3491,863,4354
"2020-04-16 10:11:31","2020-04-17 13:00:00","2020-04-17 13:30:00",3586,868,4454
"2020-04-16 10:11:31","2020-04-17 14:00:00","2020-04-17 14:30:00",3453,836,4289
"2020-04-16 10:11:31","2020-04-17 15:00:00","2020-04-17 15:30:00",3358,818,4176
"2020-04-16 10:11:31","2020-04-17 16:00:00","2020-04-17 16:30:00",3332,824,4156
"2020-04-16 10:11:31","2020-04-17 17:00:00","2020-04-17 17:30:00",3505,969,4474
"2020-04-16 10:11:31","2020-04-17 18:00:00","2020-04-17 18:30:00",3700,1002,4702
"2020-04-16 10:11:31","2020-04-17 19:00:00","2020-04-17 19:30:00",3604,966,4570
"2020-04-16 10:11:31","2020-04-17 20:00:00","2020-04-17 20:30:00",3457,916,4373
"2020-04-16 10:11:31","2020-04-17 21:00:00","2020-04-17 21:30:00",3579,931,4510
"2020-04-16 10:11:31","2020-04-17 22:00:00","2020-04-17 22:30:00",3358,840,4198
"2020-04-17 10:11:20","2020-04-17 23:00:00","2020-04-17 23:30:00",3047,693,3740
"2020-04-17 10:11:20","2020-04-18 00:00:00","2020-04-18 00:30:00",2834,677,3511
"2020-04-17 10:11:20","2020-04-18 01:00:00","2020-04-18 01:30:00",2732,616,3348
"2020-04-17 10:11:20","2020-04-18 02:00:00","2020-04-18 02:30:00",2584,594,3178
"2020-04-17 10:11:20","2020-04-18 03:00:00","2020-04-18 03:30:00",2479,566,3045
"2020-04-17 10:11:20","2020-04-18 04:00:00","2020-04-18 04:30:00",2432,566,2998
"2020-04-17 10:11:20","2020-04-18 05:00:00","2020-04-18 05:30:00",2416,551,2967
"2020-04-17 10:11:20","2020-04-18 06:00:00","2020-04-18 06:30:00",2464,564,3028
"2020-04-17 10:11:20","2020-04-18 07:00:00","2020-04-18 07:30:00",2531,564,3095
"2020-04-17 10:11:20","2020-04-18 08:00:00","2020-04-18 08:30:00",2694,655,3349
"2020-04-17 10:11:20","2020-04-18 09:00:00","2020-04-18 09:30:00",2901,718,3619
"2020-04-17 10:11:20","2020-04-18 10:00:00","2020-04-18 10:30:00",3060,752,3812
"2020-04-17 10:11:20","2020-04-18 11:00:00","2020-04-18 11:30:00",3211,771,3982
"2020-04-17 10:11:20","2020-04-18 12:00:00","2020-04-18 12:30:00",3348,801,4149
"2020-04-17 10:11:20","2020-04-18 13:00:00","2020-04-18 13:30:00",3451,815,4266
"2020-04-17 10:11:20","2020-04-18 14:00:00","2020-04-18 14:30:00",3367,755,4122
"2020-04-17 10:11:20","2020-04-18 15:00:00","2020-04-18 15:30:00",3276,706,3982
"2020-04-17 10:11:20","2020-04-18 16:00:00","2020-04-18 16:30:00",3277,696,3973
"2020-04-17 10:11:20","2020-04-18 17:00:00","2020-04-18 17:30:00",3415,837,4252
"2020-04-17 10:11:20","2020-04-18 18:00:00","2020-04-18 18:30:00",3634,907,4541
"2020-04-17 10:11:20","2020-04-18 19:00:00","2020-04-18 19:30:00",3503,892,4395
"2020-04-17 10:11:20","2020-04-18 20:00:00","2020-04-18 20:30:00",3365,885,4250
"2020-04-17 10:11:20","2020-04-18 21:00:00","2020-04-18 21:30:00",3437,874,4311
"2020-04-17 10:11:20","2020-04-18 22:00:00","2020-04-18 22:30:00",3145,778,3923
"2020-04-18 10:11:11","2020-04-18 23:00:00","2020-04-18 23:30:00",2891,726,3617
"2020-04-18 10:11:11","2020-04-19 00:00:00","2020-04-19 00:30:00",2628,593,3221
"2020-04-18 10:11:11","2020-04-19 01:00:00","2020-04-19 01:30:00",2535,533,3068
"2020-04-18 10:11:11","2020-04-19 02:00:00","2020-04-19 02:30:00",2376,493,2869
"2020-04-18 10:11:11","2020-04-19 03:00:00","2020-04-19 03:30:00",2251,503,2754
"2020-04-18 10:11:11","2020-04-19 04:00:00","2020-04-19 04:30:00",2206,474,2680
"2020-04-18 10:11:11","2020-04-19 05:00:00","2020-04-19 05:30:00",2255,451,2706
"2020-04-18 10:11:11","2020-04-19 06:00:00","2020-04-19 06:30:00",2315,490,2805
"2020-04-18 10:11:11","2020-04-19 07:00:00","2020-04-19 07:30:00",2312,520,2832
"2020-04-18 10:11:11","2020-04-19 08:00:00","2020-04-19 08:30:00",2495,555,3050
"2020-04-18 10:11:11","2020-04-19 09:00:00","2020-04-19 09:30:00",2656,620,3276
"2020-04-18 10:11:11","2020-04-19 10:00:00","2020-04-19 10:30:00",2883,670,3553
"2020-04-18 10:11:11","2020-04-19 11:00:00","2020-04-19 11:30:00",3055,760,3815
"2020-04-18 10:11:11","2020-04-19 12:00:00","2020-04-19 12:30:00",3221,800,4021
"2020-04-18 10:11:11","2020-04-19 13:00:00","2020-04-19 13:30:00",3280,850,4130
"2020-04-18 10:11:11","2020-04-19 14:00:00","2020-04-19 14:30:00",3147,845,3992
"2020-04-18 10:11:11","2020-04-19 15:00:00","2020-04-19 15:30:00",3058,765,3823
"2020-04-18 10:11:11","2020-04-19 16:00:00","2020-04-19 16:30:00",3059,800,3859
"2020-04-18 10:11:11","2020-04-19 17:00:00","2020-04-19 17:30:00",3248,850,4098
"2020-04-18 10:11:11","2020-04-19 18:00:00","2020-04-19 18:30:00",3490,820,4310
"2020-04-18 10:11:11","2020-04-19 19:00:00","2020-04-19 19:30:00",3452,730,4182
"2020-04-18 10:11:11","2020-04-19 20:00:00","2020-04-19 20:30:00",3301,705,4006
"2020-04-18 10:11:11","2020-04-19 21:00:00","2020-04-19 21:30:00",3431,750,4181
"2020-04-18 10:11:11","2020-04-19 22:00:00","2020-04-19 22:30:00",3142,670,3812
"2020-04-19 10:11:31","2020-04-19 23:00:00","2020-04-19 23:30:00",2817,606,3423
"2020-04-19 10:11:31","2020-04-20 00:00:00","2020-04-20 00:30:00",2564,540,3104
"2020-04-19 10:11:31","2020-04-20 01:00:00","2020-04-20 01:30:00",2505,510,3015
"2020-04-19 10:11:31","2020-04-20 02:00:00","2020-04-20 02:30:00",2383,480,2863
"2020-04-19 10:11:31","2020-04-20 03:00:00","2020-04-20 03:30:00",2327,490,2817
"2020-04-19 10:11:31","2020-04-20 04:00:00","2020-04-20 04:30:00",2300,486,2786
"2020-04-19 10:11:31","2020-04-20 05:00:00","2020-04-20 05:30:00",2324,500,2824
"2020-04-19 10:11:31","2020-04-20 06:00:00","2020-04-20 06:30:00",2458,550,3008
"2020-04-19 10:11:31","2020-04-20 07:00:00","2020-04-20 07:30:00",2640,616,3256
"2020-04-19 10:11:31","2020-04-20 08:00:00","2020-04-20 08:30:00",3000,715,3715
"2020-04-19 10:11:31","2020-04-20 09:00:00","2020-04-20 09:30:00",3259,790,4049
"2020-04-19 10:11:31","2020-04-20 10:00:00","2020-04-20 10:30:00",3356,815,4171
"2020-04-19 10:11:31","2020-04-20 11:00:00","2020-04-20 11:30:00",3427,822,4249
"2020-04-19 10:11:31","2020-04-20 12:00:00","2020-04-20 12:30:00",3431,830,4261
"2020-04-19 10:11:31","2020-04-20 13:00:00","2020-04-20 13:30:00",3530,829,4359
"2020-04-19 10:11:31","2020-04-20 14:00:00","2020-04-20 14:30:00",3391,765,4156
"2020-04-19 10:11:31","2020-04-20 15:00:00","2020-04-20 15:30:00",3291,735,4026
"2020-04-19 10:11:31","2020-04-20 16:00:00","2020-04-20 16:30:00",3264,770,4034
"2020-04-19 10:11:31","2020-04-20 17:00:00","2020-04-20 17:30:00",3445,910,4355
"2020-04-19 10:11:31","2020-04-20 18:00:00","2020-04-20 18:30:00",3650,955,4605
"2020-04-19 10:11:31","2020-04-20 19:00:00","2020-04-20 19:30:00",3549,890,4439
"2020-04-19 10:11:31","2020-04-20 20:00:00","2020-04-20 20:30:00",3395,870,4265
"2020-04-19 10:11:31","2020-04-20 21:00:00","2020-04-20 21:30:00",3523,900,4423
"2020-04-19 10:11:31","2020-04-20 22:00:00","2020-04-20 22:30:00",3291,825,4116
"2020-04-20 10:11:20","2020-04-20 23:00:00","2020-04-20 23:30:00",2964,683,3647
"2020-04-20 10:11:20","2020-04-21 00:00:00","2020-04-21 00:30:00",2681,602,3283
"2020-04-20 10:11:20","2020-04-21 01:00:00","2020-04-21 01:30:00",2579,550,3129
"2020-04-20 10:11:20","2020-04-21 02:00:00","2020-04-21 02:30:00",2475,523,2998
"2020-04-20 10:11:20","2020-04-21 03:00:00","2020-04-21 03:30:00",2385,510,2895
"2020-04-20 10:11:20","2020-04-21 04:00:00","2020-04-21 04:30:00",2350,496,2846
"2020-04-20 10:11:20","2020-04-21 05:00:00","2020-04-21 05:30:00",2405,500,2905
"2020-04-20 10:11:20","2020-04-21 06:00:00","2020-04-21 06:30:00",2540,524,3064
"2020-04-20 10:11:20","2020-04-21 07:00:00","2020-04-21 07:30:00",2717,579,3296
"2020-04-20 10:11:20","2020-04-21 08:00:00","2020-04-21 08:30:00",3049,679,3728
"2020-04-20 10:11:20","2020-04-21 09:00:00","2020-04-21 09:30:00",3287,751,4038
"2020-04-20 10:11:20","2020-04-21 10:00:00","2020-04-21 10:30:00",3359,786,4145
"2020-04-20 10:11:20","2020-04-21 11:00:00","2020-04-21 11:30:00",3407,795,4202
"2020-04-20 10:11:20","2020-04-21 12:00:00","2020-04-21 12:30:00",3435,795,4230
"2020-04-20 10:11:20","2020-04-21 13:00:00","2020-04-21 13:30:00",3501,803,4304
"2020-04-20 10:11:20","2020-04-21 14:00:00","2020-04-21 14:30:00",3334,740,4074
"2020-04-20 10:11:20","2020-04-21 15:00:00","2020-04-21 15:30:00",3242,715,3957
"2020-04-20 10:11:20","2020-04-21 16:00:00","2020-04-21 16:30:00",3239,719,3958
"2020-04-20 10:11:20","2020-04-21 17:00:00","2020-04-21 17:30:00",3440,870,4310
"2020-04-20 10:11:20","2020-04-21 18:00:00","2020-04-21 18:30:00",3650,925,4575
"2020-04-20 10:11:20","2020-04-21 19:00:00","2020-04-21 19:30:00",3536,864,4400
"2020-04-20 10:11:20","2020-04-21 20:00:00","2020-04-21 20:30:00",3394,815,4209
"2020-04-20 10:11:20","2020-04-21 21:00:00","2020-04-21 21:30:00",3453,863,4316
"2020-04-20 10:11:20","2020-04-21 22:00:00","2020-04-21 22:30:00",3204,792,3996
"2020-04-21 10:11:11","2020-04-21 23:00:00","2020-04-21 23:30:00",2875,691,3566
"2020-04-21 10:11:11","2020-04-22 00:00:00","2020-04-22 00:30:00",2681,604,3285
"2020-04-21 10:11:11","2020-04-22 01:00:00","2020-04-22 01:30:00",2565,545,3110
"2020-04-21 10:11:11","2020-04-22 02:00:00","2020-04-22 02:30:00",2449,513,2962
"2020-04-21 10:11:11","2020-04-22 03:00:00","2020-04-22 03:30:00",2347,508,2855
"2020-04-21 10:11:11","2020-04-22 04:00:00","2020-04-22 04:30:00",2300,506,2806
"2020-04-21 10:11:11","2020-04-22 05:00:00","2020-04-22 05:30:00",2353,513,2866
"2020-04-21 10:11:11","2020-04-22 06:00:00","2020-04-22 06:30:00",2483,540,3023
"2020-04-21 10:11:11","2020-04-22 07:00:00","2020-04-22 07:30:00",2655,628,3283
"2020-04-21 10:11:11","2020-04-22 08:00:00","2020-04-22 08:30:00",2979,710,3689
"2020-04-21 10:11:11","2020-04-22 09:00:00","2020-04-22 09:30:00",3210,788,3998
"2020-04-21 10:11:11","2020-04-22 10:00:00","2020-04-22 10:30:00",3279,794,4073
"2020-04-21 10:11:11","2020-04-22 11:00:00","2020-04-22 11:30:00",3324,788,4112
"2020-04-21 10:11:11","2020-04-22 12:00:00","2020-04-22 12:30:00",3349,784,4133
"2020-04-21 10:11:11","2020-04-22 13:00:00","2020-04-22 13:30:00",3413,800,4213
"2020-04-21 10:11:11","2020-04-22 14:00:00","2020-04-22 14:30:00",3248,742,3990
"2020-04-21 10:11:11","2020-04-22 15:00:00","2020-04-22 15:30:00",3158,721,3879
"2020-04-21 10:11:11","2020-04-22 16:00:00","2020-04-22 16:30:00",3154,750,3904
"2020-04-21 10:11:11","2020-04-22 17:00:00","2020-04-22 17:30:00",3347,910,4257
"2020-04-21 10:11:11","2020-04-22 18:00:00","2020-04-22 18:30:00",3550,968,4518
"2020-04-21 10:11:11","2020-04-22 19:00:00","2020-04-22 19:30:00",3456,883,4339
"2020-04-21 10:11:11","2020-04-22 20:00:00","2020-04-22 20:30:00",3335,854,4189
"2020-04-21 10:11:11","2020-04-22 21:00:00","2020-04-22 21:30:00",3410,885,4295
"2020-04-21 10:11:11","2020-04-22 22:00:00","2020-04-22 22:30:00",3180,845,4025
"2020-04-22 10:11:30","2020-04-22 23:00:00","2020-04-22 23:30:00",2853,713,3566
"2020-04-22 10:11:30","2020-04-23 00:00:00","2020-04-23 00:30:00",2644,632,3276
"2020-04-22 10:11:30","2020-04-23 01:00:00","2020-04-23 01:30:00",2538,580,3118
"2020-04-22 10:11:30","2020-04-23 02:00:00","2020-04-23 02:30:00",2430,553,2983
"2020-04-22 10:11:30","2020-04-23 03:00:00","2020-04-23 03:30:00",2336,540,2876
"2020-04-22 10:11:30","2020-04-23 04:00:00","2020-04-23 04:30:00",2300,526,2826
"2020-04-22 10:11:30","2020-04-23 05:00:00","2020-04-23 05:30:00",2358,530,2888
"2020-04-22 10:11:30","2020-04-23 06:00:00","2020-04-23 06:30:00",2497,554,3051
"2020-04-22 10:11:30","2020-04-23 07:00:00","2020-04-23 07:30:00",2681,609,3290
"2020-04-22 10:11:30","2020-04-23 08:00:00","2020-04-23 08:30:00",3026,709,3735
"2020-04-22 10:11:30","2020-04-23 09:00:00","2020-04-23 09:30:00",3273,781,4054
"2020-04-22 10:11:30","2020-04-23 10:00:00","2020-04-23 10:30:00",3348,816,4164
"2020-04-22 10:11:30","2020-04-23 11:00:00","2020-04-23 11:30:00",3397,825,4222
"2020-04-22 10:11:30","2020-04-23 12:00:00","2020-04-23 12:30:00",3426,825,4251
"2020-04-22 10:11:30","2020-04-23 13:00:00","2020-04-23 13:30:00",3495,833,4328
"2020-04-22 10:11:30","2020-04-23 14:00:00","2020-04-23 14:30:00",3322,770,4092
"2020-04-22 10:11:30","2020-04-23 15:00:00","2020-04-23 15:30:00",3227,745,3972
"2020-04-22 10:11:30","2020-04-23 16:00:00","2020-04-23 16:30:00",3224,749,3973
"2020-04-22 10:11:30","2020-04-23 17:00:00","2020-04-23 17:30:00",3432,900,4332
"2020-04-22 10:11:30","2020-04-23 18:00:00","2020-04-23 18:30:00",3650,955,4605
"2020-04-22 10:11:30","2020-04-23 19:00:00","2020-04-23 19:30:00",3531,894,4425
"2020-04-22 10:11:30","2020-04-23 20:00:00","2020-04-23 20:30:00",3384,845,4229
"2020-04-22 10:11:30","2020-04-23 21:00:00","2020-04-23 21:30:00",3445,893,4338
"2020-04-22 10:11:30","2020-04-23 22:00:00","2020-04-23 22:30:00",3187,822,4009
"2020-04-23 10:11:21","2020-04-23 23:00:00","2020-04-23 23:30:00",2853,713,3566
"2020-04-23 10:11:21","2020-04-24 00:00:00","2020-04-24 00:30:00",2581,604,3185
"2020-04-23 10:11:21","2020-04-24 01:00:00","2020-04-24 01:30:00",2481,545,3026
"2020-04-23 10:11:21","2020-04-24 02:00:00","2020-04-24 02:30:00",2365,513,2878
"2020-04-23 10:11:21","2020-04-24 03:00:00","2020-04-24 03:30:00",2288,508,2796
"2020-04-23 10:11:21","2020-04-24 04:00:00","2020-04-24 04:30:00",2270,525,2795
"2020-04-23 10:11:21","2020-04-24 05:00:00","2020-04-24 05:30:00",2309,536,2845
"2020-04-23 10:11:21","2020-04-24 06:00:00","2020-04-24 06:30:00",2354,560,2914
"2020-04-23 10:11:21","2020-04-24 07:00:00","2020-04-24 07:30:00",2503,625,3128
"2020-04-23 10:11:21","2020-04-24 08:00:00","2020-04-24 08:30:00",2808,740,3548
"2020-04-23 10:11:21","2020-04-24 09:00:00","2020-04-24 09:30:00",3041,810,3851
"2020-04-23 10:11:21","2020-04-24 10:00:00","2020-04-24 10:30:00",3134,841,3975
"2020-04-23 10:11:21","2020-04-24 11:00:00","2020-04-24 11:30:00",3173,820,3993
"2020-04-23 10:11:21","2020-04-24 12:00:00","2020-04-24 12:30:00",3233,810,4043
"2020-04-23 10:11:21","2020-04-24 13:00:00","2020-04-24 13:30:00",3328,810,4138
"2020-04-23 10:11:21","2020-04-24 14:00:00","2020-04-24 14:30:00",3212,765,3977
"2020-04-23 10:11:21","2020-04-24 15:00:00","2020-04-24 15:30:00",3172,735,3907
"2020-04-23 10:11:21","2020-04-24 16:00:00","2020-04-24 16:30:00",3160,750,3910
"2020-04-23 10:11:21","2020-04-24 17:00:00","2020-04-24 17:30:00",3319,910,4229
"2020-04-23 10:11:21","2020-04-24 18:00:00","2020-04-24 18:30:00",3520,968,4488
"2020-04-23 10:11:21","2020-04-24 19:00:00","2020-04-24 19:30:00",3375,883,4258
"2020-04-23 10:11:21","2020-04-24 20:00:00","2020-04-24 20:30:00",3190,854,4044
"2020-04-23 10:11:21","2020-04-24 21:00:00","2020-04-24 21:30:00",3211,885,4096
"2020-04-23 10:11:21","2020-04-24 22:00:00","2020-04-24 22:30:00",2999,845,3844
"2020-04-24 10:11:05","2020-04-24 23:00:00","2020-04-24 23:30:00",2923,754,3677
"2020-04-24 10:11:05","2020-04-25 00:00:00","2020-04-25 00:30:00",2636,636,3272
"2020-04-24 10:11:05","2020-04-25 01:00:00","2020-04-25 01:30:00",2513,578,3091
"2020-04-24 10:11:05","2020-04-25 02:00:00","2020-04-25 02:30:00",2408,556,2964
"2020-04-24 10:11:05","2020-04-25 03:00:00","2020-04-25 03:30:00",2314,547,2861
"2020-04-24 10:11:05","2020-04-25 04:00:00","2020-04-25 04:30:00",2243,537,2780
"2020-04-24 10:11:05","2020-04-25 05:00:00","2020-04-25 05:30:00",2233,537,2770
"2020-04-24 10:11:05","2020-04-25 06:00:00","2020-04-25 06:30:00",2312,541,2853
"2020-04-24 10:11:05","2020-04-25 07:00:00","2020-04-25 07:30:00",2337,572,2909
"2020-04-24 10:11:05","2020-04-25 08:00:00","2020-04-25 08:30:00",2535,633,3168
"2020-04-24 10:11:05","2020-04-25 09:00:00","2020-04-25 09:30:00",2758,697,3455
"2020-04-24 10:11:05","2020-04-25 10:00:00","2020-04-25 10:30:00",2939,749,3688
"2020-04-24 10:11:05","2020-04-25 11:00:00","2020-04-25 11:30:00",3049,790,3839
"2020-04-24 10:11:05","2020-04-25 12:00:00","2020-04-25 12:30:00",3149,816,3965
"2020-04-24 10:11:05","2020-04-25 13:00:00","2020-04-25 13:30:00",3274,819,4093
"2020-04-24 10:11:05","2020-04-25 14:00:00","2020-04-25 14:30:00",3211,770,3981
"2020-04-24 10:11:05","2020-04-25 15:00:00","2020-04-25 15:30:00",3141,755,3896
"2020-04-24 10:11:05","2020-04-25 16:00:00","2020-04-25 16:30:00",3160,763,3923
"2020-04-24 10:11:05","2020-04-25 17:00:00","2020-04-25 17:30:00",3332,867,4199
"2020-04-24 10:11:05","2020-04-25 18:00:00","2020-04-25 18:30:00",3540,930,4470
"2020-04-24 10:11:05","2020-04-25 19:00:00","2020-04-25 19:30:00",3443,903,4346
"2020-04-24 10:11:05","2020-04-25 20:00:00","2020-04-25 20:30:00",3252,865,4117
"2020-04-24 10:11:05","2020-04-25 21:00:00","2020-04-25 21:30:00",3247,878,4125
"2020-04-24 10:11:05","2020-04-25 22:00:00","2020-04-25 22:30:00",3041,831,3872
"2020-04-25 10:10:51","2020-04-25 23:00:00","2020-04-25 23:30:00",2791,747,3538
"2020-04-25 10:10:51","2020-04-26 00:00:00","2020-04-26 00:30:00",2645,631,3276
"2020-04-25 10:10:51","2020-04-26 01:00:00","2020-04-26 01:30:00",2514,573,3087
"2020-04-25 10:10:51","2020-04-26 02:00:00","2020-04-26 02:30:00",2375,533,2908
"2020-04-25 10:10:51","2020-04-26 03:00:00","2020-04-26 03:30:00",2231,517,2748
"2020-04-25 10:10:51","2020-04-26 04:00:00","2020-04-26 04:30:00",2187,509,2696
"2020-04-25 10:10:51","2020-04-26 05:00:00","2020-04-26 05:30:00",2192,499,2691
"2020-04-25 10:10:51","2020-04-26 06:00:00","2020-04-26 06:30:00",2234,494,2728
"2020-04-25 10:10:51","2020-04-26 07:00:00","2020-04-26 07:30:00",2236,509,2745
"2020-04-25 10:10:51","2020-04-26 08:00:00","2020-04-26 08:30:00",2396,548,2944
"2020-04-25 10:10:51","2020-04-26 09:00:00","2020-04-26 09:30:00",2629,616,3245
"2020-04-25 10:10:51","2020-04-26 10:00:00","2020-04-26 10:30:00",2856,700,3556
"2020-04-25 10:10:51","2020-04-26 11:00:00","2020-04-26 11:30:00",3056,776,3832
"2020-04-25 10:10:51","2020-04-26 12:00:00","2020-04-26 12:30:00",3227,825,4052
"2020-04-25 10:10:51","2020-04-26 13:00:00","2020-04-26 13:30:00",3352,864,4216
"2020-04-25 10:10:51","2020-04-26 14:00:00","2020-04-26 14:30:00",3274,826,4100
"2020-04-25 10:10:51","2020-04-26 15:00:00","2020-04-26 15:30:00",3181,782,3963
"2020-04-25 10:10:51","2020-04-26 16:00:00","2020-04-26 16:30:00",3131,795,3926
"2020-04-25 10:10:51","2020-04-26 17:00:00","2020-04-26 17:30:00",3247,860,4107
"2020-04-25 10:10:51","2020-04-26 18:00:00","2020-04-26 18:30:00",3407,891,4298
"2020-04-25 10:10:51","2020-04-26 19:00:00","2020-04-26 19:30:00",3267,829,4096
"2020-04-25 10:10:51","2020-04-26 20:00:00","2020-04-26 20:30:00",3092,796,3888
"2020-04-25 10:10:51","2020-04-26 21:00:00","2020-04-26 21:30:00",3138,832,3970
"2020-04-25 10:10:51","2020-04-26 22:00:00","2020-04-26 22:30:00",2982,783,3765
"2020-04-26 10:10:36","2020-04-26 23:00:00","2020-04-26 23:30:00",2701,653,3354
"2020-04-26 10:10:36","2020-04-27 00:00:00","2020-04-27 00:30:00",2532,576,3108
"2020-04-26 10:10:36","2020-04-27 01:00:00","2020-04-27 01:30:00",2432,518,2950
"2020-04-26 10:10:36","2020-04-27 02:00:00","2020-04-27 02:30:00",2333,486,2819
"2020-04-26 10:10:36","2020-04-27 03:00:00","2020-04-27 03:30:00",2240,481,2721
"2020-04-26 10:10:36","2020-04-27 04:00:00","2020-04-27 04:30:00",2205,479,2684
"2020-04-26 10:10:36","2020-04-27 05:00:00","2020-04-27 05:30:00",2219,486,2705
"2020-04-26 10:10:36","2020-04-27 06:00:00","2020-04-27 06:30:00",2328,512,2840
"2020-04-26 10:10:36","2020-04-27 07:00:00","2020-04-27 07:30:00",2531,599,3130
"2020-04-26 10:10:36","2020-04-27 08:00:00","2020-04-27 08:30:00",2916,680,3596
"2020-04-26 10:10:36","2020-04-27 09:00:00","2020-04-27 09:30:00",3204,758,3962
"2020-04-26 10:10:36","2020-04-27 10:00:00","2020-04-27 10:30:00",3301,764,4065
"2020-04-26 10:10:36","2020-04-27 11:00:00","2020-04-27 11:30:00",3344,757,4101
"2020-04-26 10:10:36","2020-04-27 12:00:00","2020-04-27 12:30:00",3380,754,4134
"2020-04-26 10:10:36","2020-04-27 13:00:00","2020-04-27 13:30:00",3489,770,4259
"2020-04-26 10:10:36","2020-04-27 14:00:00","2020-04-27 14:30:00",3350,712,4062
"2020-04-26 10:10:36","2020-04-27 15:00:00","2020-04-27 15:30:00",3235,691,3926
"2020-04-26 10:10:36","2020-04-27 16:00:00","2020-04-27 16:30:00",3242,720,3962
"2020-04-26 10:10:36","2020-04-27 17:00:00","2020-04-27 17:30:00",3406,878,4284
"2020-04-26 10:10:36","2020-04-27 18:00:00","2020-04-27 18:30:00",3600,935,4535
"2020-04-26 10:10:36","2020-04-27 19:00:00","2020-04-27 19:30:00",3459,851,4310
"2020-04-26 10:10:36","2020-04-27 20:00:00","2020-04-27 20:30:00",3327,823,4150
"2020-04-26 10:10:36","2020-04-27 21:00:00","2020-04-27 21:30:00",3406,854,4260
"2020-04-26 10:10:36","2020-04-27 22:00:00","2020-04-27 22:30:00",3212,814,4026
"2020-04-27 10:11:25","2020-04-27 23:00:00","2020-04-27 23:30:00",2862,773,3635
"2020-04-27 10:11:25","2020-04-28 00:00:00","2020-04-28 00:30:00",2627,629,3256
"2020-04-27 10:11:25","2020-04-28 01:00:00","2020-04-28 01:30:00",2514,566,3080
"2020-04-27 10:11:25","2020-04-28 02:00:00","2020-04-28 02:30:00",2387,537,2924
"2020-04-27 10:11:25","2020-04-28 03:00:00","2020-04-28 03:30:00",2309,543,2852
"2020-04-27 10:11:25","2020-04-28 04:00:00","2020-04-28 04:30:00",2286,527,2813
"2020-04-27 10:11:25","2020-04-28 05:00:00","2020-04-28 05:30:00",2290,523,2813
"2020-04-27 10:11:25","2020-04-28 06:00:00","2020-04-28 06:30:00",2390,556,2946
"2020-04-27 10:11:25","2020-04-28 07:00:00","2020-04-28 07:30:00",2603,628,3231
"2020-04-27 10:11:25","2020-04-28 08:00:00","2020-04-28 08:30:00",2998,752,3750
"2020-04-27 10:11:25","2020-04-28 09:00:00","2020-04-28 09:30:00",3310,829,4139
"2020-04-27 10:11:25","2020-04-28 10:00:00","2020-04-28 10:30:00",3362,870,4232
"2020-04-27 10:11:25","2020-04-28 11:00:00","2020-04-28 11:30:00",3407,875,4282
"2020-04-27 10:11:25","2020-04-28 12:00:00","2020-04-28 12:30:00",3440,881,4321
"2020-04-27 10:11:25","2020-04-28 13:00:00","2020-04-28 13:30:00",3540,909,4449
"2020-04-27 10:11:25","2020-04-28 14:00:00","2020-04-28 14:30:00",3400,842,4242
"2020-04-27 10:11:25","2020-04-28 15:00:00","2020-04-28 15:30:00",3297,820,4117
"2020-04-27 10:11:25","2020-04-28 16:00:00","2020-04-28 16:30:00",3278,847,4125
"2020-04-27 10:11:25","2020-04-28 17:00:00","2020-04-28 17:30:00",3451,996,4447
"2020-04-27 10:11:25","2020-04-28 18:00:00","2020-04-28 18:30:00",3646,1047,4693
"2020-04-27 10:11:25","2020-04-28 19:00:00","2020-04-28 19:30:00",3515,957,4472
"2020-04-27 10:11:25","2020-04-28 20:00:00","2020-04-28 20:30:00",3353,884,4237
"2020-04-27 10:11:25","2020-04-28 21:00:00","2020-04-28 21:30:00",3397,910,4307
"2020-04-27 10:11:25","2020-04-28 22:00:00","2020-04-28 22:30:00",3229,882,4111
"2020-04-28 10:11:11","2020-04-28 23:00:00","2020-04-28 23:30:00",2927,770,3697
"2020-04-28 10:11:11","2020-04-29 00:00:00","2020-04-29 00:30:00",2643,593,3236
"2020-04-28 10:11:11","2020-04-29 01:00:00","2020-04-29 01:30:00",2532,541,3073
"2020-04-28 10:11:11","2020-04-29 02:00:00","2020-04-29 02:30:00",2406,512,2918
"2020-04-28 10:11:11","2020-04-29 03:00:00","2020-04-29 03:30:00",2330,510,2840
"2020-04-28 10:11:11","2020-04-29 04:00:00","2020-04-29 04:30:00",2307,503,2810
"2020-04-28 10:11:11","2020-04-29 05:00:00","2020-04-29 05:30:00",2311,511,2822
"2020-04-28 10:11:11","2020-04-29 06:00:00","2020-04-29 06:30:00",2363,528,2891
"2020-04-28 10:11:11","2020-04-29 07:00:00","2020-04-29 07:30:00",2570,612,3182
"2020-04-28 10:11:11","2020-04-29 08:00:00","2020-04-29 08:30:00",2961,711,3672
"2020-04-28 10:11:11","2020-04-29 09:00:00","2020-04-29 09:30:00",3274,799,4073
"2020-04-28 10:11:11","2020-04-29 10:00:00","2020-04-29 10:30:00",3336,835,4171
"2020-04-28 10:11:11","2020-04-29 11:00:00","2020-04-29 11:30:00",3390,853,4243
"2020-04-28 10:11:11","2020-04-29 12:00:00","2020-04-29 12:30:00",3428,873,4301
"2020-04-28 10:11:11","2020-04-29 13:00:00","2020-04-29 13:30:00",3532,907,4439
"2020-04-28 10:11:11","2020-04-29 14:00:00","2020-04-29 14:30:00",3393,854,4247
"2020-04-28 10:11:11","2020-04-29 15:00:00","2020-04-29 15:30:00",3305,838,4143
"2020-04-28 10:11:11","2020-04-29 16:00:00","2020-04-29 16:30:00",3286,852,4138
"2020-04-28 10:11:11","2020-04-29 17:00:00","2020-04-29 17:30:00",3457,981,4438
"2020-04-28 10:11:11","2020-04-29 18:00:00","2020-04-29 18:30:00",3650,1009,4659
"2020-04-28 10:11:11","2020-04-29 19:00:00","2020-04-29 19:30:00",3521,904,4425
"2020-04-28 10:11:11","2020-04-29 20:00:00","2020-04-29 20:30:00",3361,847,4208
"2020-04-28 10:11:11","2020-04-29 21:00:00","2020-04-29 21:30:00",3404,843,4247
"2020-04-28 10:11:11","2020-04-29 22:00:00","2020-04-29 22:30:00",3238,838,4076
"2020-04-29 10:11:31","2020-04-29 23:00:00","2020-04-29 23:30:00",2851,729,3580
"2020-04-29 10:11:31","2020-04-30 00:00:00","2020-04-30 00:30:00",2675,616,3291
"2020-04-29 10:11:31","2020-04-30 01:00:00","2020-04-30 01:30:00",2552,564,3116
"2020-04-29 10:11:31","2020-04-30 02:00:00","2020-04-30 02:30:00",2437,535,2972
"2020-04-29 10:11:31","2020-04-30 03:00:00","2020-04-30 03:30:00",2367,533,2900
"2020-04-29 10:11:31","2020-04-30 04:00:00","2020-04-30 04:30:00",2340,520,2860
"2020-04-29 10:11:31","2020-04-30 05:00:00","2020-04-30 05:30:00",2368,528,2896
"2020-04-29 10:11:31","2020-04-30 06:00:00","2020-04-30 06:30:00",2401,539,2940
"2020-04-29 10:11:31","2020-04-30 07:00:00","2020-04-30 07:30:00",2644,627,3271
"2020-04-29 10:11:31","2020-04-30 08:00:00","2020-04-30 08:30:00",2991,752,3743
"2020-04-29 10:11:31","2020-04-30 09:00:00","2020-04-30 09:30:00",3280,834,4114
"2020-04-29 10:11:31","2020-04-30 10:00:00","2020-04-30 10:30:00",3354,856,4210
"2020-04-29 10:11:31","2020-04-30 11:00:00","2020-04-30 11:30:00",3382,864,4246
"2020-04-29 10:11:31","2020-04-30 12:00:00","2020-04-30 12:30:00",3420,875,4295
"2020-04-29 10:11:31","2020-04-30 13:00:00","2020-04-30 13:30:00",3527,931,4458
"2020-04-29 10:11:31","2020-04-30 14:00:00","2020-04-30 14:30:00",3378,890,4268
"2020-04-29 10:11:31","2020-04-30 15:00:00","2020-04-30 15:30:00",3316,891,4207
"2020-04-29 10:11:31","2020-04-30 16:00:00","2020-04-30 16:30:00",3326,925,4251
"2020-04-29 10:11:31","2020-04-30 17:00:00","2020-04-30 17:30:00",3524,1059,4583
"2020-04-29 10:11:31","2020-04-30 18:00:00","2020-04-30 18:30:00",3680,1072,4752
"2020-04-29 10:11:31","2020-04-30 19:00:00","2020-04-30 19:30:00",3554,951,4505
"2020-04-29 10:11:31","2020-04-30 20:00:00","2020-04-30 20:30:00",3362,889,4251
"2020-04-29 10:11:31","2020-04-30 21:00:00","2020-04-30 21:30:00",3333,880,4213
"2020-04-29 10:11:31","2020-04-30 22:00:00","2020-04-30 22:30:00",3191,846,4037
"2020-04-30 10:11:20","2020-04-30 23:00:00","2020-04-30 23:30:00",2851,762,3613
"2020-04-30 10:11:20","2020-05-01 00:00:00","2020-05-01 00:30:00",2687,624,3311
"2020-04-30 10:11:20","2020-05-01 01:00:00","2020-05-01 01:30:00",2559,567,3126
"2020-04-30 10:11:20","2020-05-01 02:00:00","2020-05-01 02:30:00",2436,541,2977
"2020-04-30 10:11:20","2020-05-01 03:00:00","2020-05-01 03:30:00",2353,546,2899
"2020-04-30 10:11:20","2020-05-01 04:00:00","2020-05-01 04:30:00",2320,532,2852
"2020-04-30 10:11:20","2020-05-01 05:00:00","2020-05-01 05:30:00",2362,528,2890
"2020-04-30 10:11:20","2020-05-01 06:00:00","2020-05-01 06:30:00",2434,558,2992
"2020-04-30 10:11:20","2020-05-01 07:00:00","2020-05-01 07:30:00",2652,623,3275
"2020-04-30 10:11:20","2020-05-01 08:00:00","2020-05-01 08:30:00",2998,736,3734
"2020-04-30 10:11:20","2020-05-01 09:00:00","2020-05-01 09:30:00",3292,805,4097
"2020-04-30 10:11:20","2020-05-01 10:00:00","2020-05-01 10:30:00",3355,842,4197
"2020-04-30 10:11:20","2020-05-01 11:00:00","2020-05-01 11:30:00",3420,847,4267
"2020-04-30 10:11:20","2020-05-01 12:00:00","2020-05-01 12:30:00",3428,852,4280
"2020-04-30 10:11:20","2020-05-01 13:00:00","2020-05-01 13:30:00",3498,877,4375
"2020-04-30 10:11:20","2020-05-01 14:00:00","2020-05-01 14:30:00",3358,816,4174
"2020-04-30 10:11:20","2020-05-01 15:00:00","2020-05-01 15:30:00",3245,797,4042
"2020-04-30 10:11:20","2020-05-01 16:00:00","2020-05-01 16:30:00",3215,821,4036
"2020-04-30 10:11:20","2020-05-01 17:00:00","2020-05-01 17:30:00",3382,955,4337
"2020-04-30 10:11:20","2020-05-01 18:00:00","2020-05-01 18:30:00",3580,1001,4581
"2020-04-30 10:11:20","2020-05-01 19:00:00","2020-05-01 19:30:00",3473,921,4394
"2020-04-30 10:11:20","2020-05-01 20:00:00","2020-05-01 20:30:00",3290,855,4145
"2020-04-30 10:11:20","2020-05-01 21:00:00","2020-05-01 21:30:00",3259,878,4137
"2020-04-30 10:11:20","2020-05-01 22:00:00","2020-05-01 22:30:00",3142,853,3995
"2020-05-01 10:11:10","2020-05-01 23:00:00","2020-05-01 23:30:00",2870,755,3625
"2020-05-01 10:11:10","2020-05-02 00:00:00","2020-05-02 00:30:00",2702,637,3339
"2020-05-01 10:11:10","2020-05-02 01:00:00","2020-05-02 01:30:00",2560,567,3127
"2020-05-01 10:11:10","2020-05-02 02:00:00","2020-05-02 02:30:00",2423,529,2952
"2020-05-01 10:11:10","2020-05-02 03:00:00","2020-05-02 03:30:00",2333,518,2851
"2020-05-01 10:11:10","2020-05-02 04:00:00","2020-05-02 04:30:00",2284,503,2787
"2020-05-01 10:11:10","2020-05-02 05:00:00","2020-05-02 05:30:00",2285,508,2793
"2020-05-01 10:11:10","2020-05-02 06:00:00","2020-05-02 06:30:00",2280,500,2780
"2020-05-01 10:11:10","2020-05-02 07:00:00","2020-05-02 07:30:00",2366,534,2900
"2020-05-01 10:11:10","2020-05-02 08:00:00","2020-05-02 08:30:00",2588,622,3210
"2020-05-01 10:11:10","2020-05-02 09:00:00","2020-05-02 09:30:00",2812,703,3515
"2020-05-01 10:11:10","2020-05-02 10:00:00","2020-05-02 10:30:00",3015,762,3777
"2020-05-01 10:11:10","2020-05-02 11:00:00","2020-05-02 11:30:00",3141,791,3932
"2020-05-01 10:11:10","2020-05-02 12:00:00","2020-05-02 12:30:00",3195,790,3985
"2020-05-01 10:11:10","2020-05-02 13:00:00","2020-05-02 13:30:00",3230,783,4013
"2020-05-01 10:11:10","2020-05-02 14:00:00","2020-05-02 14:30:00",3116,724,3840
"2020-05-01 10:11:10","2020-05-02 15:00:00","2020-05-02 15:30:00",3011,694,3705
"2020-05-01 10:11:10","2020-05-02 16:00:00","2020-05-02 16:30:00",2978,710,3688
"2020-05-01 10:11:10","2020-05-02 17:00:00","2020-05-02 17:30:00",3156,831,3987
"2020-05-01 10:11:10","2020-05-02 18:00:00","2020-05-02 18:30:00",3380,920,4300
"2020-05-01 10:11:10","2020-05-02 19:00:00","2020-05-02 19:30:00",3315,890,4205
"2020-05-01 10:11:10","2020-05-02 20:00:00","2020-05-02 20:30:00",3153,851,4004
"2020-05-01 10:11:10","2020-05-02 21:00:00","2020-05-02 21:30:00",3105,823,3928
"2020-05-01 10:11:10","2020-05-02 22:00:00","2020-05-02 22:30:00",3005,815,3820
"2020-05-02 10:11:31","2020-05-02 23:00:00","2020-05-02 23:30:00",2747,708,3455
"2020-05-02 10:11:31","2020-05-03 00:00:00","2020-05-03 00:30:00",2538,624,3162
"2020-05-02 10:11:31","2020-05-03 01:00:00","2020-05-03 01:30:00",2421,568,2989
"2020-05-02 10:11:31","2020-05-03 02:00:00","2020-05-03 02:30:00",2305,533,2838
"2020-05-02 10:11:31","2020-05-03 03:00:00","2020-05-03 03:30:00",2217,522,2739
"2020-05-02 10:11:31","2020-05-03 04:00:00","2020-05-03 04:30:00",2167,507,2674
"2020-05-02 10:11:31","2020-05-03 05:00:00","2020-05-03 05:30:00",2164,506,2670
"2020-05-02 10:11:31","2020-05-03 06:00:00","2020-05-03 06:30:00",2172,500,2672
"2020-05-02 10:11:31","2020-05-03 07:00:00","2020-05-03 07:30:00",2230,519,2749
"2020-05-02 10:11:31","2020-05-03 08:00:00","2020-05-03 08:30:00",2410,578,2988
"2020-05-02 10:11:31","2020-05-03 09:00:00","2020-05-03 09:30:00",2634,649,3283
"2020-05-02 10:11:31","2020-05-03 10:00:00","2020-05-03 10:30:00",2852,732,3584
"2020-05-02 10:11:31","2020-05-03 11:00:00","2020-05-03 11:30:00",3042,797,3839
"2020-05-02 10:11:31","2020-05-03 12:00:00","2020-05-03 12:30:00",3186,848,4034
"2020-05-02 10:11:31","2020-05-03 13:00:00","2020-05-03 13:30:00",3321,896,4217
"2020-05-02 10:11:31","2020-05-03 14:00:00","2020-05-03 14:30:00",3254,846,4100
"2020-05-02 10:11:31","2020-05-03 15:00:00","2020-05-03 15:30:00",3172,798,3970
"2020-05-02 10:11:31","2020-05-03 16:00:00","2020-05-03 16:30:00",3177,810,3987
"2020-05-02 10:11:31","2020-05-03 17:00:00","2020-05-03 17:30:00",3329,877,4206
"2020-05-02 10:11:31","2020-05-03 18:00:00","2020-05-03 18:30:00",3449,920,4369
"2020-05-02 10:11:31","2020-05-03 19:00:00","2020-05-03 19:30:00",3333,859,4192
"2020-05-02 10:11:31","2020-05-03 20:00:00","2020-05-03 20:30:00",3166,814,3980
"2020-05-02 10:11:31","2020-05-03 21:00:00","2020-05-03 21:30:00",3127,807,3934
"2020-05-02 10:11:31","2020-05-03 22:00:00","2020-05-03 22:30:00",2965,801,3766
"2020-05-03 10:11:11","2020-05-03 23:00:00","2020-05-03 23:30:00",2718,732,3450
"2020-05-03 10:11:11","2020-05-04 00:00:00","2020-05-04 00:30:00",2538,603,3141
"2020-05-03 10:11:11","2020-05-04 01:00:00","2020-05-04 01:30:00",2421,545,2966
"2020-05-03 10:11:11","2020-05-04 02:00:00","2020-05-04 02:30:00",2305,514,2819
"2020-05-03 10:11:11","2020-05-04 03:00:00","2020-05-04 03:30:00",2217,511,2728
"2020-05-03 10:11:11","2020-05-04 04:00:00","2020-05-04 04:30:00",2167,503,2670
"2020-05-03 10:11:11","2020-05-04 05:00:00","2020-05-04 05:30:00",2164,512,2676
"2020-05-03 10:11:11","2020-05-04 06:00:00","2020-05-04 06:30:00",2172,531,2703
"2020-05-03 10:11:11","2020-05-04 07:00:00","2020-05-04 07:30:00",2230,625,2855
"2020-05-03 10:11:11","2020-05-04 08:00:00","2020-05-04 08:30:00",2410,735,3145
"2020-05-03 10:11:11","2020-05-04 09:00:00","2020-05-04 09:30:00",2634,833,3467
"2020-05-03 10:11:11","2020-05-04 10:00:00","2020-05-04 10:30:00",2852,874,3726
"2020-05-03 10:11:11","2020-05-04 11:00:00","2020-05-04 11:30:00",3042,893,3935
"2020-05-03 10:11:11","2020-05-04 12:00:00","2020-05-04 12:30:00",3186,916,4102
"2020-05-03 10:11:11","2020-05-04 13:00:00","2020-05-04 13:30:00",3321,954,4275
"2020-05-03 10:11:11","2020-05-04 14:00:00","2020-05-04 14:30:00",3254,895,4149
"2020-05-03 10:11:11","2020-05-04 15:00:00","2020-05-04 15:30:00",3172,877,4049
"2020-05-03 10:11:11","2020-05-04 16:00:00","2020-05-04 16:30:00",3177,893,4070
"2020-05-03 10:11:11","2020-05-04 17:00:00","2020-05-04 17:30:00",3329,1037,4366
"2020-05-03 10:11:11","2020-05-04 18:00:00","2020-05-04 18:30:00",3449,1068,4517
"2020-05-03 10:11:11","2020-05-04 19:00:00","2020-05-04 19:30:00",3333,950,4283
"2020-05-03 10:11:11","2020-05-04 20:00:00","2020-05-04 20:30:00",3166,887,4053
"2020-05-03 10:11:11","2020-05-04 21:00:00","2020-05-04 21:30:00",3127,883,4010
"2020-05-03 10:11:11","2020-05-04 22:00:00","2020-05-04 22:30:00",2965,877,3842
"2020-05-04 10:11:36","2020-05-04 23:00:00","2020-05-04 23:30:00",2718,755,3473
"2020-05-04 10:11:36","2020-05-05 00:00:00","2020-05-05 00:30:00",2462,638,3100
"2020-05-04 10:11:36","2020-05-05 01:00:00","2020-05-05 01:30:00",2358,571,2929
"2020-05-04 10:11:36","2020-05-05 02:00:00","2020-05-05 02:30:00",2245,549,2794
"2020-05-04 10:11:36","2020-05-05 03:00:00","2020-05-05 03:30:00",2167,562,2729
"2020-05-04 10:11:36","2020-05-05 04:00:00","2020-05-05 04:30:00",2160,536,2696
"2020-05-04 10:11:36","2020-05-05 05:00:00","2020-05-05 05:30:00",2190,533,2723
"2020-05-04 10:11:36","2020-05-05 06:00:00","2020-05-05 06:30:00",2260,550,2810
"2020-05-04 10:11:36","2020-05-05 07:00:00","2020-05-05 07:30:00",2523,626,3149
"2020-05-04 10:11:36","2020-05-05 08:00:00","2020-05-05 08:30:00",2901,721,3622
"2020-05-04 10:11:36","2020-05-05 09:00:00","2020-05-05 09:30:00",3214,799,4013
"2020-05-04 10:11:36","2020-05-05 10:00:00","2020-05-05 10:30:00",3301,824,4125
"2020-05-04 10:11:36","2020-05-05 11:00:00","2020-05-05 11:30:00",3361,837,4198
"2020-05-04 10:11:36","2020-05-05 12:00:00","2020-05-05 12:30:00",3393,883,4276
"2020-05-04 10:11:36","2020-05-05 13:00:00","2020-05-05 13:30:00",3492,905,4397
"2020-05-04 10:11:36","2020-05-05 14:00:00","2020-05-05 14:30:00",3357,816,4173
"2020-05-04 10:11:36","2020-05-05 15:00:00","2020-05-05 15:30:00",3278,813,4091
"2020-05-04 10:11:36","2020-05-05 16:00:00","2020-05-05 16:30:00",3280,821,4101
"2020-05-04 10:11:36","2020-05-05 17:00:00","2020-05-05 17:30:00",3456,953,4409
"2020-05-04 10:11:36","2020-05-05 18:00:00","2020-05-05 18:30:00",3630,987,4617
"2020-05-04 10:11:36","2020-05-05 19:00:00","2020-05-05 19:30:00",3470,885,4355
"2020-05-04 10:11:36","2020-05-05 20:00:00","2020-05-05 20:30:00",3302,850,4152
"2020-05-04 10:11:36","2020-05-05 21:00:00","2020-05-05 21:30:00",3274,857,4131
"2020-05-04 10:11:36","2020-05-05 22:00:00","2020-05-05 22:30:00",3197,861,4058
"2020-05-05 10:11:26","2020-05-05 23:00:00","2020-05-05 23:30:00",2867,721,3588
"2020-05-05 10:11:26","2020-05-06 00:00:00","2020-05-06 00:30:00",2660,601,3261
"2020-05-05 10:11:26","2020-05-06 01:00:00","2020-05-06 01:30:00",2535,553,3088
"2020-05-05 10:11:26","2020-05-06 02:00:00","2020-05-06 02:30:00",2419,523,2942
"2020-05-05 10:11:26","2020-05-06 03:00:00","2020-05-06 03:30:00",2347,522,2869
"2020-05-05 10:11:26","2020-05-06 04:00:00","2020-05-06 04:30:00",2320,512,2832
"2020-05-05 10:11:26","2020-05-06 05:00:00","2020-05-06 05:30:00",2348,521,2869
"2020-05-05 10:11:26","2020-05-06 06:00:00","2020-05-06 06:30:00",2382,542,2924
"2020-05-05 10:11:26","2020-05-06 07:00:00","2020-05-06 07:30:00",2629,615,3244
"2020-05-05 10:11:26","2020-05-06 08:00:00","2020-05-06 08:30:00",2981,740,3721
"2020-05-05 10:11:26","2020-05-06 09:00:00","2020-05-06 09:30:00",3274,812,4086
"2020-05-05 10:11:26","2020-05-06 10:00:00","2020-05-06 10:30:00",3349,843,4192
"2020-05-05 10:11:26","2020-05-06 11:00:00","2020-05-06 11:30:00",3378,845,4223
"2020-05-05 10:11:26","2020-05-06 12:00:00","2020-05-06 12:30:00",3416,830,4246
"2020-05-05 10:11:26","2020-05-06 13:00:00","2020-05-06 13:30:00",3524,850,4374
"2020-05-05 10:11:26","2020-05-06 14:00:00","2020-05-06 14:30:00",3373,779,4152
"2020-05-05 10:11:26","2020-05-06 15:00:00","2020-05-06 15:30:00",3310,772,4082
"2020-05-05 10:11:26","2020-05-06 16:00:00","2020-05-06 16:30:00",3321,794,4115
"2020-05-05 10:11:26","2020-05-06 17:00:00","2020-05-06 17:30:00",3522,939,4461
"2020-05-05 10:11:26","2020-05-06 18:00:00","2020-05-06 18:30:00",3680,988,4668
"2020-05-05 10:11:26","2020-05-06 19:00:00","2020-05-06 19:30:00",3553,910,4463
"2020-05-05 10:11:26","2020-05-06 20:00:00","2020-05-06 20:30:00",3357,862,4219
"2020-05-05 10:11:26","2020-05-06 21:00:00","2020-05-06 21:30:00",3328,880,4208
"2020-05-05 10:11:26","2020-05-06 22:00:00","2020-05-06 22:30:00",3184,846,4030
"2020-05-06 10:11:11","2020-05-06 23:00:00","2020-05-06 23:30:00",2838,786,3624
"2020-05-06 10:11:11","2020-05-07 00:00:00","2020-05-07 00:30:00",2655,665,3320
"2020-05-06 10:11:11","2020-05-07 01:00:00","2020-05-07 01:30:00",2574,593,3167
"2020-05-06 10:11:11","2020-05-07 02:00:00","2020-05-07 02:30:00",2444,574,3018
"2020-05-06 10:11:11","2020-05-07 03:00:00","2020-05-07 03:30:00",2361,567,2928
"2020-05-06 10:11:11","2020-05-07 04:00:00","2020-05-07 04:30:00",2348,552,2900
"2020-05-06 10:11:11","2020-05-07 05:00:00","2020-05-07 05:30:00",2359,555,2914
"2020-05-06 10:11:11","2020-05-07 06:00:00","2020-05-07 06:30:00",2418,580,2998
"2020-05-06 10:11:11","2020-05-07 07:00:00","2020-05-07 07:30:00",2639,655,3294
"2020-05-06 10:11:11","2020-05-07 08:00:00","2020-05-07 08:30:00",2990,770,3760
"2020-05-06 10:11:11","2020-05-07 09:00:00","2020-05-07 09:30:00",3298,838,4136
"2020-05-06 10:11:11","2020-05-07 10:00:00","2020-05-07 10:30:00",3377,882,4259
"2020-05-06 10:11:11","2020-05-07 11:00:00","2020-05-07 11:30:00",3416,901,4317
"2020-05-06 10:11:11","2020-05-07 12:00:00","2020-05-07 12:30:00",3464,931,4395
"2020-05-06 10:11:11","2020-05-07 13:00:00","2020-05-07 13:30:00",3589,961,4550
"2020-05-06 10:11:11","2020-05-07 14:00:00","2020-05-07 14:30:00",3455,899,4354
"2020-05-06 10:11:11","2020-05-07 15:00:00","2020-05-07 15:30:00",3393,876,4269
"2020-05-06 10:11:11","2020-05-07 16:00:00","2020-05-07 16:30:00",3368,900,4268
"2020-05-06 10:11:11","2020-05-07 17:00:00","2020-05-07 17:30:00",3545,1024,4569
"2020-05-06 10:11:11","2020-05-07 18:00:00","2020-05-07 18:30:00",3688,1055,4743
"2020-05-06 10:11:11","2020-05-07 19:00:00","2020-05-07 19:30:00",3522,945,4467
"2020-05-06 10:11:11","2020-05-07 20:00:00","2020-05-07 20:30:00",3376,890,4266
"2020-05-06 10:11:11","2020-05-07 21:00:00","2020-05-07 21:30:00",3306,872,4178
"2020-05-06 10:11:11","2020-05-07 22:00:00","2020-05-07 22:30:00",3233,865,4098
"2020-05-07 10:11:06","2020-05-07 23:00:00","2020-05-07 23:30:00",2935,786,3721
"2020-05-07 10:11:06","2020-05-08 00:00:00","2020-05-08 00:30:00",2706,615,3321
"2020-05-07 10:11:06","2020-05-08 01:00:00","2020-05-08 01:30:00",2588,558,3146
"2020-05-07 10:11:06","2020-05-08 02:00:00","2020-05-08 02:30:00",2433,544,2977
"2020-05-07 10:11:06","2020-05-08 03:00:00","2020-05-08 03:30:00",2353,538,2891
"2020-05-07 10:11:06","2020-05-08 04:00:00","2020-05-08 04:30:00",2326,521,2847
"2020-05-07 10:11:06","2020-05-08 05:00:00","2020-05-08 05:30:00",2364,540,2904
"2020-05-07 10:11:06","2020-05-08 06:00:00","2020-05-08 06:30:00",2370,544,2914
"2020-05-07 10:11:06","2020-05-08 07:00:00","2020-05-08 07:30:00",2610,638,3248
"2020-05-07 10:11:06","2020-05-08 08:00:00","2020-05-08 08:30:00",2964,745,3709
"2020-05-07 10:11:06","2020-05-08 09:00:00","2020-05-08 09:30:00",3242,828,4070
"2020-05-07 10:11:06","2020-05-08 10:00:00","2020-05-08 10:30:00",3306,856,4162
"2020-05-07 10:11:06","2020-05-08 11:00:00","2020-05-08 11:30:00",3354,872,4226
"2020-05-07 10:11:06","2020-05-08 12:00:00","2020-05-08 12:30:00",3406,870,4276
"2020-05-07 10:11:06","2020-05-08 13:00:00","2020-05-08 13:30:00",3539,878,4417
"2020-05-07 10:11:06","2020-05-08 14:00:00","2020-05-08 14:30:00",3374,814,4188
"2020-05-07 10:11:06","2020-05-08 15:00:00","2020-05-08 15:30:00",3252,767,4019
"2020-05-07 10:11:06","2020-05-08 16:00:00","2020-05-08 16:30:00",3242,787,4029
"2020-05-07 10:11:06","2020-05-08 17:00:00","2020-05-08 17:30:00",3494,913,4407
"2020-05-07 10:11:06","2020-05-08 18:00:00","2020-05-08 18:30:00",3600,949,4549
"2020-05-07 10:11:06","2020-05-08 19:00:00","2020-05-08 19:30:00",3458,870,4328
"2020-05-07 10:11:06","2020-05-08 20:00:00","2020-05-08 20:30:00",3300,831,4131
"2020-05-07 10:11:06","2020-05-08 21:00:00","2020-05-08 21:30:00",3191,826,4017
"2020-05-07 10:11:06","2020-05-08 22:00:00","2020-05-08 22:30:00",3137,827,3964
"2020-05-07 10:11:06","2020-05-08 23:00:00","2020-05-08 23:30:00",2895,721,3616
"2020-05-07 10:11:06","2020-05-09 00:00:00","2020-05-09 00:30:00",2689,655,3344
"2020-05-07 10:11:06","2020-05-09 01:00:00","2020-05-09 01:30:00",2565,611,3176
"2020-05-07 10:11:06","2020-05-09 02:00:00","2020-05-09 02:30:00",2421,550,2971
"2020-05-07 10:11:06","2020-05-09 03:00:00","2020-05-09 03:30:00",2334,542,2876
"2020-05-07 10:11:06","2020-05-09 04:00:00","2020-05-09 04:30:00",2301,528,2829
"2020-05-07 10:11:06","2020-05-09 05:00:00","2020-05-09 05:30:00",2314,534,2848
"2020-05-07 10:11:06","2020-05-09 06:00:00","2020-05-09 06:30:00",2270,527,2797
"2020-05-07 10:11:06","2020-05-09 07:00:00","2020-05-09 07:30:00",2412,567,2979
"2020-05-07 10:11:06","2020-05-09 08:00:00","2020-05-09 08:30:00",2617,628,3245
"2020-05-07 10:11:06","2020-05-09 09:00:00","2020-05-09 09:30:00",2832,682,3514
"2020-05-07 10:11:06","2020-05-09 10:00:00","2020-05-09 10:30:00",3010,736,3746
"2020-05-07 10:11:06","2020-05-09 11:00:00","2020-05-09 11:30:00",3140,794,3934
"2020-05-07 10:11:06","2020-05-09 12:00:00","2020-05-09 12:30:00",3198,815,4013
"2020-05-07 10:11:06","2020-05-09 13:00:00","2020-05-09 13:30:00",3242,825,4067
"2020-05-07 10:11:06","2020-05-09 14:00:00","2020-05-09 14:30:00",3136,771,3907
"2020-05-07 10:11:06","2020-05-09 15:00:00","2020-05-09 15:30:00",3025,739,3764
"2020-05-07 10:11:06","2020-05-09 16:00:00","2020-05-09 16:30:00",2994,743,3737
"2020-05-07 10:11:06","2020-05-09 17:00:00","2020-05-09 17:30:00",3149,835,3984
"2020-05-07 10:11:06","2020-05-09 18:00:00","2020-05-09 18:30:00",3380,933,4313
"2020-05-07 10:11:06","2020-05-09 19:00:00","2020-05-09 19:30:00",3342,912,4254
"2020-05-07 10:11:06","2020-05-09 20:00:00","2020-05-09 20:30:00",3170,853,4023
"2020-05-07 10:11:06","2020-05-09 21:00:00","2020-05-09 21:30:00",3061,810,3871
"2020-05-07 10:11:06","2020-05-09 22:00:00","2020-05-09 22:30:00",3033,820,3853
"2020-05-09 10:11:21","2020-05-09 23:00:00","2020-05-09 23:30:00",2773,734,3507
"2020-05-09 10:11:21","2020-05-10 00:00:00","2020-05-10 00:30:00",2535,652,3187
"2020-05-09 10:11:21","2020-05-10 01:00:00","2020-05-10 01:30:00",2431,592,3023
"2020-05-09 10:11:21","2020-05-10 02:00:00","2020-05-10 02:30:00",2329,551,2880
"2020-05-09 10:11:21","2020-05-10 03:00:00","2020-05-10 03:30:00",2226,510,2736
"2020-05-09 10:11:21","2020-05-10 04:00:00","2020-05-10 04:30:00",2213,528,2741
"2020-05-09 10:11:21","2020-05-10 05:00:00","2020-05-10 05:30:00",2235,529,2764
"2020-05-09 10:11:21","2020-05-10 06:00:00","2020-05-10 06:30:00",2200,516,2716
"2020-05-09 10:11:21","2020-05-10 07:00:00","2020-05-10 07:30:00",2330,537,2867
"2020-05-09 10:11:21","2020-05-10 08:00:00","2020-05-10 08:30:00",2511,590,3101
"2020-05-09 10:11:21","2020-05-10 09:00:00","2020-05-10 09:30:00",2722,664,3386
"2020-05-09 10:11:21","2020-05-10 10:00:00","2020-05-10 10:30:00",2924,736,3660
"2020-05-09 10:11:21","2020-05-10 11:00:00","2020-05-10 11:30:00",3043,786,3829
"2020-05-09 10:11:21","2020-05-10 12:00:00","2020-05-10 12:30:00",3125,835,3960
"2020-05-09 10:11:21","2020-05-10 13:00:00","2020-05-10 13:30:00",3164,877,4041
"2020-05-09 10:11:21","2020-05-10 14:00:00","2020-05-10 14:30:00",3054,825,3879
"2020-05-09 10:11:21","2020-05-10 15:00:00","2020-05-10 15:30:00",2953,792,3745
"2020-05-09 10:11:21","2020-05-10 16:00:00","2020-05-10 16:30:00",2935,830,3765
"2020-05-09 10:11:21","2020-05-10 17:00:00","2020-05-10 17:30:00",3115,897,4012
"2020-05-09 10:11:21","2020-05-10 18:00:00","2020-05-10 18:30:00",3330,916,4246
"2020-05-09 10:11:21","2020-05-10 19:00:00","2020-05-10 19:30:00",3218,851,4069
"2020-05-09 10:11:21","2020-05-10 20:00:00","2020-05-10 20:30:00",3068,811,3879
"2020-05-09 10:11:21","2020-05-10 21:00:00","2020-05-10 21:30:00",3015,787,3802
"2020-05-09 10:11:21","2020-05-10 22:00:00","2020-05-10 22:30:00",3003,803,3806
"2020-05-10 10:11:06","2020-05-10 23:00:00","2020-05-10 23:30:00",2732,661,3393
"2020-05-10 10:11:06","2020-05-11 00:00:00","2020-05-11 00:30:00",2507,625,3132
"2020-05-10 10:11:06","2020-05-11 01:00:00","2020-05-11 01:30:00",2396,587,2983
"2020-05-10 10:11:06","2020-05-11 02:00:00","2020-05-11 02:30:00",2279,575,2854
"2020-05-10 10:11:06","2020-05-11 03:00:00","2020-05-11 03:30:00",2219,582,2801
"2020-05-10 10:11:06","2020-05-11 04:00:00","2020-05-11 04:30:00",2160,564,2724
"2020-05-10 10:11:06","2020-05-11 05:00:00","2020-05-11 05:30:00",2186,600,2786
"2020-05-10 10:11:06","2020-05-11 06:00:00","2020-05-11 06:30:00",2223,598,2821
"2020-05-10 10:11:06","2020-05-11 07:00:00","2020-05-11 07:30:00",2497,661,3158
"2020-05-10 10:11:06","2020-05-11 08:00:00","2020-05-11 08:30:00",2888,784,3672
"2020-05-10 10:11:06","2020-05-11 09:00:00","2020-05-11 09:30:00",3200,852,4052
"2020-05-10 10:11:06","2020-05-11 10:00:00","2020-05-11 10:30:00",3331,870,4201
"2020-05-10 10:11:06","2020-05-11 11:00:00","2020-05-11 11:30:00",3391,922,4313
"2020-05-10 10:11:06","2020-05-11 12:00:00","2020-05-11 12:30:00",3412,919,4331
"2020-05-10 10:11:06","2020-05-11 13:00:00","2020-05-11 13:30:00",3543,966,4509
"2020-05-10 10:11:06","2020-05-11 14:00:00","2020-05-11 14:30:00",3365,905,4270
"2020-05-10 10:11:06","2020-05-11 15:00:00","2020-05-11 15:30:00",3337,863,4200
"2020-05-10 10:11:06","2020-05-11 16:00:00","2020-05-11 16:30:00",3364,897,4261
"2020-05-10 10:11:06","2020-05-11 17:00:00","2020-05-11 17:30:00",3538,1036,4574
"2020-05-10 10:11:06","2020-05-11 18:00:00","2020-05-11 18:30:00",3700,1062,4762
"2020-05-10 10:11:06","2020-05-11 19:00:00","2020-05-11 19:30:00",3544,972,4516
"2020-05-10 10:11:06","2020-05-11 20:00:00","2020-05-11 20:30:00",3348,922,4270
"2020-05-10 10:11:06","2020-05-11 21:00:00","2020-05-11 21:30:00",3306,929,4235
"2020-05-10 10:11:06","2020-05-11 22:00:00","2020-05-11 22:30:00",3260,966,4226
"2020-05-11 10:11:26","2020-05-11 23:00:00","2020-05-11 23:30:00",2939,773,3712
"2020-05-11 10:11:26","2020-05-12 00:00:00","2020-05-12 00:30:00",2672,672,3344
"2020-05-11 10:11:26","2020-05-12 01:00:00","2020-05-12 01:30:00",2556,607,3163
"2020-05-11 10:11:26","2020-05-12 02:00:00","2020-05-12 02:30:00",2419,574,2993
"2020-05-11 10:11:26","2020-05-12 03:00:00","2020-05-12 03:30:00",2332,569,2901
"2020-05-11 10:11:26","2020-05-12 04:00:00","2020-05-12 04:30:00",2270,550,2820
"2020-05-11 10:11:26","2020-05-12 05:00:00","2020-05-12 05:30:00",2367,565,2932
"2020-05-11 10:11:26","2020-05-12 06:00:00","2020-05-12 06:30:00",2361,570,2931
"2020-05-11 10:11:26","2020-05-12 07:00:00","2020-05-12 07:30:00",2614,668,3282
"2020-05-11 10:11:26","2020-05-12 08:00:00","2020-05-12 08:30:00",3019,772,3791
"2020-05-11 10:11:26","2020-05-12 09:00:00","2020-05-12 09:30:00",3315,841,4156
"2020-05-11 10:11:26","2020-05-12 10:00:00","2020-05-12 10:30:00",3382,856,4238
"2020-05-11 10:11:26","2020-05-12 11:00:00","2020-05-12 11:30:00",3363,861,4224
"2020-05-11 10:11:26","2020-05-12 12:00:00","2020-05-12 12:30:00",3411,874,4285
"2020-05-11 10:11:26","2020-05-12 13:00:00","2020-05-12 13:30:00",3521,886,4407
"2020-05-11 10:11:26","2020-05-12 14:00:00","2020-05-12 14:30:00",3392,840,4232
"2020-05-11 10:11:26","2020-05-12 15:00:00","2020-05-12 15:30:00",3316,825,4141
"2020-05-11 10:11:26","2020-05-12 16:00:00","2020-05-12 16:30:00",3335,840,4175
"2020-05-11 10:11:26","2020-05-12 17:00:00","2020-05-12 17:30:00",3526,950,4476
"2020-05-11 10:11:26","2020-05-12 18:00:00","2020-05-12 18:30:00",3700,998,4698
"2020-05-11 10:11:26","2020-05-12 19:00:00","2020-05-12 19:30:00",3567,929,4496
"2020-05-11 10:11:26","2020-05-12 20:00:00","2020-05-12 20:30:00",3373,887,4260
"2020-05-11 10:11:26","2020-05-12 21:00:00","2020-05-12 21:30:00",3291,883,4174
"2020-05-11 10:11:26","2020-05-12 22:00:00","2020-05-12 22:30:00",3212,894,4106
"2020-05-12 10:11:21","2020-05-12 23:00:00","2020-05-12 23:30:00",2902,774,3676
"2020-05-12 10:11:21","2020-05-13 00:00:00","2020-05-13 00:30:00",2672,660,3332
"2020-05-12 10:11:21","2020-05-13 01:00:00","2020-05-13 01:30:00",2556,616,3172
"2020-05-12 10:11:21","2020-05-13 02:00:00","2020-05-13 02:30:00",2419,582,3001
"2020-05-12 10:11:21","2020-05-13 03:00:00","2020-05-13 03:30:00",2332,590,2922
"2020-05-12 10:11:21","2020-05-13 04:00:00","2020-05-13 04:30:00",2270,601,2871
"2020-05-12 10:11:21","2020-05-13 05:00:00","2020-05-13 05:30:00",2367,610,2977
"2020-05-12 10:11:21","2020-05-13 06:00:00","2020-05-13 06:30:00",2361,627,2988
"2020-05-12 10:11:21","2020-05-13 07:00:00","2020-05-13 07:30:00",2614,717,3331
"2020-05-12 10:11:21","2020-05-13 08:00:00","2020-05-13 08:30:00",3019,815,3834
"2020-05-12 10:11:21","2020-05-13 09:00:00","2020-05-13 09:30:00",3315,892,4207
"2020-05-12 10:11:21","2020-05-13 10:00:00","2020-05-13 10:30:00",3382,907,4289
"2020-05-12 10:11:21","2020-05-13 11:00:00","2020-05-13 11:30:00",3363,901,4264
"2020-05-12 10:11:21","2020-05-13 12:00:00","2020-05-13 12:30:00",3411,899,4310
"2020-05-12 10:11:21","2020-05-13 13:00:00","2020-05-13 13:30:00",3521,926,4447
"2020-05-12 10:11:21","2020-05-13 14:00:00","2020-05-13 14:30:00",3392,865,4257
"2020-05-12 10:11:21","2020-05-13 15:00:00","2020-05-13 15:30:00",3316,837,4153
"2020-05-12 10:11:21","2020-05-13 16:00:00","2020-05-13 16:30:00",3335,857,4192
"2020-05-12 10:11:21","2020-05-13 17:00:00","2020-05-13 17:30:00",3526,1007,4533
"2020-05-12 10:11:21","2020-05-13 18:00:00","2020-05-13 18:30:00",3700,1022,4722
"2020-05-12 10:11:21","2020-05-13 19:00:00","2020-05-13 19:30:00",3567,967,4534
"2020-05-12 10:11:21","2020-05-13 20:00:00","2020-05-13 20:30:00",3373,922,4295
"2020-05-12 10:11:21","2020-05-13 21:00:00","2020-05-13 21:30:00",3291,921,4212
"2020-05-12 10:11:21","2020-05-13 22:00:00","2020-05-13 22:30:00",3212,970,4182
"2020-05-13 10:11:15","2020-05-13 23:00:00","2020-05-13 23:30:00",2902,785,3687
"2020-05-13 10:11:15","2020-05-14 00:00:00","2020-05-14 00:30:00",2712,726,3438
"2020-05-13 10:11:15","2020-05-14 01:00:00","2020-05-14 01:30:00",2596,669,3265
"2020-05-13 10:11:15","2020-05-14 02:00:00","2020-05-14 02:30:00",2459,668,3127
"2020-05-13 10:11:15","2020-05-14 03:00:00","2020-05-14 03:30:00",2372,657,3029
"2020-05-13 10:11:15","2020-05-14 04:00:00","2020-05-14 04:30:00",2310,672,2982
"2020-05-13 10:11:15","2020-05-14 05:00:00","2020-05-14 05:30:00",2407,663,3070
"2020-05-13 10:11:15","2020-05-14 06:00:00","2020-05-14 06:30:00",2401,656,3057
"2020-05-13 10:11:15","2020-05-14 07:00:00","2020-05-14 07:30:00",2654,747,3401
"2020-05-13 10:11:15","2020-05-14 08:00:00","2020-05-14 08:30:00",3059,817,3876
"2020-05-13 10:11:15","2020-05-14 09:00:00","2020-05-14 09:30:00",3355,892,4247
"2020-05-13 10:11:15","2020-05-14 10:00:00","2020-05-14 10:30:00",3422,878,4300
"2020-05-13 10:11:15","2020-05-14 11:00:00","2020-05-14 11:30:00",3403,934,4337
"2020-05-13 10:11:15","2020-05-14 12:00:00","2020-05-14 12:30:00",3451,923,4374
"2020-05-13 10:11:15","2020-05-14 13:00:00","2020-05-14 13:30:00",3561,948,4509
"2020-05-13 10:11:15","2020-05-14 14:00:00","2020-05-14 14:30:00",3392,901,4293
"2020-05-13 10:11:15","2020-05-14 15:00:00","2020-05-14 15:30:00",3316,855,4171
"2020-05-13 10:11:15","2020-05-14 16:00:00","2020-05-14 16:30:00",3335,852,4187
"2020-05-13 10:11:15","2020-05-14 17:00:00","2020-05-14 17:30:00",3526,966,4492
"2020-05-13 10:11:15","2020-05-14 18:00:00","2020-05-14 18:30:00",3700,996,4696
"2020-05-13 10:11:15","2020-05-14 19:00:00","2020-05-14 19:30:00",3567,916,4483
"2020-05-13 10:11:15","2020-05-14 20:00:00","2020-05-14 20:30:00",3373,854,4227
"2020-05-13 10:11:15","2020-05-14 21:00:00","2020-05-14 21:30:00",3291,837,4128
"2020-05-13 10:11:15","2020-05-14 22:00:00","2020-05-14 22:30:00",3212,875,4087
"2020-05-14 10:11:31","2020-05-14 23:00:00","2020-05-14 23:30:00",2902,761,3663
"2020-05-14 10:11:31","2020-05-15 00:00:00","2020-05-15 00:30:00",2717,711,3428
"2020-05-14 10:11:31","2020-05-15 01:00:00","2020-05-15 01:30:00",2577,641,3218
"2020-05-14 10:11:31","2020-05-15 02:00:00","2020-05-15 02:30:00",2442,603,3045
"2020-05-14 10:11:31","2020-05-15 03:00:00","2020-05-15 03:30:00",2327,589,2916
"2020-05-14 10:11:31","2020-05-15 04:00:00","2020-05-15 04:30:00",2300,579,2879
"2020-05-14 10:11:31","2020-05-15 05:00:00","2020-05-15 05:30:00",2329,572,2901
"2020-05-14 10:11:31","2020-05-15 06:00:00","2020-05-15 06:30:00",2357,571,2928
"2020-05-14 10:11:31","2020-05-15 07:00:00","2020-05-15 07:30:00",2618,650,3268
"2020-05-14 10:11:31","2020-05-15 08:00:00","2020-05-15 08:30:00",2976,710,3686
"2020-05-14 10:11:31","2020-05-15 09:00:00","2020-05-15 09:30:00",3293,789,4082
"2020-05-14 10:11:31","2020-05-15 10:00:00","2020-05-15 10:30:00",3391,802,4193
"2020-05-14 10:11:31","2020-05-15 11:00:00","2020-05-15 11:30:00",3418,838,4256
"2020-05-14 10:11:31","2020-05-15 12:00:00","2020-05-15 12:30:00",3432,886,4318
"2020-05-14 10:11:31","2020-05-15 13:00:00","2020-05-15 13:30:00",3499,930,4429
"2020-05-14 10:11:31","2020-05-15 14:00:00","2020-05-15 14:30:00",3377,887,4264
"2020-05-14 10:11:31","2020-05-15 15:00:00","2020-05-15 15:30:00",3265,818,4083
"2020-05-14 10:11:31","2020-05-15 16:00:00","2020-05-15 16:30:00",3229,816,4045
"2020-05-14 10:11:31","2020-05-15 17:00:00","2020-05-15 17:30:00",3360,935,4295
"2020-05-14 10:11:31","2020-05-15 18:00:00","2020-05-15 18:30:00",3550,1004,4554
"2020-05-14 10:11:31","2020-05-15 19:00:00","2020-05-15 19:30:00",3451,946,4397
"2020-05-14 10:11:31","2020-05-15 20:00:00","2020-05-15 20:30:00",3276,890,4166
"2020-05-14 10:11:31","2020-05-15 21:00:00","2020-05-15 21:30:00",3177,846,4023
"2020-05-14 10:11:31","2020-05-15 22:00:00","2020-05-15 22:30:00",3172,865,4037
"2020-05-15 10:11:26","2020-05-15 23:00:00","2020-05-15 23:30:00",2910,761,3671
"2020-05-15 10:11:26","2020-05-16 00:00:00","2020-05-16 00:30:00",2700,683,3383
"2020-05-15 10:11:26","2020-05-16 01:00:00","2020-05-16 01:30:00",2557,591,3148
"2020-05-15 10:11:26","2020-05-16 02:00:00","2020-05-16 02:30:00",2414,544,2958
"2020-05-15 10:11:26","2020-05-16 03:00:00","2020-05-16 03:30:00",2335,551,2886
"2020-05-15 10:11:26","2020-05-16 04:00:00","2020-05-16 04:30:00",2289,494,2783
"2020-05-15 10:11:26","2020-05-16 05:00:00","2020-05-16 05:30:00",2298,508,2806
"2020-05-15 10:11:26","2020-05-16 06:00:00","2020-05-16 06:30:00",2250,499,2749
"2020-05-15 10:11:26","2020-05-16 07:00:00","2020-05-16 07:30:00",2396,540,2936
"2020-05-15 10:11:26","2020-05-16 08:00:00","2020-05-16 08:30:00",2637,603,3240
"2020-05-15 10:11:26","2020-05-16 09:00:00","2020-05-16 09:30:00",2875,686,3561
"2020-05-15 10:11:26","2020-05-16 10:00:00","2020-05-16 10:30:00",3065,752,3817
"2020-05-15 10:11:26","2020-05-16 11:00:00","2020-05-16 11:30:00",3184,766,3950
"2020-05-15 10:11:26","2020-05-16 12:00:00","2020-05-16 12:30:00",3218,795,4013
"2020-05-15 10:11:26","2020-05-16 13:00:00","2020-05-16 13:30:00",3233,815,4048
"2020-05-15 10:11:26","2020-05-16 14:00:00","2020-05-16 14:30:00",3110,784,3894
"2020-05-15 10:11:26","2020-05-16 15:00:00","2020-05-16 15:30:00",3000,739,3739
"2020-05-15 10:11:26","2020-05-16 16:00:00","2020-05-16 16:30:00",2972,736,3708
"2020-05-15 10:11:26","2020-05-16 17:00:00","2020-05-16 17:30:00",3124,857,3981
"2020-05-15 10:11:26","2020-05-16 18:00:00","2020-05-16 18:30:00",3320,950,4270
"2020-05-15 10:11:26","2020-05-16 19:00:00","2020-05-16 19:30:00",3229,898,4127
"2020-05-15 10:11:26","2020-05-16 20:00:00","2020-05-16 20:30:00",3068,834,3902
"2020-05-15 10:11:26","2020-05-16 21:00:00","2020-05-16 21:30:00",2980,795,3775
"2020-05-15 10:11:26","2020-05-16 22:00:00","2020-05-16 22:30:00",3001,772,3773
"2020-05-16 10:11:10","2020-05-16 23:00:00","2020-05-16 23:30:00",2754,707,3461
"2020-05-16 10:11:10","2020-05-17 00:00:00","2020-05-17 00:30:00",2521,623,3144
"2020-05-16 10:11:10","2020-05-17 01:00:00","2020-05-17 01:30:00",2413,560,2973
"2020-05-16 10:11:10","2020-05-17 02:00:00","2020-05-17 02:30:00",2290,520,2810
"2020-05-16 10:11:10","2020-05-17 03:00:00","2020-05-17 03:30:00",2202,500,2702
"2020-05-16 10:11:10","2020-05-17 04:00:00","2020-05-17 04:30:00",2129,492,2621
"2020-05-16 10:11:10","2020-05-17 05:00:00","2020-05-17 05:30:00",2141,490,2631
"2020-05-16 10:11:10","2020-05-17 06:00:00","2020-05-17 06:30:00",2091,480,2571
"2020-05-16 10:11:10","2020-05-17 07:00:00","2020-05-17 07:30:00",2202,499,2701
"2020-05-16 10:11:10","2020-05-17 08:00:00","2020-05-17 08:30:00",2379,534,2913
"2020-05-16 10:11:10","2020-05-17 09:00:00","2020-05-17 09:30:00",2580,601,3181
"2020-05-16 10:11:10","2020-05-17 10:00:00","2020-05-17 10:30:00",2777,655,3432
"2020-05-16 10:11:10","2020-05-17 11:00:00","2020-05-17 11:30:00",2967,720,3687
"2020-05-16 10:11:10","2020-05-17 12:00:00","2020-05-17 12:30:00",3100,770,3870
"2020-05-16 10:11:10","2020-05-17 13:00:00","2020-05-17 13:30:00",3211,818,4029
"2020-05-16 10:11:10","2020-05-17 14:00:00","2020-05-17 14:30:00",3128,768,3896
"2020-05-16 10:11:10","2020-05-17 15:00:00","2020-05-17 15:30:00",3065,751,3816
"2020-05-16 10:11:10","2020-05-17 16:00:00","2020-05-17 16:30:00",3053,765,3818
"2020-05-16 10:11:10","2020-05-17 17:00:00","2020-05-17 17:30:00",3187,856,4043
"2020-05-16 10:11:10","2020-05-17 18:00:00","2020-05-17 18:30:00",3291,868,4159
"2020-05-16 10:11:10","2020-05-17 19:00:00","2020-05-17 19:30:00",3221,796,4017
"2020-05-16 10:11:10","2020-05-17 20:00:00","2020-05-17 20:30:00",3035,770,3805
"2020-05-16 10:11:10","2020-05-17 21:00:00","2020-05-17 21:30:00",2954,773,3727
"2020-05-16 10:11:10","2020-05-17 22:00:00","2020-05-17 22:30:00",2978,801,3779
"2020-05-17 10:11:25","2020-05-17 23:00:00","2020-05-17 23:30:00",2769,734,3503
"2020-05-17 10:11:25","2020-05-18 00:00:00","2020-05-18 00:30:00",2528,590,3118
"2020-05-17 10:11:25","2020-05-18 01:00:00","2020-05-18 01:30:00",2358,530,2888
"2020-05-17 10:11:25","2020-05-18 02:00:00","2020-05-18 02:30:00",2235,492,2727
"2020-05-17 10:11:25","2020-05-18 03:00:00","2020-05-18 03:30:00",2170,484,2654
"2020-05-17 10:11:25","2020-05-18 04:00:00","2020-05-18 04:30:00",2150,474,2624
"2020-05-17 10:11:25","2020-05-18 05:00:00","2020-05-18 05:30:00",2223,475,2698
"2020-05-17 10:11:25","2020-05-18 06:00:00","2020-05-18 06:30:00",2272,530,2802
"2020-05-17 10:11:25","2020-05-18 07:00:00","2020-05-18 07:30:00",2619,640,3259
"2020-05-17 10:11:25","2020-05-18 08:00:00","2020-05-18 08:30:00",3018,763,3781
"2020-05-17 10:11:25","2020-05-18 09:00:00","2020-05-18 09:30:00",3349,842,4191
"2020-05-17 10:11:25","2020-05-18 10:00:00","2020-05-18 10:30:00",3427,867,4294
"2020-05-17 10:11:25","2020-05-18 11:00:00","2020-05-18 11:30:00",3464,881,4345
"2020-05-17 10:11:25","2020-05-18 12:00:00","2020-05-18 12:30:00",3520,885,4405
"2020-05-17 10:11:25","2020-05-18 13:00:00","2020-05-18 13:30:00",3643,894,4537
"2020-05-17 10:11:25","2020-05-18 14:00:00","2020-05-18 14:30:00",3511,836,4347
"2020-05-17 10:11:25","2020-05-18 15:00:00","2020-05-18 15:30:00",3402,793,4195
"2020-05-17 10:11:25","2020-05-18 16:00:00","2020-05-18 16:30:00",3366,805,4171
"2020-05-17 10:11:25","2020-05-18 17:00:00","2020-05-18 17:30:00",3541,948,4489
"2020-05-17 10:11:25","2020-05-18 18:00:00","2020-05-18 18:30:00",3700,972,4672
"2020-05-17 10:11:25","2020-05-18 19:00:00","2020-05-18 19:30:00",3515,900,4415
"2020-05-17 10:11:25","2020-05-18 20:00:00","2020-05-18 20:30:00",3319,865,4184
"2020-05-17 10:11:25","2020-05-18 21:00:00","2020-05-18 21:30:00",3250,859,4109
"2020-05-17 10:11:25","2020-05-18 22:00:00","2020-05-18 22:30:00",3277,884,4161
"2020-05-18 10:11:16","2020-05-18 23:00:00","2020-05-18 23:30:00",2996,752,3748
"2020-05-18 10:11:16","2020-05-19 00:00:00","2020-05-19 00:30:00",2717,586,3303
"2020-05-18 10:11:16","2020-05-19 01:00:00","2020-05-19 01:30:00",2564,520,3084
"2020-05-18 10:11:16","2020-05-19 02:00:00","2020-05-19 02:30:00",2429,495,2924
"2020-05-18 10:11:16","2020-05-19 03:00:00","2020-05-19 03:30:00",2360,484,2844
"2020-05-18 10:11:16","2020-05-19 04:00:00","2020-05-19 04:30:00",2351,472,2823
"2020-05-18 10:11:16","2020-05-19 05:00:00","2020-05-19 05:30:00",2381,473,2854
"2020-05-18 10:11:16","2020-05-19 06:00:00","2020-05-19 06:30:00",2415,501,2916
"2020-05-18 10:11:16","2020-05-19 07:00:00","2020-05-19 07:30:00",2717,656,3373
"2020-05-18 10:11:16","2020-05-19 08:00:00","2020-05-19 08:30:00",3124,792,3916
"2020-05-18 10:11:16","2020-05-19 09:00:00","2020-05-19 09:30:00",3457,896,4353
"2020-05-18 10:11:16","2020-05-19 10:00:00","2020-05-19 10:30:00",3543,929,4472
"2020-05-18 10:11:16","2020-05-19 11:00:00","2020-05-19 11:30:00",3516,947,4463
"2020-05-18 10:11:16","2020-05-19 12:00:00","2020-05-19 12:30:00",3546,952,4498
"2020-05-18 10:11:16","2020-05-19 13:00:00","2020-05-19 13:30:00",3685,965,4650
"2020-05-18 10:11:16","2020-05-19 14:00:00","2020-05-19 14:30:00",3548,895,4443
"2020-05-18 10:11:16","2020-05-19 15:00:00","2020-05-19 15:30:00",3506,865,4371
"2020-05-18 10:11:16","2020-05-19 16:00:00","2020-05-19 16:30:00",3491,890,4381
"2020-05-18 10:11:16","2020-05-19 17:00:00","2020-05-19 17:30:00",3675,1006,4681
"2020-05-18 10:11:16","2020-05-19 18:00:00","2020-05-19 18:30:00",3850,1064,4914
"2020-05-18 10:11:16","2020-05-19 19:00:00","2020-05-19 19:30:00",3647,969,4616
"2020-05-18 10:11:16","2020-05-19 20:00:00","2020-05-19 20:30:00",3437,923,4360
"2020-05-18 10:11:16","2020-05-19 21:00:00","2020-05-19 21:30:00",3336,914,4250
"2020-05-18 10:11:16","2020-05-19 22:00:00","2020-05-19 22:30:00",3361,947,4308
"2020-05-19 10:11:36","2020-05-19 23:00:00","2020-05-19 23:30:00",3061,774,3835
"2020-05-19 10:11:36","2020-05-20 00:00:00","2020-05-20 00:30:00",2717,650,3367
"2020-05-19 10:11:36","2020-05-20 01:00:00","2020-05-20 01:30:00",2564,584,3148
"2020-05-19 10:11:36","2020-05-20 02:00:00","2020-05-20 02:30:00",2429,562,2991
"2020-05-19 10:11:36","2020-05-20 03:00:00","2020-05-20 03:30:00",2360,558,2918
"2020-05-19 10:11:36","2020-05-20 04:00:00","2020-05-20 04:30:00",2351,550,2901
"2020-05-19 10:11:36","2020-05-20 05:00:00","2020-05-20 05:30:00",2381,551,2932
"2020-05-19 10:11:36","2020-05-20 06:00:00","2020-05-20 06:30:00",2415,582,2997
"2020-05-19 10:11:36","2020-05-20 07:00:00","2020-05-20 07:30:00",2717,673,3390
"2020-05-19 10:11:36","2020-05-20 08:00:00","2020-05-20 08:30:00",3124,799,3923
"2020-05-19 10:11:36","2020-05-20 09:00:00","2020-05-20 09:30:00",3457,906,4363
"2020-05-19 10:11:36","2020-05-20 10:00:00","2020-05-20 10:30:00",3543,960,4503
"2020-05-19 10:11:36","2020-05-20 11:00:00","2020-05-20 11:30:00",3516,992,4508
"2020-05-19 10:11:36","2020-05-20 12:00:00","2020-05-20 12:30:00",3546,987,4533
"2020-05-19 10:11:36","2020-05-20 13:00:00","2020-05-20 13:30:00",3685,1005,4690
"2020-05-19 10:11:36","2020-05-20 14:00:00","2020-05-20 14:30:00",3548,971,4519
"2020-05-19 10:11:36","2020-05-20 15:00:00","2020-05-20 15:30:00",3506,936,4442
"2020-05-19 10:11:36","2020-05-20 16:00:00","2020-05-20 16:30:00",3491,953,4444
"2020-05-19 10:11:36","2020-05-20 17:00:00","2020-05-20 17:30:00",3675,1074,4749
"2020-05-19 10:11:36","2020-05-20 18:00:00","2020-05-20 18:30:00",3850,1105,4955
"2020-05-19 10:11:36","2020-05-20 19:00:00","2020-05-20 19:30:00",3647,1009,4656
"2020-05-19 10:11:36","2020-05-20 20:00:00","2020-05-20 20:30:00",3437,955,4392
"2020-05-19 10:11:36","2020-05-20 21:00:00","2020-05-20 21:30:00",3336,924,4260
"2020-05-19 10:11:36","2020-05-20 22:00:00","2020-05-20 22:30:00",3361,899,4260
"2020-05-20 10:11:20","2020-05-20 23:00:00","2020-05-20 23:30:00",2929,796,3725
"2020-05-20 10:11:20","2020-05-21 00:00:00","2020-05-21 00:30:00",2774,672,3446
"2020-05-20 10:11:20","2020-05-21 01:00:00","2020-05-21 01:30:00",2632,606,3238
"2020-05-20 10:11:20","2020-05-21 02:00:00","2020-05-21 02:30:00",2512,572,3084
"2020-05-20 10:11:20","2020-05-21 03:00:00","2020-05-21 03:30:00",2453,567,3020
"2020-05-20 10:11:20","2020-05-21 04:00:00","2020-05-21 04:30:00",2430,555,2985
"2020-05-20 10:11:20","2020-05-21 05:00:00","2020-05-21 05:30:00",2444,551,2995
"2020-05-20 10:11:20","2020-05-21 06:00:00","2020-05-21 06:30:00",2463,569,3032
"2020-05-20 10:11:20","2020-05-21 07:00:00","2020-05-21 07:30:00",2775,668,3443
"2020-05-20 10:11:20","2020-05-21 08:00:00","2020-05-21 08:30:00",3202,787,3989
"2020-05-20 10:11:20","2020-05-21 09:00:00","2020-05-21 09:30:00",3547,879,4426
"2020-05-20 10:11:20","2020-05-21 10:00:00","2020-05-21 10:30:00",3647,881,4528
"2020-05-20 10:11:20","2020-05-21 11:00:00","2020-05-21 11:30:00",3651,930,4581
"2020-05-20 10:11:20","2020-05-21 12:00:00","2020-05-21 12:30:00",3701,941,4642
"2020-05-20 10:11:20","2020-05-21 13:00:00","2020-05-21 13:30:00",3785,967,4752
"2020-05-20 10:11:20","2020-05-21 14:00:00","2020-05-21 14:30:00",3604,885,4489
"2020-05-20 10:11:20","2020-05-21 15:00:00","2020-05-21 15:30:00",3479,860,4339
"2020-05-20 10:11:20","2020-05-21 16:00:00","2020-05-21 16:30:00",3433,877,4310
"2020-05-20 10:11:20","2020-05-21 17:00:00","2020-05-21 17:30:00",3585,1007,4592
"2020-05-20 10:11:20","2020-05-21 18:00:00","2020-05-21 18:30:00",3800,1034,4834
"2020-05-20 10:11:20","2020-05-21 19:00:00","2020-05-21 19:30:00",3662,930,4592
"2020-05-20 10:11:20","2020-05-21 20:00:00","2020-05-21 20:30:00",3492,890,4382
"2020-05-20 10:11:20","2020-05-21 21:00:00","2020-05-21 21:30:00",3373,867,4240
"2020-05-20 10:11:20","2020-05-21 22:00:00","2020-05-21 22:30:00",3410,865,4275
"2020-05-21 10:11:10","2020-05-21 23:00:00","2020-05-21 23:30:00",3063,740,3803
"2020-05-21 10:11:10","2020-05-22 00:00:00","2020-05-22 00:30:00",2692,606,3298
"2020-05-21 10:11:10","2020-05-22 01:00:00","2020-05-22 01:30:00",2570,541,3111
"2020-05-21 10:11:10","2020-05-22 02:00:00","2020-05-22 02:30:00",2454,520,2974
"2020-05-21 10:11:10","2020-05-22 03:00:00","2020-05-22 03:30:00",2377,514,2891
"2020-05-21 10:11:10","2020-05-22 04:00:00","2020-05-22 04:30:00",2333,504,2837
"2020-05-21 10:11:10","2020-05-22 05:00:00","2020-05-22 05:30:00",2365,490,2855
"2020-05-21 10:11:10","2020-05-22 06:00:00","2020-05-22 06:30:00",2384,515,2899
"2020-05-21 10:11:10","2020-05-22 07:00:00","2020-05-22 07:30:00",2652,618,3270
"2020-05-21 10:11:10","2020-05-22 08:00:00","2020-05-22 08:30:00",3002,740,3742
"2020-05-21 10:11:10","2020-05-22 09:00:00","2020-05-22 09:30:00",3287,829,4116
"2020-05-21 10:11:10","2020-05-22 10:00:00","2020-05-22 10:30:00",3380,845,4225
"2020-05-21 10:11:10","2020-05-22 11:00:00","2020-05-22 11:30:00",3404,834,4238
"2020-05-21 10:11:10","2020-05-22 12:00:00","2020-05-22 12:30:00",3460,833,4293
"2020-05-21 10:11:10","2020-05-22 13:00:00","2020-05-22 13:30:00",3541,827,4368
"2020-05-21 10:11:10","2020-05-22 14:00:00","2020-05-22 14:30:00",3425,776,4201
"2020-05-21 10:11:10","2020-05-22 15:00:00","2020-05-22 15:30:00",3335,755,4090
"2020-05-21 10:11:10","2020-05-22 16:00:00","2020-05-22 16:30:00",3300,766,4066
"2020-05-21 10:11:10","2020-05-22 17:00:00","2020-05-22 17:30:00",3428,870,4298
"2020-05-21 10:11:10","2020-05-22 18:00:00","2020-05-22 18:30:00",3602,880,4482
"2020-05-21 10:11:10","2020-05-22 19:00:00","2020-05-22 19:30:00",3479,833,4312
"2020-05-21 10:11:10","2020-05-22 20:00:00","2020-05-22 20:30:00",3286,792,4078
"2020-05-21 10:11:10","2020-05-22 21:00:00","2020-05-22 21:30:00",3178,768,3946
"2020-05-21 10:11:10","2020-05-22 22:00:00","2020-05-22 22:30:00",3172,789,3961
